fra;clage_vacsi;jour;n_dose1;n_complet;n_cum_dose1;n_cum_complet;couv_dose1;couv_complet
FR;24;2020-12-27;1;0;1;0;0.0;0.0
FR;24;2020-12-28;3;0;4;0;0.0;0.0
FR;24;2020-12-29;0;0;4;0;0.0;0.0
FR;24;2020-12-30;0;0;4;0;0.0;0.0
FR;24;2020-12-31;1;0;5;0;0.0;0.0
FR;24;2021-01-01;1;0;6;0;0.0;0.0
FR;24;2021-01-02;1;0;7;0;0.0;0.0
FR;24;2021-01-03;2;0;9;0;0.0;0.0
FR;24;2021-01-04;4;0;13;0;0.0;0.0
FR;24;2021-01-05;17;1;30;1;0.0;0.0
FR;24;2021-01-06;39;0;69;1;0.0;0.0
FR;24;2021-01-07;180;0;249;1;0.0;0.0
FR;24;2021-01-08;216;0;465;1;0.0;0.0
FR;24;2021-01-09;39;0;504;1;0.0;0.0
FR;24;2021-01-10;35;0;539;1;0.0;0.0
FR;24;2021-01-11;255;2;794;3;0.0;0.0
FR;24;2021-01-12;398;5;1192;8;0.0;0.0
FR;24;2021-01-13;482;5;1674;13;0.0;0.0
FR;24;2021-01-14;616;6;2290;19;0.0;0.0
FR;24;2021-01-15;599;2;2889;21;0.1;0.0
FR;24;2021-01-16;118;3;3007;24;0.1;0.0
FR;24;2021-01-17;94;0;3101;24;0.1;0.0
FR;24;2021-01-18;510;4;3611;28;0.1;0.0
FR;24;2021-01-19;601;4;4212;32;0.1;0.0
FR;24;2021-01-20;652;0;4864;32;0.1;0.0
FR;24;2021-01-21;760;4;5624;36;0.1;0.0
FR;24;2021-01-22;604;4;6228;40;0.1;0.0
FR;24;2021-01-23;117;0;6345;40;0.1;0.0
FR;24;2021-01-24;22;0;6367;40;0.1;0.0
FR;24;2021-01-25;296;5;6663;45;0.1;0.0
FR;24;2021-01-26;367;13;7030;58;0.1;0.0
FR;24;2021-01-27;447;14;7477;72;0.1;0.0
FR;24;2021-01-28;598;52;8075;124;0.1;0.0
FR;24;2021-01-29;469;84;8544;208;0.2;0.0
FR;24;2021-01-30;87;16;8631;224;0.2;0.0
FR;24;2021-01-31;25;13;8656;237;0.2;0.0
FR;24;2021-02-01;157;135;8813;372;0.2;0.0
FR;24;2021-02-02;219;182;9032;554;0.2;0.0
FR;24;2021-02-03;218;187;9250;741;0.2;0.0
FR;24;2021-02-04;359;315;9609;1056;0.2;0.0
FR;24;2021-02-05;348;346;9957;1402;0.2;0.0
FR;24;2021-02-06;83;71;10040;1473;0.2;0.0
FR;24;2021-02-07;169;31;10209;1504;0.2;0.0
FR;24;2021-02-08;388;360;10597;1864;0.2;0.0
FR;24;2021-02-09;749;460;11346;2324;0.2;0.0
FR;24;2021-02-10;1095;601;12441;2925;0.2;0.1
FR;24;2021-02-11;1583;724;14024;3649;0.3;0.1
FR;24;2021-02-12;1625;573;15649;4222;0.3;0.1
FR;24;2021-02-13;293;95;15942;4317;0.3;0.1
FR;24;2021-02-14;63;31;16005;4348;0.3;0.1
FR;24;2021-02-15;1043;389;17048;4737;0.3;0.1
FR;24;2021-02-16;1569;589;18617;5326;0.3;0.1
FR;24;2021-02-17;1494;506;20111;5832;0.4;0.1
FR;24;2021-02-18;1954;639;22065;6471;0.4;0.1
FR;24;2021-02-19;1861;573;23926;7044;0.4;0.1
FR;24;2021-02-20;335;89;24261;7133;0.4;0.1
FR;24;2021-02-21;41;19;24302;7152;0.4;0.1
FR;24;2021-02-22;1171;297;25473;7449;0.5;0.1
FR;24;2021-02-23;1594;401;27067;7850;0.5;0.1
FR;24;2021-02-24;1657;349;28724;8199;0.5;0.2
FR;24;2021-02-25;2292;496;31016;8695;0.6;0.2
FR;24;2021-02-26;2203;419;33219;9114;0.6;0.2
FR;24;2021-02-27;533;89;33752;9203;0.6;0.2
FR;24;2021-02-28;92;17;33844;9220;0.6;0.2
FR;24;2021-03-01;1279;250;35123;9470;0.6;0.2
FR;24;2021-03-02;1668;332;36791;9802;0.7;0.2
FR;24;2021-03-03;1777;381;38568;10183;0.7;0.2
FR;24;2021-03-04;2188;545;40756;10728;0.8;0.2
FR;24;2021-03-05;3334;537;44090;11265;0.8;0.2
FR;24;2021-03-06;1732;160;45822;11425;0.8;0.2
FR;24;2021-03-07;993;88;46815;11513;0.9;0.2
FR;24;2021-03-08;1982;269;48797;11782;0.9;0.2
FR;24;2021-03-09;2648;352;51445;12134;0.9;0.2
FR;24;2021-03-10;2465;391;53910;12525;1.0;0.2
FR;24;2021-03-11;2987;548;56897;13073;1.0;0.2
FR;24;2021-03-12;3879;483;60776;13556;1.1;0.2
FR;24;2021-03-13;1501;119;62277;13675;1.1;0.3
FR;24;2021-03-14;538;40;62815;13715;1.2;0.3
FR;24;2021-03-15;1877;278;64692;13993;1.2;0.3
FR;24;2021-03-16;832;317;65524;14310;1.2;0.3
FR;24;2021-03-17;1081;333;66605;14643;1.2;0.3
FR;24;2021-03-18;1310;458;67915;15101;1.3;0.3
FR;24;2021-03-19;1893;385;69808;15486;1.3;0.3
FR;24;2021-03-20;851;93;70659;15579;1.3;0.3
FR;24;2021-03-21;637;77;71296;15656;1.3;0.3
FR;24;2021-03-22;1505;317;72801;15973;1.3;0.3
FR;24;2021-03-23;1810;411;74611;16384;1.4;0.3
FR;24;2021-03-24;2172;380;76783;16764;1.4;0.3
FR;24;2021-03-25;2577;518;79360;17282;1.5;0.3
FR;24;2021-03-26;3176;515;82536;17797;1.5;0.3
FR;24;2021-03-27;1906;219;84442;18016;1.6;0.3
FR;24;2021-03-28;1010;83;85452;18099;1.6;0.3
FR;24;2021-03-29;2464;387;87916;18486;1.6;0.3
FR;24;2021-03-30;3649;551;91565;19037;1.7;0.4
FR;24;2021-03-31;4194;557;95759;19594;1.8;0.4
FR;24;2021-04-01;5440;800;101199;20394;1.9;0.4
FR;24;2021-04-02;4475;665;105674;21059;1.9;0.4
FR;24;2021-04-03;1755;350;107429;21409;2.0;0.4
FR;24;2021-04-04;955;131;108384;21540;2.0;0.4
FR;24;2021-04-05;1101;141;109485;21681;2.0;0.4
FR;24;2021-04-06;3574;615;113059;22296;2.1;0.4
FR;24;2021-04-07;4802;861;117861;23157;2.2;0.4
FR;24;2021-04-08;6402;1155;124263;24312;2.3;0.4
FR;24;2021-04-09;5802;1097;130065;25409;2.4;0.5
FR;24;2021-04-10;2627;583;132692;25992;2.4;0.5
FR;24;2021-04-11;1259;317;133951;26309;2.5;0.5
FR;24;2021-04-12;3461;954;137412;27263;2.5;0.5
FR;24;2021-04-13;4785;1173;142197;28436;2.6;0.5
FR;24;2021-04-14;4977;1343;147174;29779;2.7;0.5
FR;24;2021-04-15;5235;1615;152409;31394;2.8;0.6
FR;24;2021-04-16;4851;1701;157260;33095;2.9;0.6
FR;24;2021-04-17;2146;810;159406;33905;2.9;0.6
FR;24;2021-04-18;725;443;160131;34348;3.0;0.6
FR;24;2021-04-19;2951;1532;163082;35880;3.0;0.7
FR;24;2021-04-20;3136;2143;166218;38023;3.1;0.7
FR;24;2021-04-21;3479;2501;169697;40524;3.1;0.7
FR;24;2021-04-22;4053;3158;173750;43682;3.2;0.8
FR;24;2021-04-23;4232;3311;177982;46993;3.3;0.9
FR;24;2021-04-24;2405;1690;180387;48683;3.3;0.9
FR;24;2021-04-25;1232;802;181619;49485;3.3;0.9
FR;24;2021-04-26;3140;2198;184759;51683;3.4;1.0
FR;24;2021-04-27;4087;3192;188846;54875;3.5;1.0
FR;24;2021-04-28;5061;3773;193907;58648;3.6;1.1
FR;24;2021-04-29;5839;4489;199746;63137;3.7;1.2
FR;24;2021-04-30;6774;4654;206520;67791;3.8;1.2
FR;24;2021-05-01;4167;1092;210687;68883;3.9;1.3
FR;24;2021-05-02;2788;907;213475;69790;3.9;1.3
FR;24;2021-05-03;6381;4154;219856;73944;4.1;1.4
FR;24;2021-05-04;7613;4733;227469;78677;4.2;1.5
FR;24;2021-05-05;8830;4991;236299;83668;4.4;1.5
FR;24;2021-05-06;10946;6406;247245;90074;4.6;1.7
FR;24;2021-05-07;12150;6456;259395;96530;4.8;1.8
FR;24;2021-05-08;10033;2560;269428;99090;5.0;1.8
FR;24;2021-05-09;6883;1941;276311;101031;5.1;1.9
FR;24;2021-05-10;11133;4986;287444;106017;5.3;2.0
FR;24;2021-05-11;15652;5789;303096;111806;5.6;2.1
FR;24;2021-05-12;22959;6213;326055;118019;6.0;2.2
FR;24;2021-05-13;27618;3087;353673;121106;6.5;2.2
FR;24;2021-05-14;32806;5584;386479;126690;7.1;2.3
FR;24;2021-05-15;34180;4012;420659;130702;7.8;2.4
FR;24;2021-05-16;21896;1998;442555;132700;8.2;2.4
FR;24;2021-05-17;29597;5278;472152;137978;8.7;2.5
FR;24;2021-05-18;37953;6089;510105;144067;9.4;2.7
FR;24;2021-05-19;40229;7073;550334;151140;10.1;2.8
FR;24;2021-05-20;45877;7497;596211;158637;11.0;2.9
FR;24;2021-05-21;47446;7255;643657;165892;11.9;3.1
FR;24;2021-05-22;44688;4520;688345;170412;12.7;3.1
FR;24;2021-05-23;24027;2328;712372;172740;13.1;3.2
FR;24;2021-05-24;34394;3588;746766;176328;13.8;3.3
FR;24;2021-05-25;44773;7800;791539;184128;14.6;3.4
FR;24;2021-05-26;45737;7337;837276;191465;15.4;3.5
FR;24;2021-05-27;51930;8491;889206;199956;16.4;3.7
FR;24;2021-05-28;48562;8912;937768;208868;17.3;3.9
FR;24;2021-05-29;44003;5891;981771;214759;18.1;4.0
FR;24;2021-05-30;18363;2234;1000134;216993;18.4;4.0
FR;24;2021-05-31;51777;8169;1051911;225162;19.4;4.2
FR;24;2021-06-01;59315;10068;1111226;235230;20.5;4.3
FR;24;2021-06-02;60709;9493;1171935;244723;21.6;4.5
FR;24;2021-06-03;67281;10442;1239216;255165;22.8;4.7
FR;24;2021-06-04;64466;10596;1303682;265761;24.0;4.9
FR;24;2021-06-05;54727;7675;1358409;273436;25.0;5.0
FR;24;2021-06-06;26694;3569;1385103;277005;25.5;5.1
FR;24;2021-06-07;56657;9799;1441760;286804;26.6;5.3
FR;24;2021-06-08;70297;9155;1512057;295959;27.9;5.5
FR;24;2021-06-09;76324;11177;1588381;307136;29.3;5.7
FR;24;2021-06-10;62050;13700;1650431;320836;30.4;5.9
FR;29;2020-12-27;0;0;0;0;0.0;0.0
FR;29;2020-12-28;1;0;1;0;0.0;0.0
FR;29;2020-12-29;0;0;1;0;0.0;0.0
FR;29;2020-12-30;0;0;1;0;0.0;0.0
FR;29;2020-12-31;1;0;2;0;0.0;0.0
FR;29;2021-01-01;2;0;4;0;0.0;0.0
FR;29;2021-01-02;3;0;7;0;0.0;0.0
FR;29;2021-01-03;3;0;10;0;0.0;0.0
FR;29;2021-01-04;10;0;20;0;0.0;0.0
FR;29;2021-01-05;42;0;62;0;0.0;0.0
FR;29;2021-01-06;146;0;208;0;0.0;0.0
FR;29;2021-01-07;307;2;515;2;0.0;0.0
FR;29;2021-01-08;519;5;1034;7;0.0;0.0
FR;29;2021-01-09;113;0;1147;7;0.0;0.0
FR;29;2021-01-10;91;1;1238;8;0.0;0.0
FR;29;2021-01-11;647;4;1885;12;0.1;0.0
FR;29;2021-01-12;942;14;2827;26;0.1;0.0
FR;29;2021-01-13;1220;12;4047;38;0.1;0.0
FR;29;2021-01-14;1570;16;5617;54;0.2;0.0
FR;29;2021-01-15;1316;7;6933;61;0.2;0.0
FR;29;2021-01-16;193;4;7126;65;0.2;0.0
FR;29;2021-01-17;158;0;7284;65;0.2;0.0
FR;29;2021-01-18;1039;14;8323;79;0.2;0.0
FR;29;2021-01-19;1153;6;9476;85;0.3;0.0
FR;29;2021-01-20;1198;7;10674;92;0.3;0.0
FR;29;2021-01-21;1462;8;12136;100;0.3;0.0
FR;29;2021-01-22;1154;10;13290;110;0.4;0.0
FR;29;2021-01-23;170;2;13460;112;0.4;0.0
FR;29;2021-01-24;52;0;13512;112;0.4;0.0
FR;29;2021-01-25;543;19;14055;131;0.4;0.0
FR;29;2021-01-26;667;35;14722;166;0.4;0.0
FR;29;2021-01-27;729;63;15451;229;0.4;0.0
FR;29;2021-01-28;1037;123;16488;352;0.4;0.0
FR;29;2021-01-29;807;171;17295;523;0.5;0.0
FR;29;2021-01-30;141;40;17436;563;0.5;0.0
FR;29;2021-01-31;34;26;17470;589;0.5;0.0
FR;29;2021-02-01;263;295;17733;884;0.5;0.0
FR;29;2021-02-02;410;372;18143;1256;0.5;0.0
FR;29;2021-02-03;459;462;18602;1718;0.5;0.0
FR;29;2021-02-04;614;717;19216;2435;0.5;0.1
FR;29;2021-02-05;534;749;19750;3184;0.5;0.1
FR;29;2021-02-06;143;109;19893;3293;0.5;0.1
FR;29;2021-02-07;304;67;20197;3360;0.5;0.1
FR;29;2021-02-08;606;808;20803;4168;0.6;0.1
FR;29;2021-02-09;1250;1026;22053;5194;0.6;0.1
FR;29;2021-02-10;1715;1148;23768;6342;0.6;0.2
FR;29;2021-02-11;2472;1444;26240;7786;0.7;0.2
FR;29;2021-02-12;2224;1240;28464;9026;0.8;0.2
FR;29;2021-02-13;428;157;28892;9183;0.8;0.2
FR;29;2021-02-14;134;81;29026;9264;0.8;0.2
FR;29;2021-02-15;1575;805;30601;10069;0.8;0.3
FR;29;2021-02-16;1928;1167;32529;11236;0.9;0.3
FR;29;2021-02-17;1889;959;34418;12195;0.9;0.3
FR;29;2021-02-18;2402;1178;36820;13373;1.0;0.4
FR;29;2021-02-19;2330;956;39150;14329;1.1;0.4
FR;29;2021-02-20;384;125;39534;14454;1.1;0.4
FR;29;2021-02-21;86;43;39620;14497;1.1;0.4
FR;29;2021-02-22;1364;539;40984;15036;1.1;0.4
FR;29;2021-02-23;1763;663;42747;15699;1.2;0.4
FR;29;2021-02-24;1789;548;44536;16247;1.2;0.4
FR;29;2021-02-25;2410;953;46946;17200;1.3;0.5
FR;29;2021-02-26;2583;676;49529;17876;1.3;0.5
FR;29;2021-02-27;609;111;50138;17987;1.3;0.5
FR;29;2021-02-28;112;28;50250;18015;1.4;0.5
FR;29;2021-03-01;1313;360;51563;18375;1.4;0.5
FR;29;2021-03-02;1817;611;53380;18986;1.4;0.5
FR;29;2021-03-03;2000;613;55380;19599;1.5;0.5
FR;29;2021-03-04;2517;784;57897;20383;1.6;0.5
FR;29;2021-03-05;3647;746;61544;21129;1.7;0.6
FR;29;2021-03-06;1648;153;63192;21282;1.7;0.6
FR;29;2021-03-07;824;103;64016;21385;1.7;0.6
FR;29;2021-03-08;1975;416;65991;21801;1.8;0.6
FR;29;2021-03-09;2675;511;68666;22312;1.8;0.6
FR;29;2021-03-10;2597;535;71263;22847;1.9;0.6
FR;29;2021-03-11;3380;867;74643;23714;2.0;0.6
FR;29;2021-03-12;4022;765;78665;24479;2.1;0.7
FR;29;2021-03-13;1645;151;80310;24630;2.2;0.7
FR;29;2021-03-14;569;65;80879;24695;2.2;0.7
FR;29;2021-03-15;1916;386;82795;25081;2.2;0.7
FR;29;2021-03-16;1122;510;83917;25591;2.3;0.7
FR;29;2021-03-17;1384;513;85301;26104;2.3;0.7
FR;29;2021-03-18;1655;691;86956;26795;2.3;0.7
FR;29;2021-03-19;2251;578;89207;27373;2.4;0.7
FR;29;2021-03-20;994;135;90201;27508;2.4;0.7
FR;29;2021-03-21;725;66;90926;27574;2.4;0.7
FR;29;2021-03-22;1670;420;92596;27994;2.5;0.8
FR;29;2021-03-23;2226;613;94822;28607;2.6;0.8
FR;29;2021-03-24;2557;588;97379;29195;2.6;0.8
FR;29;2021-03-25;3400;710;100779;29905;2.7;0.8
FR;29;2021-03-26;3748;732;104527;30637;2.8;0.8
FR;29;2021-03-27;2152;273;106679;30910;2.9;0.8
FR;29;2021-03-28;966;79;107645;30989;2.9;0.8
FR;29;2021-03-29;2779;552;110424;31541;3.0;0.8
FR;29;2021-03-30;4022;744;114446;32285;3.1;0.9
FR;29;2021-03-31;4551;842;118997;33127;3.2;0.9
FR;29;2021-04-01;5881;1051;124878;34178;3.4;0.9
FR;29;2021-04-02;4923;958;129801;35136;3.5;0.9
FR;29;2021-04-03;1783;343;131584;35479;3.5;1.0
FR;29;2021-04-04;900;126;132484;35605;3.6;1.0
FR;29;2021-04-05;926;116;133410;35721;3.6;1.0
FR;29;2021-04-06;3521;783;136931;36504;3.7;1.0
FR;29;2021-04-07;4571;1141;141502;37645;3.8;1.0
FR;29;2021-04-08;6300;1510;147802;39155;4.0;1.1
FR;29;2021-04-09;6306;1309;154108;40464;4.1;1.1
FR;29;2021-04-10;2652;635;156760;41099;4.2;1.1
FR;29;2021-04-11;1166;342;157926;41441;4.2;1.1
FR;29;2021-04-12;3607;1060;161533;42501;4.3;1.1
FR;29;2021-04-13;4894;1526;166427;44027;4.5;1.2
FR;29;2021-04-14;4790;1528;171217;45555;4.6;1.2
FR;29;2021-04-15;5629;1843;176846;47398;4.8;1.3
FR;29;2021-04-16;4815;1905;181661;49303;4.9;1.3
FR;29;2021-04-17;2251;925;183912;50228;4.9;1.4
FR;29;2021-04-18;775;520;184687;50748;5.0;1.4
FR;29;2021-04-19;2874;1780;187561;52528;5.0;1.4
FR;29;2021-04-20;3525;2521;191086;55049;5.1;1.5
FR;29;2021-04-21;3507;2801;194593;57850;5.2;1.6
FR;29;2021-04-22;4483;3867;199076;61717;5.4;1.7
FR;29;2021-04-23;4629;3811;203705;65528;5.5;1.8
FR;29;2021-04-24;2713;1836;206418;67364;5.6;1.8
FR;29;2021-04-25;1196;741;207614;68105;5.6;1.8
FR;29;2021-04-26;3029;2485;210643;70590;5.7;1.9
FR;29;2021-04-27;4139;3612;214782;74202;5.8;2.0
FR;29;2021-04-28;5281;4051;220063;78253;5.9;2.1
FR;29;2021-04-29;6191;5003;226254;83256;6.1;2.2
FR;29;2021-04-30;6852;5239;233106;88495;6.3;2.4
FR;29;2021-05-01;4407;1224;237513;89719;6.4;2.4
FR;29;2021-05-02;2635;921;240148;90640;6.5;2.4
FR;29;2021-05-03;6943;4302;247091;94942;6.6;2.6
FR;29;2021-05-04;8247;5213;255338;100155;6.9;2.7
FR;29;2021-05-05;9726;5204;265064;105359;7.1;2.8
FR;29;2021-05-06;11332;6575;276396;111934;7.4;3.0
FR;29;2021-05-07;11783;6637;288179;118571;7.8;3.2
FR;29;2021-05-08;8990;2290;297169;120861;8.0;3.3
FR;29;2021-05-09;5921;1752;303090;122613;8.2;3.3
FR;29;2021-05-10;10733;5325;313823;127938;8.4;3.4
FR;29;2021-05-11;14697;6397;328520;134335;8.8;3.6
FR;29;2021-05-12;20145;6356;348665;140691;9.4;3.8
FR;29;2021-05-13;19881;2374;368546;143065;9.9;3.8
FR;29;2021-05-14;22810;4450;391356;147515;10.5;4.0
FR;29;2021-05-15;21544;2981;412900;150496;11.1;4.0
FR;29;2021-05-16;13408;1359;426308;151855;11.5;4.1
FR;29;2021-05-17;21621;4996;447929;156851;12.1;4.2
FR;29;2021-05-18;28487;5758;476416;162609;12.8;4.4
FR;29;2021-05-19;29127;5997;505543;168606;13.6;4.5
FR;29;2021-05-20;32878;6576;538421;175182;14.5;4.7
FR;29;2021-05-21;32148;6210;570569;181392;15.4;4.9
FR;29;2021-05-22;26238;3050;596807;184442;16.1;5.0
FR;29;2021-05-23;14229;1501;611036;185943;16.4;5.0
FR;29;2021-05-24;22615;2651;633651;188594;17.0;5.1
FR;29;2021-05-25;30664;6589;664315;195183;17.9;5.3
FR;29;2021-05-26;32703;6636;697018;201819;18.8;5.4
FR;29;2021-05-27;35786;7644;732804;209463;19.7;5.6
FR;29;2021-05-28;33280;7921;766084;217384;20.6;5.8
FR;29;2021-05-29;26620;4271;792704;221655;21.3;6.0
FR;29;2021-05-30;11850;1639;804554;223294;21.6;6.0
FR;29;2021-05-31;33628;6812;838182;230106;22.6;6.2
FR;29;2021-06-01;38509;8242;876691;238348;23.6;6.4
FR;29;2021-06-02;38905;7843;915596;246191;24.6;6.6
FR;29;2021-06-03;43931;8847;959527;255038;25.8;6.9
FR;29;2021-06-04;42505;9079;1002032;264117;27.0;7.1
FR;29;2021-06-05;31609;5610;1033641;269727;27.8;7.3
FR;29;2021-06-06;16857;2553;1050498;272280;28.3;7.3
FR;29;2021-06-07;37113;8223;1087611;280503;29.3;7.5
FR;29;2021-06-08;46709;7645;1134320;288148;30.5;7.8
FR;29;2021-06-09;49298;9425;1183618;297573;31.8;8.0
FR;29;2021-06-10;40712;11220;1224330;308793;32.9;8.3
FR;39;2020-12-27;0;0;0;0;0.0;0.0
FR;39;2020-12-28;0;0;0;0;0.0;0.0
FR;39;2020-12-29;1;0;1;0;0.0;0.0
FR;39;2020-12-30;5;0;6;0;0.0;0.0
FR;39;2020-12-31;1;0;7;0;0.0;0.0
FR;39;2021-01-01;4;0;11;0;0.0;0.0
FR;39;2021-01-02;2;1;13;1;0.0;0.0
FR;39;2021-01-03;2;0;15;1;0.0;0.0
FR;39;2021-01-04;23;0;38;1;0.0;0.0
FR;39;2021-01-05;140;0;178;1;0.0;0.0
FR;39;2021-01-06;386;0;564;1;0.0;0.0
FR;39;2021-01-07;1177;6;1741;7;0.0;0.0
FR;39;2021-01-08;1791;5;3532;12;0.0;0.0
FR;39;2021-01-09;475;0;4007;12;0.0;0.0
FR;39;2021-01-10;308;1;4315;13;0.1;0.0
FR;39;2021-01-11;2216;10;6531;23;0.1;0.0
FR;39;2021-01-12;3421;21;9952;44;0.1;0.0
FR;39;2021-01-13;3507;18;13459;62;0.2;0.0
FR;39;2021-01-14;4788;57;18247;119;0.2;0.0
FR;39;2021-01-15;4401;23;22648;142;0.3;0.0
FR;39;2021-01-16;771;4;23419;146;0.3;0.0
FR;39;2021-01-17;492;4;23911;150;0.3;0.0
FR;39;2021-01-18;3081;36;26992;186;0.3;0.0
FR;39;2021-01-19;4016;19;31008;205;0.4;0.0
FR;39;2021-01-20;3913;21;34921;226;0.4;0.0
FR;39;2021-01-21;5158;24;40079;250;0.5;0.0
FR;39;2021-01-22;3978;39;44057;289;0.5;0.0
FR;39;2021-01-23;593;4;44650;293;0.5;0.0
FR;39;2021-01-24;184;0;44834;293;0.5;0.0
FR;39;2021-01-25;1599;45;46433;338;0.6;0.0
FR;39;2021-01-26;2173;102;48606;440;0.6;0.0
FR;39;2021-01-27;2289;216;50895;656;0.6;0.0
FR;39;2021-01-28;3484;476;54379;1132;0.7;0.0
FR;39;2021-01-29;2677;700;57056;1832;0.7;0.0
FR;39;2021-01-30;396;215;57452;2047;0.7;0.0
FR;39;2021-01-31;89;78;57541;2125;0.7;0.0
FR;39;2021-02-01;753;1060;58294;3185;0.7;0.0
FR;39;2021-02-02;1336;1650;59630;4835;0.7;0.1
FR;39;2021-02-03;1362;1666;60992;6501;0.7;0.1
FR;39;2021-02-04;1986;2538;62978;9039;0.8;0.1
FR;39;2021-02-05;1647;2709;64625;11748;0.8;0.1
FR;39;2021-02-06;400;433;65025;12181;0.8;0.1
FR;39;2021-02-07;554;210;65579;12391;0.8;0.1
FR;39;2021-02-08;1520;2430;67099;14821;0.8;0.2
FR;39;2021-02-09;3170;3393;70269;18214;0.8;0.2
FR;39;2021-02-10;3894;3537;74163;21751;0.9;0.3
FR;39;2021-02-11;6180;4877;80343;26628;1.0;0.3
FR;39;2021-02-12;5826;4017;86169;30645;1.0;0.4
FR;39;2021-02-13;1243;548;87412;31193;1.1;0.4
FR;39;2021-02-14;389;267;87801;31460;1.1;0.4
FR;39;2021-02-15;3424;2405;91225;33865;1.1;0.4
FR;39;2021-02-16;4429;3379;95654;37244;1.2;0.4
FR;39;2021-02-17;3994;2889;99648;40133;1.2;0.5
FR;39;2021-02-18;5982;3921;105630;44054;1.3;0.5
FR;39;2021-02-19;5857;3101;111487;47155;1.3;0.6
FR;39;2021-02-20;1140;479;112627;47634;1.4;0.6
FR;39;2021-02-21;187;122;112814;47756;1.4;0.6
FR;39;2021-02-22;3014;1681;115828;49437;1.4;0.6
FR;39;2021-02-23;3928;1946;119756;51383;1.4;0.6
FR;39;2021-02-24;3738;1738;123494;53121;1.5;0.6
FR;39;2021-02-25;5620;2571;129114;55692;1.6;0.7
FR;39;2021-02-26;6112;1961;135226;57653;1.6;0.7
FR;39;2021-02-27;1668;315;136894;57968;1.7;0.7
FR;39;2021-02-28;241;125;137135;58093;1.7;0.7
FR;39;2021-03-01;2968;1021;140103;59114;1.7;0.7
FR;39;2021-03-02;4285;1660;144388;60774;1.7;0.7
FR;39;2021-03-03;4292;1563;148680;62337;1.8;0.8
FR;39;2021-03-04;6356;2373;155036;64710;1.9;0.8
FR;39;2021-03-05;9227;2186;164263;66896;2.0;0.8
FR;39;2021-03-06;4984;451;169247;67347;2.0;0.8
FR;39;2021-03-07;2666;287;171913;67634;2.1;0.8
FR;39;2021-03-08;4711;1155;176624;68789;2.1;0.8
FR;39;2021-03-09;6964;1585;183588;70374;2.2;0.8
FR;39;2021-03-10;6170;1590;189758;71964;2.3;0.9
FR;39;2021-03-11;8802;2502;198560;74466;2.4;0.9
FR;39;2021-03-12;11597;2253;210157;76719;2.5;0.9
FR;39;2021-03-13;5315;463;215472;77182;2.6;0.9
FR;39;2021-03-14;1771;180;217243;77362;2.6;0.9
FR;39;2021-03-15;4869;1088;222112;78450;2.7;0.9
FR;39;2021-03-16;3379;1430;225491;79880;2.7;1.0
FR;39;2021-03-17;3461;1527;228952;81407;2.8;1.0
FR;39;2021-03-18;4675;2016;233627;83423;2.8;1.0
FR;39;2021-03-19;6328;1696;239955;85119;2.9;1.0
FR;39;2021-03-20;3207;388;243162;85507;2.9;1.0
FR;39;2021-03-21;2073;174;245235;85681;3.0;1.0
FR;39;2021-03-22;4465;1135;249700;86816;3.0;1.0
FR;39;2021-03-23;6200;1697;255900;88513;3.1;1.1
FR;39;2021-03-24;6355;1405;262255;89918;3.2;1.1
FR;39;2021-03-25;9092;1791;271347;91709;3.3;1.1
FR;39;2021-03-26;10691;1779;282038;93488;3.4;1.1
FR;39;2021-03-27;6005;666;288043;94154;3.5;1.1
FR;39;2021-03-28;2740;198;290783;94352;3.5;1.1
FR;39;2021-03-29;7237;1334;298020;95686;3.6;1.2
FR;39;2021-03-30;10591;1965;308611;97651;3.7;1.2
FR;39;2021-03-31;11236;1923;319847;99574;3.9;1.2
FR;39;2021-04-01;15079;2738;334926;102312;4.0;1.2
FR;39;2021-04-02;13314;2566;348240;104878;4.2;1.3
FR;39;2021-04-03;5619;1034;353859;105912;4.3;1.3
FR;39;2021-04-04;2529;350;356388;106262;4.3;1.3
FR;39;2021-04-05;2541;331;358929;106593;4.3;1.3
FR;39;2021-04-06;9325;2359;368254;108952;4.4;1.3
FR;39;2021-04-07;12247;2822;380501;111774;4.6;1.3
FR;39;2021-04-08;16922;3815;397423;115589;4.8;1.4
FR;39;2021-04-09;16952;3704;414375;119293;5.0;1.4
FR;39;2021-04-10;7423;1972;421798;121265;5.1;1.5
FR;39;2021-04-11;2989;990;424787;122255;5.1;1.5
FR;39;2021-04-12;9649;2790;434436;125045;5.2;1.5
FR;39;2021-04-13;13014;4078;447450;129123;5.4;1.6
FR;39;2021-04-14;12963;3902;460413;133025;5.6;1.6
FR;39;2021-04-15;14882;4891;475295;137916;5.7;1.7
FR;39;2021-04-16;12870;5352;488165;143268;5.9;1.7
FR;39;2021-04-17;6165;2740;494330;146008;6.0;1.8
FR;39;2021-04-18;2279;1564;496609;147572;6.0;1.8
FR;39;2021-04-19;7959;4750;504568;152322;6.1;1.8
FR;39;2021-04-20;9541;6761;514109;159083;6.2;1.9
FR;39;2021-04-21;10404;7243;524513;166326;6.3;2.0
FR;39;2021-04-22;12024;10396;536537;176722;6.5;2.1
FR;39;2021-04-23;12346;10587;548883;187309;6.6;2.3
FR;39;2021-04-24;7892;5116;556775;192425;6.7;2.3
FR;39;2021-04-25;3545;2175;560320;194600;6.8;2.3
FR;39;2021-04-26;8780;6999;569100;201599;6.9;2.4
FR;39;2021-04-27;12330;9624;581430;211223;7.0;2.5
FR;39;2021-04-28;14972;10150;596402;221373;7.2;2.7
FR;39;2021-04-29;18208;13053;614610;234426;7.4;2.8
FR;39;2021-04-30;20962;13358;635572;247784;7.7;3.0
FR;39;2021-05-01;14126;3577;649698;251361;7.8;3.0
FR;39;2021-05-02;9395;2520;659093;253881;7.9;3.1
FR;39;2021-05-03;22710;11363;681803;265244;8.2;3.2
FR;39;2021-05-04;27289;14022;709092;279266;8.5;3.4
FR;39;2021-05-05;31102;14356;740194;293622;8.9;3.5
FR;39;2021-05-06;37378;17788;777572;311410;9.4;3.8
FR;39;2021-05-07;38876;18616;816448;330026;9.8;4.0
FR;39;2021-05-08;29208;5696;845656;335722;10.2;4.0
FR;39;2021-05-09;18809;4322;864465;340044;10.4;4.1
FR;39;2021-05-10;34200;14609;898665;354653;10.8;4.3
FR;39;2021-05-11;44637;17225;943302;371878;11.4;4.5
FR;39;2021-05-12;56858;16351;1000160;388229;12.1;4.7
FR;39;2021-05-13;53595;5678;1053755;393907;12.7;4.7
FR;39;2021-05-14;63133;11142;1116888;405049;13.5;4.9
FR;39;2021-05-15;56928;6970;1173816;412019;14.2;5.0
FR;39;2021-05-16;36082;3140;1209898;415159;14.6;5.0
FR;39;2021-05-17;56697;12028;1266595;427187;15.3;5.1
FR;39;2021-05-18;71600;13730;1338195;440917;16.1;5.3
FR;39;2021-05-19;75082;14191;1413277;455108;17.0;5.5
FR;39;2021-05-20;83453;15056;1496730;470164;18.0;5.7
FR;39;2021-05-21;82870;15063;1579600;485227;19.0;5.8
FR;39;2021-05-22;63851;7468;1643451;492695;19.8;5.9
FR;39;2021-05-23;34110;3332;1677561;496027;20.2;6.0
FR;39;2021-05-24;52446;5409;1730007;501436;20.9;6.0
FR;39;2021-05-25;73777;15885;1803784;517321;21.7;6.2
FR;39;2021-05-26;77118;15927;1880902;533248;22.7;6.4
FR;39;2021-05-27;85089;17987;1965991;551235;23.7;6.6
FR;39;2021-05-28;78846;19549;2044837;570784;24.7;6.9
FR;39;2021-05-29;57894;10131;2102731;580915;25.3;7.0
FR;39;2021-05-30;24579;3664;2127310;584579;25.6;7.0
FR;39;2021-05-31;74796;15881;2202106;600460;26.5;7.2
FR;39;2021-06-01;85992;19676;2288098;620136;27.6;7.5
FR;39;2021-06-02;86171;19084;2374269;639220;28.6;7.7
FR;39;2021-06-03;97474;21586;2471743;660806;29.8;8.0
FR;39;2021-06-04;95613;23061;2567356;683867;30.9;8.2
FR;39;2021-06-05;63792;13613;2631148;697480;31.7;8.4
FR;39;2021-06-06;31789;5751;2662937;703231;32.1;8.5
FR;39;2021-06-07;74656;20396;2737593;723627;33.0;8.7
FR;39;2021-06-08;98144;18979;2835737;742606;34.2;9.0
FR;39;2021-06-09;104590;24056;2940327;766662;35.4;9.2
FR;39;2021-06-10;83854;27100;3024181;793762;36.5;9.6
FR;49;2020-12-27;2;0;2;0;0.0;0.0
FR;49;2020-12-28;3;0;5;0;0.0;0.0
FR;49;2020-12-29;1;0;6;0;0.0;0.0
FR;49;2020-12-30;6;0;12;0;0.0;0.0
FR;49;2020-12-31;1;0;13;0;0.0;0.0
FR;49;2021-01-01;3;0;16;0;0.0;0.0
FR;49;2021-01-02;11;0;27;0;0.0;0.0
FR;49;2021-01-03;5;0;32;0;0.0;0.0
FR;49;2021-01-04;87;0;119;0;0.0;0.0
FR;49;2021-01-05;338;1;457;1;0.0;0.0
FR;49;2021-01-06;861;5;1318;6;0.0;0.0
FR;49;2021-01-07;2160;7;3478;13;0.0;0.0
FR;49;2021-01-08;3380;10;6858;23;0.1;0.0
FR;49;2021-01-09;1003;1;7861;24;0.1;0.0
FR;49;2021-01-10;473;2;8334;26;0.1;0.0
FR;49;2021-01-11;4177;17;12511;43;0.1;0.0
FR;49;2021-01-12;5872;19;18383;62;0.2;0.0
FR;49;2021-01-13;6172;22;24555;84;0.3;0.0
FR;49;2021-01-14;8343;80;32898;164;0.4;0.0
FR;49;2021-01-15;7624;35;40522;199;0.5;0.0
FR;49;2021-01-16;1428;9;41950;208;0.5;0.0
FR;49;2021-01-17;621;6;42571;214;0.5;0.0
FR;49;2021-01-18;5066;33;47637;247;0.6;0.0
FR;49;2021-01-19;6827;29;54464;276;0.6;0.0
FR;49;2021-01-20;6639;32;61103;308;0.7;0.0
FR;49;2021-01-21;8427;36;69530;344;0.8;0.0
FR;49;2021-01-22;6274;42;75804;386;0.9;0.0
FR;49;2021-01-23;1016;7;76820;393;0.9;0.0
FR;49;2021-01-24;282;3;77102;396;0.9;0.0
FR;49;2021-01-25;2622;101;79724;497;0.9;0.0
FR;49;2021-01-26;3742;227;83466;724;1.0;0.0
FR;49;2021-01-27;3990;397;87456;1121;1.0;0.0
FR;49;2021-01-28;5556;991;93012;2112;1.1;0.0
FR;49;2021-01-29;4411;1566;97423;3678;1.1;0.0
FR;49;2021-01-30;693;380;98116;4058;1.1;0.0
FR;49;2021-01-31;137;125;98253;4183;1.1;0.0
FR;49;2021-02-01;1374;2092;99627;6275;1.2;0.1
FR;49;2021-02-02;2295;3204;101922;9479;1.2;0.1
FR;49;2021-02-03;2307;3387;104229;12866;1.2;0.1
FR;49;2021-02-04;3380;4783;107609;17649;1.3;0.2
FR;49;2021-02-05;2800;4892;110409;22541;1.3;0.3
FR;49;2021-02-06;572;891;110981;23432;1.3;0.3
FR;49;2021-02-07;520;294;111501;23726;1.3;0.3
FR;49;2021-02-08;1943;4070;113444;27796;1.3;0.3
FR;49;2021-02-09;4346;5774;117790;33570;1.4;0.4
FR;49;2021-02-10;5510;6090;123300;39660;1.4;0.5
FR;49;2021-02-11;8007;8016;131307;47676;1.5;0.6
FR;49;2021-02-12;7320;6486;138627;54162;1.6;0.6
FR;49;2021-02-13;1703;1028;140330;55190;1.6;0.6
FR;49;2021-02-14;408;407;140738;55597;1.6;0.6
FR;49;2021-02-15;4132;3904;144870;59501;1.7;0.7
FR;49;2021-02-16;5399;5365;150269;64866;1.7;0.8
FR;49;2021-02-17;5146;4684;155415;69550;1.8;0.8
FR;49;2021-02-18;7499;6232;162914;75782;1.9;0.9
FR;49;2021-02-19;7085;4924;169999;80706;2.0;0.9
FR;49;2021-02-20;1494;806;171493;81512;2.0;0.9
FR;49;2021-02-21;279;226;171772;81738;2.0;1.0
FR;49;2021-02-22;3538;2671;175310;84409;2.0;1.0
FR;49;2021-02-23;4885;3156;180195;87565;2.1;1.0
FR;49;2021-02-24;4915;2875;185110;90440;2.2;1.1
FR;49;2021-02-25;7581;4222;192691;94662;2.2;1.1
FR;49;2021-02-26;8287;3206;200978;97868;2.3;1.1
FR;49;2021-02-27;2696;581;203674;98449;2.4;1.1
FR;49;2021-02-28;335;137;204009;98586;2.4;1.1
FR;49;2021-03-01;3857;1659;207866;100245;2.4;1.2
FR;49;2021-03-02;5819;2525;213685;102770;2.5;1.2
FR;49;2021-03-03;6070;2557;219755;105327;2.6;1.2
FR;49;2021-03-04;8973;3529;228728;108856;2.7;1.3
FR;49;2021-03-05;12624;3330;241352;112186;2.8;1.3
FR;49;2021-03-06;8645;654;249997;112840;2.9;1.3
FR;49;2021-03-07;4707;428;254704;113268;3.0;1.3
FR;49;2021-03-08;6444;1716;261148;114984;3.0;1.3
FR;49;2021-03-09;9614;2397;270762;117381;3.2;1.4
FR;49;2021-03-10;9056;2412;279818;119793;3.3;1.4
FR;49;2021-03-11;12937;3527;292755;123320;3.4;1.4
FR;49;2021-03-12;16599;3038;309354;126358;3.6;1.5
FR;49;2021-03-13;9608;668;318962;127026;3.7;1.5
FR;49;2021-03-14;3148;255;322110;127281;3.7;1.5
FR;49;2021-03-15;7023;1484;329133;128765;3.8;1.5
FR;49;2021-03-16;4643;2158;333776;130923;3.9;1.5
FR;49;2021-03-17;5190;2035;338966;132958;3.9;1.5
FR;49;2021-03-18;6566;2827;345532;135785;4.0;1.6
FR;49;2021-03-19;9590;2345;355122;138130;4.1;1.6
FR;49;2021-03-20;5912;589;361034;138719;4.2;1.6
FR;49;2021-03-21;3148;226;364182;138945;4.2;1.6
FR;49;2021-03-22;6327;1508;370509;140453;4.3;1.6
FR;49;2021-03-23;8637;2185;379146;142638;4.4;1.7
FR;49;2021-03-24;9571;2013;388717;144651;4.5;1.7
FR;49;2021-03-25;12414;2414;401131;147065;4.7;1.7
FR;49;2021-03-26;14759;2369;415890;149434;4.8;1.7
FR;49;2021-03-27;9374;879;425264;150313;4.9;1.7
FR;49;2021-03-28;3849;310;429113;150623;5.0;1.8
FR;49;2021-03-29;9907;1878;439020;152501;5.1;1.8
FR;49;2021-03-30;14305;2731;453325;155232;5.3;1.8
FR;49;2021-03-31;15616;2841;468941;158073;5.5;1.8
FR;49;2021-04-01;19907;3785;488848;161858;5.7;1.9
FR;49;2021-04-02;17495;3510;506343;165368;5.9;1.9
FR;49;2021-04-03;9349;1848;515692;167216;6.0;1.9
FR;49;2021-04-04;4120;628;519812;167844;6.0;2.0
FR;49;2021-04-05;4210;538;524022;168382;6.1;2.0
FR;49;2021-04-06;13229;3405;537251;171787;6.3;2.0
FR;49;2021-04-07;17716;4295;554967;176082;6.5;2.0
FR;49;2021-04-08;22483;5249;577450;181331;6.7;2.1
FR;49;2021-04-09;23566;5410;601016;186741;7.0;2.2
FR;49;2021-04-10;12425;3418;613441;190159;7.1;2.2
FR;49;2021-04-11;4475;1685;617916;191844;7.2;2.2
FR;49;2021-04-12;14150;3818;632066;195662;7.4;2.3
FR;49;2021-04-13;18748;5821;650814;201483;7.6;2.3
FR;49;2021-04-14;19445;6001;670259;207484;7.8;2.4
FR;49;2021-04-15;20408;7095;690667;214579;8.0;2.5
FR;49;2021-04-16;17504;7370;708171;221949;8.2;2.6
FR;49;2021-04-17;9898;4685;718069;226634;8.4;2.6
FR;49;2021-04-18;3373;2308;721442;228942;8.4;2.7
FR;49;2021-04-19;12014;6426;733456;235368;8.5;2.7
FR;49;2021-04-20;14238;9064;747694;244432;8.7;2.8
FR;49;2021-04-21;16062;10202;763756;254634;8.9;3.0
FR;49;2021-04-22;17639;13203;781395;267837;9.1;3.1
FR;49;2021-04-23;18164;14160;799559;281997;9.3;3.3
FR;49;2021-04-24;12686;7825;812245;289822;9.5;3.4
FR;49;2021-04-25;5512;3151;817757;292973;9.5;3.4
FR;49;2021-04-26;13792;9994;831549;302967;9.7;3.5
FR;49;2021-04-27;19310;13137;850859;316104;9.9;3.7
FR;49;2021-04-28;25093;14636;875952;330740;10.2;3.8
FR;49;2021-04-29;28715;17378;904667;348118;10.5;4.1
FR;49;2021-04-30;33262;18183;937929;366301;10.9;4.3
FR;49;2021-05-01;25007;5777;962936;372078;11.2;4.3
FR;49;2021-05-02;16559;3902;979495;375980;11.4;4.4
FR;49;2021-05-03;39735;15583;1019230;391563;11.9;4.6
FR;49;2021-05-04;46827;20373;1066057;411936;12.4;4.8
FR;49;2021-05-05;55908;21730;1121965;433666;13.1;5.0
FR;49;2021-05-06;62473;24753;1184438;458419;13.8;5.3
FR;49;2021-05-07;65897;26120;1250335;484539;14.6;5.6
FR;49;2021-05-08;51626;9229;1301961;493768;15.2;5.7
FR;49;2021-05-09;32239;6271;1334200;500039;15.5;5.8
FR;49;2021-05-10;57386;20781;1391586;520820;16.2;6.1
FR;49;2021-05-11;72261;23983;1463847;544803;17.0;6.3
FR;49;2021-05-12;90345;24107;1554192;568910;18.1;6.6
FR;49;2021-05-13;80278;7825;1634470;576735;19.0;6.7
FR;49;2021-05-14;96994;15827;1731464;592562;20.1;6.9
FR;49;2021-05-15;86652;10944;1818116;603506;21.2;7.0
FR;49;2021-05-16;53129;4555;1871245;608061;21.8;7.1
FR;49;2021-05-17;82005;16397;1953250;624458;22.7;7.3
FR;49;2021-05-18;98561;18000;2051811;642458;23.9;7.5
FR;49;2021-05-19;110377;19478;2162188;661936;25.2;7.7
FR;49;2021-05-20;113982;19858;2276170;681794;26.5;7.9
FR;49;2021-05-21;113554;20049;2389724;701843;27.8;8.2
FR;49;2021-05-22;87443;10571;2477167;712414;28.8;8.3
FR;49;2021-05-23;42865;4025;2520032;716439;29.3;8.3
FR;49;2021-05-24;67070;6891;2587102;723330;30.1;8.4
FR;49;2021-05-25;94634;20923;2681736;744253;31.2;8.7
FR;49;2021-05-26;101291;22829;2783027;767082;32.4;8.9
FR;49;2021-05-27;104244;24062;2887271;791144;33.6;9.2
FR;49;2021-05-28;99641;26791;2986912;817935;34.8;9.5
FR;49;2021-05-29;74134;15562;3061046;833497;35.6;9.7
FR;49;2021-05-30;26773;4727;3087819;838224;35.9;9.8
FR;49;2021-05-31;87510;21277;3175329;859501;37.0;10.0
FR;49;2021-06-01;100160;26447;3275489;885948;38.1;10.3
FR;49;2021-06-02;101503;26669;3376992;912617;39.3;10.6
FR;49;2021-06-03;108899;27964;3485891;940581;40.6;10.9
FR;49;2021-06-04;108473;31378;3594364;971959;41.8;11.3
FR;49;2021-06-05;74299;20910;3668663;992869;42.7;11.6
FR;49;2021-06-06;31822;7571;3700485;1000440;43.1;11.6
FR;49;2021-06-07;77239;27812;3777724;1028252;44.0;12.0
FR;49;2021-06-08;103015;26162;3880739;1054414;45.2;12.3
FR;49;2021-06-09;112424;35372;3993163;1089786;46.5;12.7
FR;49;2021-06-10;85453;36264;4078616;1126050;47.5;13.1
FR;59;2020-12-27;2;0;2;0;0.0;0.0
FR;59;2020-12-28;6;0;8;0;0.0;0.0
FR;59;2020-12-29;2;0;10;0;0.0;0.0
FR;59;2020-12-30;6;0;16;0;0.0;0.0
FR;59;2020-12-31;9;0;25;0;0.0;0.0
FR;59;2021-01-01;26;1;51;1;0.0;0.0
FR;59;2021-01-02;30;0;81;1;0.0;0.0
FR;59;2021-01-03;36;0;117;1;0.0;0.0
FR;59;2021-01-04;595;4;712;5;0.0;0.0
FR;59;2021-01-05;2174;8;2886;13;0.0;0.0
FR;59;2021-01-06;4815;17;7701;30;0.1;0.0
FR;59;2021-01-07;10521;33;18222;63;0.2;0.0
FR;59;2021-01-08;14346;31;32568;94;0.4;0.0
FR;59;2021-01-09;4069;11;36637;105;0.4;0.0
FR;59;2021-01-10;1987;3;38624;108;0.4;0.0
FR;59;2021-01-11;15976;38;54600;146;0.6;0.0
FR;59;2021-01-12;21174;58;75774;204;0.9;0.0
FR;59;2021-01-13;22759;69;98533;273;1.1;0.0
FR;59;2021-01-14;24783;246;123316;519;1.4;0.0
FR;59;2021-01-15;21626;115;144942;634;1.6;0.0
FR;59;2021-01-16;5443;30;150385;664;1.7;0.0
FR;59;2021-01-17;1804;12;152189;676;1.7;0.0
FR;59;2021-01-18;13601;90;165790;766;1.9;0.0
FR;59;2021-01-19;17990;102;183780;868;2.1;0.0
FR;59;2021-01-20;17135;89;200915;957;2.3;0.0
FR;59;2021-01-21;18846;86;219761;1043;2.5;0.0
FR;59;2021-01-22;13950;102;233711;1145;2.7;0.0
FR;59;2021-01-23;2962;24;236673;1169;2.7;0.0
FR;59;2021-01-24;847;16;237520;1185;2.7;0.0
FR;59;2021-01-25;6714;626;244234;1811;2.8;0.0
FR;59;2021-01-26;8463;1392;252697;3203;2.9;0.0
FR;59;2021-01-27;8840;2409;261537;5612;3.0;0.1
FR;59;2021-01-28;10522;5061;272059;10673;3.1;0.1
FR;59;2021-01-29;7845;6659;279904;17332;3.2;0.2
FR;59;2021-01-30;1763;1515;281667;18847;3.2;0.2
FR;59;2021-01-31;374;547;282041;19394;3.2;0.2
FR;59;2021-02-01;3179;8745;285220;28139;3.2;0.3
FR;59;2021-02-02;4700;12490;289920;40629;3.3;0.5
FR;59;2021-02-03;4826;13552;294746;54181;3.4;0.6
FR;59;2021-02-04;5960;15909;300706;70090;3.4;0.8
FR;59;2021-02-05;4829;14930;305535;85020;3.5;1.0
FR;59;2021-02-06;1161;2998;306696;88018;3.5;1.0
FR;59;2021-02-07;389;986;307085;89004;3.5;1.0
FR;59;2021-02-08;2770;12482;309855;101486;3.5;1.2
FR;59;2021-02-09;4924;16199;314779;117685;3.6;1.3
FR;59;2021-02-10;5710;16084;320489;133769;3.6;1.5
FR;59;2021-02-11;7681;19740;328170;153509;3.7;1.7
FR;59;2021-02-12;6774;16048;334944;169557;3.8;1.9
FR;59;2021-02-13;1703;3450;336647;173007;3.8;2.0
FR;59;2021-02-14;362;982;337009;173989;3.8;2.0
FR;59;2021-02-15;3279;10550;340288;184539;3.9;2.1
FR;59;2021-02-16;4745;13579;345033;198118;3.9;2.3
FR;59;2021-02-17;4974;12340;350007;210458;4.0;2.4
FR;59;2021-02-18;7095;13875;357102;224333;4.1;2.6
FR;59;2021-02-19;6495;10729;363597;235062;4.1;2.7
FR;59;2021-02-20;1417;2493;365014;237555;4.2;2.7
FR;59;2021-02-21;284;571;365298;238126;4.2;2.7
FR;59;2021-02-22;3267;6381;368565;244507;4.2;2.8
FR;59;2021-02-23;4848;7143;373413;251650;4.2;2.9
FR;59;2021-02-24;6862;6430;380275;258080;4.3;2.9
FR;59;2021-02-25;21236;8566;401511;266646;4.6;3.0
FR;59;2021-02-26;28304;6294;429815;272940;4.9;3.1
FR;59;2021-02-27;17129;1530;446944;274470;5.1;3.1
FR;59;2021-02-28;1115;380;448059;274850;5.1;3.1
FR;59;2021-03-01;8831;3547;456890;278397;5.2;3.2
FR;59;2021-03-02;17214;4950;474104;283347;5.4;3.2
FR;59;2021-03-03;20703;5027;494807;288374;5.6;3.3
FR;59;2021-03-04;32398;5935;527205;294309;6.0;3.3
FR;59;2021-03-05;41095;5515;568300;299824;6.5;3.4
FR;59;2021-03-06;36145;1582;604445;301406;6.9;3.4
FR;59;2021-03-07;14097;1075;618542;302481;7.0;3.4
FR;59;2021-03-08;12354;3214;630896;305695;7.2;3.5
FR;59;2021-03-09;22951;4234;653847;309929;7.4;3.5
FR;59;2021-03-10;23316;4306;677163;314235;7.7;3.6
FR;59;2021-03-11;34469;5528;711632;319763;8.1;3.6
FR;59;2021-03-12;45518;4675;757150;324438;8.6;3.7
FR;59;2021-03-13;36269;1417;793419;325855;9.0;3.7
FR;59;2021-03-14;7215;432;800634;326287;9.1;3.7
FR;59;2021-03-15;14601;2575;815235;328862;9.3;3.7
FR;59;2021-03-16;7909;2986;823144;331848;9.4;3.8
FR;59;2021-03-17;8748;3144;831892;334992;9.5;3.8
FR;59;2021-03-18;10454;4016;842346;339008;9.6;3.9
FR;59;2021-03-19;23571;3564;865917;342572;9.8;3.9
FR;59;2021-03-20;21173;1105;887090;343677;10.1;3.9
FR;59;2021-03-21;6286;393;893376;344070;10.2;3.9
FR;59;2021-03-22;15521;2683;908897;346753;10.3;3.9
FR;59;2021-03-23;25537;3523;934434;350276;10.6;4.0
FR;59;2021-03-24;28349;3516;962783;353792;10.9;4.0
FR;59;2021-03-25;38160;3875;1000943;357667;11.4;4.1
FR;59;2021-03-26;42930;4134;1043873;361801;11.9;4.1
FR;59;2021-03-27;26901;1766;1070774;363567;12.2;4.1
FR;59;2021-03-28;7528;470;1078302;364037;12.3;4.1
FR;59;2021-03-29;21712;3362;1100014;367399;12.5;4.2
FR;59;2021-03-30;32226;4372;1132240;371771;12.9;4.2
FR;59;2021-03-31;31552;4673;1163792;376444;13.2;4.3
FR;59;2021-04-01;38405;5842;1202197;382286;13.7;4.3
FR;59;2021-04-02;36897;5788;1239094;388074;14.1;4.4
FR;59;2021-04-03;21319;3463;1260413;391537;14.3;4.5
FR;59;2021-04-04;7345;1225;1267758;392762;14.4;4.5
FR;59;2021-04-05;8264;1098;1276022;393860;14.5;4.5
FR;59;2021-04-06;25783;5930;1301805;399790;14.8;4.5
FR;59;2021-04-07;34005;7154;1335810;406944;15.2;4.6
FR;59;2021-04-08;45005;8536;1380815;415480;15.7;4.7
FR;59;2021-04-09;60683;9078;1441498;424558;16.4;4.8
FR;59;2021-04-10;36409;7104;1477907;431662;16.8;4.9
FR;59;2021-04-11;9742;3527;1487649;435189;16.9;4.9
FR;59;2021-04-12;35250;7439;1522899;442628;17.3;5.0
FR;59;2021-04-13;49792;10169;1572691;452797;17.9;5.1
FR;59;2021-04-14;50129;10193;1622820;462990;18.5;5.3
FR;59;2021-04-15;59436;11781;1682256;474771;19.1;5.4
FR;59;2021-04-16;63211;12490;1745467;487261;19.9;5.5
FR;59;2021-04-17;41419;9712;1786886;496973;20.3;5.7
FR;59;2021-04-18;12281;4654;1799167;501627;20.5;5.7
FR;59;2021-04-19;33206;11205;1832373;512832;20.8;5.8
FR;59;2021-04-20;44710;14739;1877083;527571;21.3;6.0
FR;59;2021-04-21;47360;16485;1924443;544056;21.9;6.2
FR;59;2021-04-22;55879;19534;1980322;563590;22.5;6.4
FR;59;2021-04-23;65266;20817;2045588;584407;23.3;6.6
FR;59;2021-04-24;47534;15568;2093122;599975;23.8;6.8
FR;59;2021-04-25;16695;5477;2109817;605452;24.0;6.9
FR;59;2021-04-26;41560;17535;2151377;622987;24.5;7.1
FR;59;2021-04-27;58215;23333;2209592;646320;25.1;7.4
FR;59;2021-04-28;68096;25986;2277688;672306;25.9;7.6
FR;59;2021-04-29;79386;31689;2357074;703995;26.8;8.0
FR;59;2021-04-30;93885;36570;2450959;740565;27.9;8.4
FR;59;2021-05-01;44232;11016;2495191;751581;28.4;8.5
FR;59;2021-05-02;23494;7296;2518685;758877;28.6;8.6
FR;59;2021-05-03;62777;26284;2581462;785161;29.4;8.9
FR;59;2021-05-04;71289;34379;2652751;819540;30.2;9.3
FR;59;2021-05-05;77678;37351;2730429;856891;31.1;9.7
FR;59;2021-05-06;89528;43619;2819957;900510;32.1;10.2
FR;59;2021-05-07;98044;53918;2918001;954428;33.2;10.9
FR;59;2021-05-08;58688;16509;2976689;970937;33.9;11.0
FR;59;2021-05-09;39273;10353;3015962;981290;34.3;11.2
FR;59;2021-05-10;95459;40070;3111421;1021360;35.4;11.6
FR;59;2021-05-11;125969;49263;3237390;1070623;36.8;12.2
FR;59;2021-05-12;123360;46129;3360750;1116752;38.2;12.7
FR;59;2021-05-13;92654;14379;3453404;1131131;39.3;12.9
FR;59;2021-05-14;129348;34225;3582752;1165356;40.7;13.3
FR;59;2021-05-15;114426;25446;3697178;1190802;42.0;13.5
FR;59;2021-05-16;55261;7143;3752439;1197945;42.7;13.6
FR;59;2021-05-17;105466;30606;3857905;1228551;43.9;14.0
FR;59;2021-05-18;117520;34087;3975425;1262638;45.2;14.4
FR;59;2021-05-19;118867;35376;4094292;1298014;46.6;14.8
FR;59;2021-05-20;122437;42208;4216729;1340222;48.0;15.2
FR;59;2021-05-21;122061;48562;4338790;1388784;49.3;15.8
FR;59;2021-05-22;81870;25317;4420660;1414101;50.3;16.1
FR;59;2021-05-23;31283;5134;4451943;1419235;50.6;16.1
FR;59;2021-05-24;51974;9897;4503917;1429132;51.2;16.3
FR;59;2021-05-25;84432;41926;4588349;1471058;52.2;16.7
FR;59;2021-05-26;83362;44211;4671711;1515269;53.1;17.2
FR;59;2021-05-27;90067;52387;4761778;1567656;54.2;17.8
FR;59;2021-05-28;91691;66569;4853469;1634225;55.2;18.6
FR;59;2021-05-29;60403;40013;4913872;1674238;55.9;19.0
FR;59;2021-05-30;16147;7782;4930019;1682020;56.1;19.1
FR;59;2021-05-31;58638;42375;4988657;1724395;56.7;19.6
FR;59;2021-06-01;68222;53742;5056879;1778137;57.5;20.2
FR;59;2021-06-02;62435;52904;5119314;1831041;58.2;20.8
FR;59;2021-06-03;69836;58611;5189150;1889652;59.0;21.5
FR;59;2021-06-04;71724;71805;5260874;1961457;59.8;22.3
FR;59;2021-06-05;45686;48759;5306560;2010216;60.4;22.9
FR;59;2021-06-06;14249;12569;5320809;2022785;60.5;23.0
FR;59;2021-06-07;43838;54894;5364647;2077679;61.0;23.6
FR;59;2021-06-08;70534;52715;5435181;2130394;61.8;24.2
FR;59;2021-06-09;71820;64756;5507001;2195150;62.6;25.0
FR;59;2021-06-10;52627;64446;5559628;2259596;63.2;25.7
FR;64;2020-12-27;1;0;1;0;0.0;0.0
FR;64;2020-12-28;1;0;2;0;0.0;0.0
FR;64;2020-12-29;2;0;4;0;0.0;0.0
FR;64;2020-12-30;6;0;10;0;0.0;0.0
FR;64;2020-12-31;5;0;15;0;0.0;0.0
FR;64;2021-01-01;8;0;23;0;0.0;0.0
FR;64;2021-01-02;13;0;36;0;0.0;0.0
FR;64;2021-01-03;19;0;55;0;0.0;0.0
FR;64;2021-01-04;209;2;264;2;0.0;0.0
FR;64;2021-01-05;899;4;1163;6;0.0;0.0
FR;64;2021-01-06;1691;3;2854;9;0.1;0.0
FR;64;2021-01-07;3662;10;6516;19;0.2;0.0
FR;64;2021-01-08;4891;12;11407;31;0.3;0.0
FR;64;2021-01-09;1959;2;13366;33;0.3;0.0
FR;64;2021-01-10;1027;1;14393;34;0.4;0.0
FR;64;2021-01-11;5291;8;19684;42;0.5;0.0
FR;64;2021-01-12;7148;13;26832;55;0.7;0.0
FR;64;2021-01-13;7469;17;34301;72;0.8;0.0
FR;64;2021-01-14;8583;88;42884;160;1.0;0.0
FR;64;2021-01-15;7102;34;49986;194;1.2;0.0
FR;64;2021-01-16;2221;18;52207;212;1.3;0.0
FR;64;2021-01-17;844;10;53051;222;1.3;0.0
FR;64;2021-01-18;4688;17;57739;239;1.4;0.0
FR;64;2021-01-19;6409;24;64148;263;1.6;0.0
FR;64;2021-01-20;6240;35;70388;298;1.7;0.0
FR;64;2021-01-21;6926;26;77314;324;1.9;0.0
FR;64;2021-01-22;5432;32;82746;356;2.0;0.0
FR;64;2021-01-23;1415;13;84161;369;2.1;0.0
FR;64;2021-01-24;436;9;84597;378;2.1;0.0
FR;64;2021-01-25;2774;203;87371;581;2.1;0.0
FR;64;2021-01-26;3544;494;90915;1075;2.2;0.0
FR;64;2021-01-27;3771;886;94686;1961;2.3;0.0
FR;64;2021-01-28;4576;1755;99262;3716;2.4;0.1
FR;64;2021-01-29;3534;2332;102796;6048;2.5;0.1
FR;64;2021-01-30;840;708;103636;6756;2.5;0.2
FR;64;2021-01-31;172;279;103808;7035;2.5;0.2
FR;64;2021-02-01;1530;2870;105338;9905;2.6;0.2
FR;64;2021-02-02;2154;4144;107492;14049;2.6;0.3
FR;64;2021-02-03;2308;4366;109800;18415;2.7;0.4
FR;64;2021-02-04;2830;5511;112630;23926;2.7;0.6
FR;64;2021-02-05;2192;4972;114822;28898;2.8;0.7
FR;64;2021-02-06;667;1305;115489;30203;2.8;0.7
FR;64;2021-02-07;165;493;115654;30696;2.8;0.7
FR;64;2021-02-08;1491;4196;117145;34892;2.9;0.9
FR;64;2021-02-09;2354;5674;119499;40566;2.9;1.0
FR;64;2021-02-10;2573;5683;122072;46249;3.0;1.1
FR;64;2021-02-11;3471;7231;125543;53480;3.1;1.3
FR;64;2021-02-12;3116;5452;128659;58932;3.1;1.4
FR;64;2021-02-13;847;1448;129506;60380;3.2;1.5
FR;64;2021-02-14;198;437;129704;60817;3.2;1.5
FR;64;2021-02-15;1598;3888;131302;64705;3.2;1.6
FR;64;2021-02-16;2095;5144;133397;69849;3.3;1.7
FR;64;2021-02-17;2212;4643;135609;74492;3.3;1.8
FR;64;2021-02-18;3245;5458;138854;79950;3.4;1.9
FR;64;2021-02-19;3020;4213;141874;84163;3.5;2.1
FR;64;2021-02-20;808;1204;142682;85367;3.5;2.1
FR;64;2021-02-21;135;255;142817;85622;3.5;2.1
FR;64;2021-02-22;1490;2667;144307;88289;3.5;2.2
FR;64;2021-02-23;2409;2916;146716;91205;3.6;2.2
FR;64;2021-02-24;3876;2856;150592;94061;3.7;2.3
FR;64;2021-02-25;16066;3874;166658;97935;4.1;2.4
FR;64;2021-02-26;21864;2813;188522;100748;4.6;2.5
FR;64;2021-02-27;13094;781;201616;101529;4.9;2.5
FR;64;2021-02-28;799;174;202415;101703;4.9;2.5
FR;64;2021-03-01;6581;1760;208996;103463;5.1;2.5
FR;64;2021-03-02;13168;2373;222164;105836;5.4;2.6
FR;64;2021-03-03;15997;2417;238161;108253;5.8;2.6
FR;64;2021-03-04;25339;2922;263500;111175;6.4;2.7
FR;64;2021-03-05;30600;2727;294100;113902;7.2;2.8
FR;64;2021-03-06;26921;854;321021;114756;7.8;2.8
FR;64;2021-03-07;9950;543;330971;115299;8.1;2.8
FR;64;2021-03-08;8864;1820;339835;117119;8.3;2.9
FR;64;2021-03-09;16920;2076;356755;119195;8.7;2.9
FR;64;2021-03-10;17229;2211;373984;121406;9.1;3.0
FR;64;2021-03-11;26055;2900;400039;124306;9.8;3.0
FR;64;2021-03-12;33582;2504;433621;126810;10.6;3.1
FR;64;2021-03-13;27436;845;461057;127655;11.2;3.1
FR;64;2021-03-14;5457;212;466514;127867;11.4;3.1
FR;64;2021-03-15;11124;1479;477638;129346;11.6;3.2
FR;64;2021-03-16;5999;1786;483637;131132;11.8;3.2
FR;64;2021-03-17;6138;1692;489775;132824;11.9;3.2
FR;64;2021-03-18;7668;2078;497443;134902;12.1;3.3
FR;64;2021-03-19;19035;1954;516478;136856;12.6;3.3
FR;64;2021-03-20;18628;773;535106;137629;13.0;3.4
FR;64;2021-03-21;4734;229;539840;137858;13.2;3.4
FR;64;2021-03-22;13580;1588;553420;139446;13.5;3.4
FR;64;2021-03-23;23704;2050;577124;141496;14.1;3.4
FR;64;2021-03-24;25571;2145;602695;143641;14.7;3.5
FR;64;2021-03-25;36804;2441;639499;146082;15.6;3.6
FR;64;2021-03-26;40281;2393;679780;148475;16.6;3.6
FR;64;2021-03-27;21337;1046;701117;149521;17.1;3.6
FR;64;2021-03-28;5086;265;706203;149786;17.2;3.7
FR;64;2021-03-29;17594;2153;723797;151939;17.6;3.7
FR;64;2021-03-30;27527;2878;751324;154817;18.3;3.8
FR;64;2021-03-31;24285;2941;775609;157758;18.9;3.8
FR;64;2021-04-01;30697;3813;806306;161571;19.7;3.9
FR;64;2021-04-02;29265;3626;835571;165197;20.4;4.0
FR;64;2021-04-03;16007;2384;851578;167581;20.8;4.1
FR;64;2021-04-04;4031;800;855609;168381;20.9;4.1
FR;64;2021-04-05;5116;802;860725;169183;21.0;4.1
FR;64;2021-04-06;19273;4300;879998;173483;21.5;4.2
FR;64;2021-04-07;23665;4825;903663;178308;22.0;4.3
FR;64;2021-04-08;34602;5658;938265;183966;22.9;4.5
FR;64;2021-04-09;53436;6142;991701;190108;24.2;4.6
FR;64;2021-04-10;29828;5035;1021529;195143;24.9;4.8
FR;64;2021-04-11;6268;2607;1027797;197750;25.1;4.8
FR;64;2021-04-12;28038;5210;1055835;202960;25.7;4.9
FR;64;2021-04-13;42490;7415;1098325;210375;26.8;5.1
FR;64;2021-04-14;40752;7172;1139077;217547;27.8;5.3
FR;64;2021-04-15;51908;8415;1190985;225962;29.0;5.5
FR;64;2021-04-16;64179;8934;1255164;234896;30.6;5.7
FR;64;2021-04-17;38496;7141;1293660;242037;31.5;5.9
FR;64;2021-04-18;10924;3349;1304584;245386;31.8;6.0
FR;64;2021-04-19;41938;8615;1346522;254001;32.8;6.2
FR;64;2021-04-20;52654;10455;1399176;264456;34.1;6.4
FR;64;2021-04-21;52508;10913;1451684;275369;35.4;6.7
FR;64;2021-04-22;57398;12801;1509082;288170;36.8;7.0
FR;64;2021-04-23;60888;12761;1569970;300931;38.3;7.3
FR;64;2021-04-24;43406;9128;1613376;310059;39.3;7.6
FR;64;2021-04-25;16263;3372;1629639;313431;39.7;7.6
FR;64;2021-04-26;50150;11560;1679789;324991;40.9;7.9
FR;64;2021-04-27;65271;15561;1745060;340552;42.5;8.3
FR;64;2021-04-28;69008;16023;1814068;356575;44.2;8.7
FR;64;2021-04-29;75365;20458;1889433;377033;46.1;9.2
FR;64;2021-04-30;76999;22001;1966432;399034;47.9;9.7
FR;64;2021-05-01;30339;6669;1996771;405703;48.7;9.9
FR;64;2021-05-02;14486;3980;2011257;409683;49.0;10.0
FR;64;2021-05-03;52252;15839;2063509;425522;50.3;10.4
FR;64;2021-05-04;53224;21626;2116733;447148;51.6;10.9
FR;64;2021-05-05;49629;22691;2166362;469839;52.8;11.5
FR;64;2021-05-06;56810;28813;2223172;498652;54.2;12.2
FR;64;2021-05-07;50908;33990;2274080;532642;55.4;13.0
FR;64;2021-05-08;20313;9311;2294393;541953;55.9;13.2
FR;64;2021-05-09;10028;5490;2304421;547443;56.2;13.3
FR;64;2021-05-10;34470;26766;2338891;574209;57.0;14.0
FR;64;2021-05-11;44198;37118;2383089;611327;58.1;14.9
FR;64;2021-05-12;39309;34955;2422398;646282;59.1;15.8
FR;64;2021-05-13;22047;10043;2444445;656325;59.6;16.0
FR;64;2021-05-14;36449;29037;2480894;685362;60.5;16.7
FR;64;2021-05-15;21288;18993;2502182;704355;61.0;17.2
FR;64;2021-05-16;7963;4303;2510145;708658;61.2;17.3
FR;64;2021-05-17;26884;25398;2537029;734056;61.8;17.9
FR;64;2021-05-18;33532;28325;2570561;762381;62.7;18.6
FR;64;2021-05-19;30497;26374;2601058;788755;63.4;19.2
FR;64;2021-05-20;35008;33249;2636066;822004;64.3;20.0
FR;64;2021-05-21;30302;37376;2666368;859380;65.0;20.9
FR;64;2021-05-22;14840;17697;2681208;877077;65.4;21.4
FR;64;2021-05-23;5130;2827;2686338;879904;65.5;21.4
FR;64;2021-05-24;10770;6489;2697108;886393;65.7;21.6
FR;64;2021-05-25;22714;34333;2719822;920726;66.3;22.4
FR;64;2021-05-26;21473;34972;2741295;955698;66.8;23.3
FR;64;2021-05-27;26021;42994;2767316;998692;67.5;24.3
FR;64;2021-05-28;24476;55737;2791792;1054429;68.1;25.7
FR;64;2021-05-29;11981;33515;2803773;1087944;68.3;26.5
FR;64;2021-05-30;2684;7431;2806457;1095375;68.4;26.7
FR;64;2021-05-31;15875;45980;2822332;1141355;68.8;27.8
FR;64;2021-06-01;20839;56384;2843171;1197739;69.3;29.2
FR;64;2021-06-02;17072;50476;2860243;1248215;69.7;30.4
FR;64;2021-06-03;21248;55065;2881491;1303280;70.2;31.8
FR;64;2021-06-04;19815;66597;2901306;1369877;70.7;33.4
FR;64;2021-06-05;9362;43235;2910668;1413112;71.0;34.4
FR;64;2021-06-06;2663;10958;2913331;1424070;71.0;34.7
FR;64;2021-06-07;12338;60973;2925669;1485043;71.3;36.2
FR;64;2021-06-08;32482;57446;2958151;1542489;72.1;37.6
FR;64;2021-06-09;31110;58187;2989261;1600676;72.9;39.0
FR;64;2021-06-10;16131;56832;3005392;1657508;73.3;40.4
FR;69;2020-12-27;2;0;2;0;0.0;0.0
FR;69;2020-12-28;2;0;4;0;0.0;0.0
FR;69;2020-12-29;3;0;7;0;0.0;0.0
FR;69;2020-12-30;8;0;15;0;0.0;0.0
FR;69;2020-12-31;5;0;20;0;0.0;0.0
FR;69;2021-01-01;6;0;26;0;0.0;0.0
FR;69;2021-01-02;11;1;37;1;0.0;0.0
FR;69;2021-01-03;8;0;45;1;0.0;0.0
FR;69;2021-01-04;115;0;160;1;0.0;0.0
FR;69;2021-01-05;411;4;571;5;0.0;0.0
FR;69;2021-01-06;810;2;1381;7;0.0;0.0
FR;69;2021-01-07;1893;3;3274;10;0.1;0.0
FR;69;2021-01-08;2461;0;5735;10;0.1;0.0
FR;69;2021-01-09;1125;1;6860;11;0.2;0.0
FR;69;2021-01-10;659;1;7519;12;0.2;0.0
FR;69;2021-01-11;2738;6;10257;18;0.3;0.0
FR;69;2021-01-12;3884;1;14141;19;0.4;0.0
FR;69;2021-01-13;3801;13;17942;32;0.5;0.0
FR;69;2021-01-14;4568;47;22510;79;0.6;0.0
FR;69;2021-01-15;3853;14;26363;93;0.7;0.0
FR;69;2021-01-16;1344;12;27707;105;0.7;0.0
FR;69;2021-01-17;634;3;28341;108;0.7;0.0
FR;69;2021-01-18;3261;18;31602;126;0.8;0.0
FR;69;2021-01-19;4799;22;36401;148;0.9;0.0
FR;69;2021-01-20;4768;16;41169;164;1.1;0.0
FR;69;2021-01-21;5550;20;46719;184;1.2;0.0
FR;69;2021-01-22;4370;19;51089;203;1.3;0.0
FR;69;2021-01-23;1363;5;52452;208;1.3;0.0
FR;69;2021-01-24;448;6;52900;214;1.4;0.0
FR;69;2021-01-25;2729;82;55629;296;1.4;0.0
FR;69;2021-01-26;3365;183;58994;479;1.5;0.0
FR;69;2021-01-27;3672;413;62666;892;1.6;0.0
FR;69;2021-01-28;4334;895;67000;1787;1.7;0.0
FR;69;2021-01-29;3489;1237;70489;3024;1.8;0.1
FR;69;2021-01-30;939;403;71428;3427;1.8;0.1
FR;69;2021-01-31;180;162;71608;3589;1.8;0.1
FR;69;2021-02-01;1828;1522;73436;5111;1.9;0.1
FR;69;2021-02-02;2429;2202;75865;7313;1.9;0.2
FR;69;2021-02-03;2426;2272;78291;9585;2.0;0.2
FR;69;2021-02-04;2990;2927;81281;12512;2.1;0.3
FR;69;2021-02-05;2515;2539;83796;15051;2.1;0.4
FR;69;2021-02-06;727;809;84523;15860;2.2;0.4
FR;69;2021-02-07;162;391;84685;16251;2.2;0.4
FR;69;2021-02-08;1611;2411;86296;18662;2.2;0.5
FR;69;2021-02-09;2430;3418;88726;22080;2.3;0.6
FR;69;2021-02-10;2572;3408;91298;25488;2.3;0.7
FR;69;2021-02-11;3535;4867;94833;30355;2.4;0.8
FR;69;2021-02-12;3166;3425;97999;33780;2.5;0.9
FR;69;2021-02-13;868;1034;98867;34814;2.5;0.9
FR;69;2021-02-14;217;414;99084;35228;2.5;0.9
FR;69;2021-02-15;1347;2781;100431;38009;2.6;1.0
FR;69;2021-02-16;1878;3985;102309;41994;2.6;1.1
FR;69;2021-02-17;2015;3665;104324;45659;2.7;1.2
FR;69;2021-02-18;3009;4563;107333;50222;2.8;1.3
FR;69;2021-02-19;2882;3513;110215;53735;2.8;1.4
FR;69;2021-02-20;755;1028;110970;54763;2.8;1.4
FR;69;2021-02-21;150;236;111120;54999;2.8;1.4
FR;69;2021-02-22;1616;2577;112736;57576;2.9;1.5
FR;69;2021-02-23;2285;2823;115021;60399;2.9;1.5
FR;69;2021-02-24;2666;2911;117687;63310;3.0;1.6
FR;69;2021-02-25;3890;3586;121577;66896;3.1;1.7
FR;69;2021-02-26;4290;2634;125867;69530;3.2;1.8
FR;69;2021-02-27;1822;706;127689;70236;3.3;1.8
FR;69;2021-02-28;312;179;128001;70415;3.3;1.8
FR;69;2021-03-01;2814;1941;130815;72356;3.4;1.9
FR;69;2021-03-02;4729;2450;135544;74806;3.5;1.9
FR;69;2021-03-03;6747;2483;142291;77289;3.6;2.0
FR;69;2021-03-04;11828;3045;154119;80334;3.9;2.1
FR;69;2021-03-05;17557;2726;171676;83060;4.4;2.1
FR;69;2021-03-06;23284;827;194960;83887;5.0;2.1
FR;69;2021-03-07;14812;473;209772;84360;5.4;2.2
FR;69;2021-03-08;9815;2067;219587;86427;5.6;2.2
FR;69;2021-03-09;17568;2519;237155;88946;6.1;2.3
FR;69;2021-03-10;18912;2579;256067;91525;6.6;2.3
FR;69;2021-03-11;29353;3279;285420;94804;7.3;2.4
FR;69;2021-03-12;40076;3022;325496;97826;8.3;2.5
FR;69;2021-03-13;36199;1045;361695;98871;9.3;2.5
FR;69;2021-03-14;8230;266;369925;99137;9.5;2.5
FR;69;2021-03-15;16794;1835;386719;100972;9.9;2.6
FR;69;2021-03-16;10733;2190;397452;103162;10.2;2.6
FR;69;2021-03-17;11755;2200;409207;105362;10.5;2.7
FR;69;2021-03-18;13133;2618;422340;107980;10.8;2.8
FR;69;2021-03-19;28942;2460;451282;110440;11.6;2.8
FR;69;2021-03-20;27089;908;478371;111348;12.3;2.9
FR;69;2021-03-21;7136;282;485507;111630;12.4;2.9
FR;69;2021-03-22;21311;2196;506818;113826;13.0;2.9
FR;69;2021-03-23;36517;2818;543335;116644;13.9;3.0
FR;69;2021-03-24;37976;2865;581311;119509;14.9;3.1
FR;69;2021-03-25;55208;3155;636519;122664;16.3;3.1
FR;69;2021-03-26;59430;3040;695949;125704;17.8;3.2
FR;69;2021-03-27;30216;1406;726165;127110;18.6;3.3
FR;69;2021-03-28;7612;397;733777;127507;18.8;3.3
FR;69;2021-03-29;27730;3483;761507;130990;19.5;3.4
FR;69;2021-03-30;42570;4403;804077;135393;20.6;3.5
FR;69;2021-03-31;35967;4429;840044;139822;21.5;3.6
FR;69;2021-04-01;43395;5809;883439;145631;22.6;3.7
FR;69;2021-04-02;41476;5946;924915;151577;23.7;3.9
FR;69;2021-04-03;21713;3940;946628;155517;24.3;4.0
FR;69;2021-04-04;5827;1309;952455;156826;24.4;4.0
FR;69;2021-04-05;7633;1069;960088;157895;24.6;4.0
FR;69;2021-04-06;28033;7217;988121;165112;25.3;4.2
FR;69;2021-04-07;32749;7772;1020870;172884;26.2;4.4
FR;69;2021-04-08;48636;8905;1069506;181789;27.4;4.7
FR;69;2021-04-09;70661;9086;1140167;190875;29.2;4.9
FR;69;2021-04-10;36720;7871;1176887;198746;30.2;5.1
FR;69;2021-04-11;7984;4288;1184871;203034;30.4;5.2
FR;69;2021-04-12;38615;8863;1223486;211897;31.4;5.4
FR;69;2021-04-13;53557;11989;1277043;223886;32.7;5.7
FR;69;2021-04-14;49379;11676;1326422;235562;34.0;6.0
FR;69;2021-04-15;61853;13556;1388275;249118;35.6;6.4
FR;69;2021-04-16;72598;14100;1460873;263218;37.4;6.7
FR;69;2021-04-17;39637;10709;1500510;273927;38.5;7.0
FR;69;2021-04-18;10029;5032;1510539;278959;38.7;7.1
FR;69;2021-04-19;45900;13907;1556439;292866;39.9;7.5
FR;69;2021-04-20;57217;16842;1613656;309708;41.4;7.9
FR;69;2021-04-21;53534;16576;1667190;326284;42.7;8.4
FR;69;2021-04-22;60291;18759;1727481;345043;44.3;8.8
FR;69;2021-04-23;59445;18796;1786926;363839;45.8;9.3
FR;69;2021-04-24;37368;13172;1824294;377011;46.8;9.7
FR;69;2021-04-25;13299;5009;1837593;382020;47.1;9.8
FR;69;2021-04-26;49845;18392;1887438;400412;48.4;10.3
FR;69;2021-04-27;63905;23231;1951343;423643;50.0;10.9
FR;69;2021-04-28;64797;22114;2016140;445757;51.7;11.4
FR;69;2021-04-29;71805;24883;2087945;470640;53.5;12.1
FR;69;2021-04-30;68698;23919;2156643;494559;55.3;12.7
FR;69;2021-05-01;24898;7615;2181541;502174;55.9;12.9
FR;69;2021-05-02;11223;5147;2192764;507321;56.2;13.0
FR;69;2021-05-03;47423;21334;2240187;528655;57.4;13.5
FR;69;2021-05-04;48072;27729;2288259;556384;58.6;14.3
FR;69;2021-05-05;42946;27152;2331205;583536;59.7;15.0
FR;69;2021-05-06;50872;30232;2382077;613768;61.0;15.7
FR;69;2021-05-07;42377;34319;2424454;648087;62.1;16.6
FR;69;2021-05-08;15328;9379;2439782;657466;62.5;16.8
FR;69;2021-05-09;7301;6568;2447083;664034;62.7;17.0
FR;69;2021-05-10;29697;34714;2476780;698748;63.5;17.9
FR;69;2021-05-11;38457;43765;2515237;742513;64.5;19.0
FR;69;2021-05-12;34123;39214;2549360;781727;65.3;20.0
FR;69;2021-05-13;17641;11508;2567001;793235;65.8;20.3
FR;69;2021-05-14;30296;34174;2597297;827409;66.6;21.2
FR;69;2021-05-15;15403;18529;2612700;845938;67.0;21.7
FR;69;2021-05-16;5435;4315;2618135;850253;67.1;21.8
FR;69;2021-05-17;21879;28797;2640014;879050;67.7;22.5
FR;69;2021-05-18;28016;29632;2668030;908682;68.4;23.3
FR;69;2021-05-19;24479;25232;2692509;933914;69.0;23.9
FR;69;2021-05-20;28403;27828;2720912;961742;69.7;24.6
FR;69;2021-05-21;23031;30744;2743943;992486;70.3;25.4
FR;69;2021-05-22;9684;14370;2753627;1006856;70.6;25.8
FR;69;2021-05-23;3190;2377;2756817;1009233;70.7;25.9
FR;69;2021-05-24;8113;7130;2764930;1016363;70.9;26.0
FR;69;2021-05-25;17889;36209;2782819;1052572;71.3;27.0
FR;69;2021-05-26;16411;34487;2799230;1087059;71.7;27.9
FR;69;2021-05-27;20621;42294;2819851;1129353;72.3;28.9
FR;69;2021-05-28;18318;53867;2838169;1183220;72.7;30.3
FR;69;2021-05-29;7679;31255;2845848;1214475;72.9;31.1
FR;69;2021-05-30;1710;6904;2847558;1221379;73.0;31.3
FR;69;2021-05-31;12339;47513;2859897;1268892;73.3;32.5
FR;69;2021-06-01;16206;57668;2876103;1326560;73.7;34.0
FR;69;2021-06-02;13016;50051;2889119;1376611;74.0;35.3
FR;69;2021-06-03;16396;57711;2905515;1434322;74.5;36.8
FR;69;2021-06-04;14585;67160;2920100;1501482;74.8;38.5
FR;69;2021-06-05;6073;39521;2926173;1541003;75.0;39.5
FR;69;2021-06-06;1571;9080;2927744;1550083;75.0;39.7
FR;69;2021-06-07;9759;59608;2937503;1609691;75.3;41.3
FR;69;2021-06-08;30269;56147;2967772;1665838;76.1;42.7
FR;69;2021-06-09;28448;54591;2996220;1720429;76.8;44.1
FR;69;2021-06-10;13555;57700;3009775;1778129;77.1;45.6
FR;74;2020-12-27;1;0;1;0;0.0;0.0
FR;74;2020-12-28;7;0;8;0;0.0;0.0
FR;74;2020-12-29;5;0;13;0;0.0;0.0
FR;74;2020-12-30;11;0;24;0;0.0;0.0
FR;74;2020-12-31;7;0;31;0;0.0;0.0
FR;74;2021-01-01;5;0;36;0;0.0;0.0
FR;74;2021-01-02;3;0;39;0;0.0;0.0
FR;74;2021-01-03;13;0;52;0;0.0;0.0
FR;74;2021-01-04;89;1;141;1;0.0;0.0
FR;74;2021-01-05;298;0;439;1;0.0;0.0
FR;74;2021-01-06;555;1;994;2;0.0;0.0
FR;74;2021-01-07;1465;0;2459;2;0.1;0.0
FR;74;2021-01-08;1806;4;4265;6;0.1;0.0
FR;74;2021-01-09;799;0;5064;6;0.1;0.0
FR;74;2021-01-10;539;0;5603;6;0.2;0.0
FR;74;2021-01-11;2130;2;7733;8;0.2;0.0
FR;74;2021-01-12;3155;4;10888;12;0.3;0.0
FR;74;2021-01-13;3213;6;14101;18;0.4;0.0
FR;74;2021-01-14;3956;41;18057;59;0.5;0.0
FR;74;2021-01-15;3546;11;21603;70;0.6;0.0
FR;74;2021-01-16;1337;5;22940;75;0.7;0.0
FR;74;2021-01-17;765;4;23705;79;0.7;0.0
FR;74;2021-01-18;4725;13;28430;92;0.8;0.0
FR;74;2021-01-19;6832;14;35262;106;1.0;0.0
FR;74;2021-01-20;7122;12;42384;118;1.2;0.0
FR;74;2021-01-21;8215;26;50599;144;1.5;0.0
FR;74;2021-01-22;6558;22;57157;166;1.6;0.0
FR;74;2021-01-23;2262;4;59419;170;1.7;0.0
FR;74;2021-01-24;611;2;60030;172;1.7;0.0
FR;74;2021-01-25;4547;56;64577;228;1.9;0.0
FR;74;2021-01-26;5638;150;70215;378;2.0;0.0
FR;74;2021-01-27;5987;272;76202;650;2.2;0.0
FR;74;2021-01-28;6986;750;83188;1400;2.4;0.0
FR;74;2021-01-29;5741;902;88929;2302;2.6;0.1
FR;74;2021-01-30;1770;262;90699;2564;2.6;0.1
FR;74;2021-01-31;296;114;90995;2678;2.6;0.1
FR;74;2021-02-01;3300;1064;94295;3742;2.7;0.1
FR;74;2021-02-02;4315;1785;98610;5527;2.8;0.2
FR;74;2021-02-03;4322;1808;102932;7335;3.0;0.2
FR;74;2021-02-04;5187;2468;108119;9803;3.1;0.3
FR;74;2021-02-05;4397;2180;112516;11983;3.2;0.3
FR;74;2021-02-06;1412;695;113928;12678;3.3;0.4
FR;74;2021-02-07;244;351;114172;13029;3.3;0.4
FR;74;2021-02-08;3086;2507;117258;15536;3.4;0.4
FR;74;2021-02-09;4128;3726;121386;19262;3.5;0.6
FR;74;2021-02-10;4431;3819;125817;23081;3.6;0.7
FR;74;2021-02-11;5647;5480;131464;28561;3.8;0.8
FR;74;2021-02-12;5281;3821;136745;32382;3.9;0.9
FR;74;2021-02-13;1653;1222;138398;33604;4.0;1.0
FR;74;2021-02-14;408;471;138806;34075;4.0;1.0
FR;74;2021-02-15;2417;4184;141223;38259;4.1;1.1
FR;74;2021-02-16;3284;5633;144507;43892;4.2;1.3
FR;74;2021-02-17;3398;5455;147905;49347;4.3;1.4
FR;74;2021-02-18;4944;6816;152849;56163;4.4;1.6
FR;74;2021-02-19;4887;5419;157736;61582;4.5;1.8
FR;74;2021-02-20;1551;1739;159287;63321;4.6;1.8
FR;74;2021-02-21;233;415;159520;63736;4.6;1.8
FR;74;2021-02-22;2868;4293;162388;68029;4.7;2.0
FR;74;2021-02-23;4155;4900;166543;72929;4.8;2.1
FR;74;2021-02-24;4526;4850;171069;77779;4.9;2.2
FR;74;2021-02-25;5537;5706;176606;83485;5.1;2.4
FR;74;2021-02-26;5495;4482;182101;87967;5.2;2.5
FR;74;2021-02-27;2031;1367;184132;89334;5.3;2.6
FR;74;2021-02-28;529;294;184661;89628;5.3;2.6
FR;74;2021-03-01;5091;3375;189752;93003;5.5;2.7
FR;74;2021-03-02;7483;4292;197235;97295;5.7;2.8
FR;74;2021-03-03;9740;4275;206975;101570;6.0;2.9
FR;74;2021-03-04;15145;4851;222120;106421;6.4;3.1
FR;74;2021-03-05;21763;4641;243883;111062;7.0;3.2
FR;74;2021-03-06;31358;1465;275241;112527;7.9;3.2
FR;74;2021-03-07;21017;587;296258;113114;8.5;3.3
FR;74;2021-03-08;14297;3706;310555;116820;8.9;3.4
FR;74;2021-03-09;24143;4272;334698;121092;9.6;3.5
FR;74;2021-03-10;26406;4471;361104;125563;10.4;3.6
FR;74;2021-03-11;38479;5403;399583;130966;11.5;3.8
FR;74;2021-03-12;50861;4822;450444;135788;13.0;3.9
FR;74;2021-03-13;48052;1660;498496;137448;14.3;4.0
FR;74;2021-03-14;12019;452;510515;137900;14.7;4.0
FR;74;2021-03-15;25673;3192;536188;141092;15.4;4.1
FR;74;2021-03-16;20048;3875;556236;144967;16.0;4.2
FR;74;2021-03-17;21813;3908;578049;148875;16.6;4.3
FR;74;2021-03-18;24450;4561;602499;153436;17.3;4.4
FR;74;2021-03-19;41509;4043;644008;157479;18.5;4.5
FR;74;2021-03-20;35547;1615;679555;159094;19.5;4.6
FR;74;2021-03-21;9488;420;689043;159514;19.8;4.6
FR;74;2021-03-22;31624;3942;720667;163456;20.7;4.7
FR;74;2021-03-23;50507;4884;771174;168340;22.2;4.8
FR;74;2021-03-24;52635;5257;823809;173597;23.7;5.0
FR;74;2021-03-25;74987;5661;898796;179258;25.8;5.2
FR;74;2021-03-26;81032;5322;979828;184580;28.2;5.3
FR;74;2021-03-27;51154;2459;1030982;187039;29.6;5.4
FR;74;2021-03-28;17811;760;1048793;187799;30.2;5.4
FR;74;2021-03-29;56151;6960;1104944;194759;31.8;5.6
FR;74;2021-03-30;76867;8834;1181811;203593;34.0;5.9
FR;74;2021-03-31;68425;9388;1250236;212981;35.9;6.1
FR;74;2021-04-01;78433;11786;1328669;224767;38.2;6.5
FR;74;2021-04-02;70099;12355;1398768;237122;40.2;6.8
FR;74;2021-04-03;37187;8470;1435955;245592;41.3;7.1
FR;74;2021-04-04;12499;2794;1448454;248386;41.6;7.1
FR;74;2021-04-05;19205;1885;1467659;250271;42.2;7.2
FR;74;2021-04-06;64517;15149;1532176;265420;44.0;7.6
FR;74;2021-04-07;72840;16022;1605016;281442;46.1;8.1
FR;74;2021-04-08;87664;17960;1692680;299402;48.7;8.6
FR;74;2021-04-09;97299;17759;1789979;317161;51.5;9.1
FR;74;2021-04-10;48637;14046;1838616;331207;52.9;9.5
FR;74;2021-04-11;12723;6825;1851339;338032;53.2;9.7
FR;74;2021-04-12;60907;17727;1912246;355759;55.0;10.2
FR;74;2021-04-13;68754;22218;1981000;377977;57.0;10.9
FR;74;2021-04-14;60152;21798;2041152;399775;58.7;11.5
FR;74;2021-04-15;61968;23743;2103120;423518;60.5;12.2
FR;74;2021-04-16;52251;24329;2155371;447847;62.0;12.9
FR;74;2021-04-17;25722;16801;2181093;464648;62.7;13.4
FR;74;2021-04-18;5741;6964;2186834;471612;62.9;13.6
FR;74;2021-04-19;31744;24297;2218578;495909;63.8;14.3
FR;74;2021-04-20;36356;29584;2254934;525493;64.8;15.1
FR;74;2021-04-21;33420;30215;2288354;555708;65.8;16.0
FR;74;2021-04-22;38121;35175;2326475;590883;66.9;17.0
FR;74;2021-04-23;34884;38781;2361359;629664;67.9;18.1
FR;74;2021-04-24;18702;30723;2380061;660387;68.4;19.0
FR;74;2021-04-25;6169;12559;2386230;672946;68.6;19.3
FR;74;2021-04-26;26839;46857;2413069;719803;69.4;20.7
FR;74;2021-04-27;34098;56021;2447167;775824;70.4;22.3
FR;74;2021-04-28;35165;52806;2482332;828630;71.4;23.8
FR;74;2021-04-29;39474;53936;2521806;882566;72.5;25.4
FR;74;2021-04-30;35854;49102;2557660;931668;73.5;26.8
FR;74;2021-05-01;11560;15130;2569220;946798;73.9;27.2
FR;74;2021-05-02;5182;11386;2574402;958184;74.0;27.5
FR;74;2021-05-03;24184;52087;2598586;1010271;74.7;29.0
FR;74;2021-05-04;25147;69201;2623733;1079472;75.4;31.0
FR;74;2021-05-05;22803;64902;2646536;1144374;76.1;32.9
FR;74;2021-05-06;27355;63254;2673891;1207628;76.9;34.7
FR;74;2021-05-07;23289;65980;2697180;1273608;77.5;36.6
FR;74;2021-05-08;7946;14301;2705126;1287909;77.8;37.0
FR;74;2021-05-09;3667;10472;2708793;1298381;77.9;37.3
FR;74;2021-05-10;16048;63050;2724841;1361431;78.3;39.1
FR;74;2021-05-11;21183;64093;2746024;1425524;78.9;41.0
FR;74;2021-05-12;18967;53149;2764991;1478673;79.5;42.5
FR;74;2021-05-13;9154;12080;2774145;1490753;79.8;42.9
FR;74;2021-05-14;17098;37749;2791243;1528502;80.2;43.9
FR;74;2021-05-15;8443;17565;2799686;1546067;80.5;44.4
FR;74;2021-05-16;2997;3500;2802683;1549567;80.6;44.5
FR;74;2021-05-17;12236;30788;2814919;1580355;80.9;45.4
FR;74;2021-05-18;15471;30482;2830390;1610837;81.4;46.3
FR;74;2021-05-19;14063;25393;2844453;1636230;81.8;47.0
FR;74;2021-05-20;16024;27685;2860477;1663915;82.2;47.8
FR;74;2021-05-21;13382;30684;2873859;1694599;82.6;48.7
FR;74;2021-05-22;5775;14217;2879634;1708816;82.8;49.1
FR;74;2021-05-23;1855;2381;2881489;1711197;82.8;49.2
FR;74;2021-05-24;4636;5723;2886125;1716920;83.0;49.4
FR;74;2021-05-25;10577;35185;2896702;1752105;83.3;50.4
FR;74;2021-05-26;10046;32953;2906748;1785058;83.6;51.3
FR;74;2021-05-27;11856;39465;2918604;1824523;83.9;52.5
FR;74;2021-05-28;11240;45047;2929844;1869570;84.2;53.7
FR;74;2021-05-29;4771;24301;2934615;1893871;84.4;54.4
FR;74;2021-05-30;1044;4239;2935659;1898110;84.4;54.6
FR;74;2021-05-31;7578;29839;2943237;1927949;84.6;55.4
FR;74;2021-06-01;10275;40162;2953512;1968111;84.9;56.6
FR;74;2021-06-02;8465;34107;2961977;2002218;85.2;57.6
FR;74;2021-06-03;10540;42338;2972517;2044556;85.5;58.8
FR;74;2021-06-04;9703;48099;2982220;2092655;85.7;60.2
FR;74;2021-06-05;4051;25161;2986271;2117816;85.9;60.9
FR;74;2021-06-06;938;4685;2987209;2122501;85.9;61.0
FR;74;2021-06-07;6146;31695;2993355;2154196;86.1;61.9
FR;74;2021-06-08;18210;32060;3011565;2186256;86.6;62.9
FR;74;2021-06-09;17331;32259;3028896;2218515;87.1;63.8
FR;74;2021-06-10;8720;37774;3037616;2256289;87.3;64.9
FR;79;2020-12-27;1;0;1;0;0.0;0.0
FR;79;2020-12-28;6;0;7;0;0.0;0.0
FR;79;2020-12-29;16;0;23;0;0.0;0.0
FR;79;2020-12-30;12;0;35;0;0.0;0.0
FR;79;2020-12-31;6;0;41;0;0.0;0.0
FR;79;2021-01-01;6;0;47;0;0.0;0.0
FR;79;2021-01-02;4;0;51;0;0.0;0.0
FR;79;2021-01-03;2;0;53;0;0.0;0.0
FR;79;2021-01-04;50;0;103;0;0.0;0.0
FR;79;2021-01-05;172;0;275;0;0.0;0.0
FR;79;2021-01-06;341;1;616;1;0.0;0.0
FR;79;2021-01-07;905;0;1521;1;0.1;0.0
FR;79;2021-01-08;1086;1;2607;2;0.1;0.0
FR;79;2021-01-09;364;0;2971;2;0.1;0.0
FR;79;2021-01-10;192;0;3163;2;0.1;0.0
FR;79;2021-01-11;1158;3;4321;5;0.2;0.0
FR;79;2021-01-12;2210;2;6531;7;0.3;0.0
FR;79;2021-01-13;2758;2;9289;9;0.4;0.0
FR;79;2021-01-14;4440;35;13729;44;0.6;0.0
FR;79;2021-01-15;5275;18;19004;62;0.9;0.0
FR;79;2021-01-16;2827;12;21831;74;1.0;0.0
FR;79;2021-01-17;1309;3;23140;77;1.0;0.0
FR;79;2021-01-18;19681;40;42821;117;1.9;0.0
FR;79;2021-01-19;26071;39;68892;156;3.1;0.0
FR;79;2021-01-20;28081;34;96973;190;4.4;0.0
FR;79;2021-01-21;30106;40;127079;230;5.7;0.0
FR;79;2021-01-22;27960;33;155039;263;7.0;0.0
FR;79;2021-01-23;11681;12;166720;275;7.5;0.0
FR;79;2021-01-24;2174;3;168894;278;7.6;0.0
FR;79;2021-01-25;22582;51;191476;329;8.6;0.0
FR;79;2021-01-26;25763;121;217239;450;9.8;0.0
FR;79;2021-01-27;25042;199;242281;649;10.9;0.0
FR;79;2021-01-28;25234;566;267515;1215;12.1;0.1
FR;79;2021-01-29;22557;565;290072;1780;13.1;0.1
FR;79;2021-01-30;8792;138;298864;1918;13.5;0.1
FR;79;2021-01-31;1233;55;300097;1973;13.5;0.1
FR;79;2021-02-01;16187;649;316284;2622;14.3;0.1
FR;79;2021-02-02;19309;1276;335593;3898;15.1;0.2
FR;79;2021-02-03;18324;1588;353917;5486;16.0;0.2
FR;79;2021-02-04;19212;2538;373129;8024;16.8;0.4
FR;79;2021-02-05;18064;2689;391193;10713;17.6;0.5
FR;79;2021-02-06;6460;1008;397653;11721;17.9;0.5
FR;79;2021-02-07;870;392;398523;12113;18.0;0.5
FR;79;2021-02-08;13116;5819;411639;17932;18.6;0.8
FR;79;2021-02-09;15598;7683;427237;25615;19.3;1.2
FR;79;2021-02-10;15469;8061;442706;33676;20.0;1.5
FR;79;2021-02-11;16550;9614;459256;43290;20.7;2.0
FR;79;2021-02-12;15694;9422;474950;52712;21.4;2.4
FR;79;2021-02-13;5009;4125;479959;56837;21.6;2.6
FR;79;2021-02-14;905;1044;480864;57881;21.7;2.6
FR;79;2021-02-15;7138;19837;488002;77718;22.0;3.5
FR;79;2021-02-16;8364;23638;496366;101356;22.4;4.6
FR;79;2021-02-17;8258;24034;504624;125390;22.8;5.7
FR;79;2021-02-18;10324;24435;514948;149825;23.2;6.8
FR;79;2021-02-19;10340;20773;525288;170598;23.7;7.7
FR;79;2021-02-20;3768;8316;529056;178914;23.9;8.1
FR;79;2021-02-21;550;1557;529606;180471;23.9;8.1
FR;79;2021-02-22;6997;21896;536603;202367;24.2;9.1
FR;79;2021-02-23;9662;23574;546265;225941;24.6;10.2
FR;79;2021-02-24;10050;22216;556315;248157;25.1;11.2
FR;79;2021-02-25;11704;22102;568019;270259;25.6;12.2
FR;79;2021-02-26;12096;19134;580115;289393;26.2;13.1
FR;79;2021-02-27;4431;6739;584546;296132;26.4;13.4
FR;79;2021-02-28;876;1038;585422;297170;26.4;13.4
FR;79;2021-03-01;12137;16470;597559;313640;26.9;14.1
FR;79;2021-03-02;16344;19280;613903;332920;27.7;15.0
FR;79;2021-03-03;17770;18558;631673;351478;28.5;15.9
FR;79;2021-03-04;20969;17709;652642;369187;29.4;16.7
FR;79;2021-03-05;22504;16510;675146;385697;30.4;17.4
FR;79;2021-03-06;29092;5419;704238;391116;31.8;17.6
FR;79;2021-03-07;21097;1069;725335;392185;32.7;17.7
FR;79;2021-03-08;17398;15356;742733;407541;33.5;18.4
FR;79;2021-03-09;25772;16470;768505;424011;34.7;19.1
FR;79;2021-03-10;26903;15639;795408;439650;35.9;19.8
FR;79;2021-03-11;31905;15156;827313;454806;37.3;20.5
FR;79;2021-03-12;33432;12994;860745;467800;38.8;21.1
FR;79;2021-03-13;25360;4268;886105;472068;40.0;21.3
FR;79;2021-03-14;9488;784;895593;472852;40.4;21.3
FR;79;2021-03-15;28508;8732;924101;481584;41.7;21.7
FR;79;2021-03-16;32813;9325;956914;490909;43.2;22.1
FR;79;2021-03-17;33811;9291;990725;500200;44.7;22.6
FR;79;2021-03-18;36695;9790;1027420;509990;46.3;23.0
FR;79;2021-03-19;36742;8898;1064162;518888;48.0;23.4
FR;79;2021-03-20;20706;3300;1084868;522188;48.9;23.6
FR;79;2021-03-21;5877;606;1090745;522794;49.2;23.6
FR;79;2021-03-22;28616;9217;1119361;532011;50.5;24.0
FR;79;2021-03-23;37097;10817;1156458;542828;52.2;24.5
FR;79;2021-03-24;35653;11370;1192111;554198;53.8;25.0
FR;79;2021-03-25;41956;11148;1234067;565346;55.7;25.5
FR;79;2021-03-26;39447;10466;1273514;575812;57.4;26.0
FR;79;2021-03-27;17668;4418;1291182;580230;58.2;26.2
FR;79;2021-03-28;4797;906;1295979;581136;58.4;26.2
FR;79;2021-03-29;22295;15017;1318274;596153;59.5;26.9
FR;79;2021-03-30;28109;18925;1346383;615078;60.7;27.7
FR;79;2021-03-31;24783;19755;1371166;634833;61.8;28.6
FR;79;2021-04-01;27206;23208;1398372;658041;63.1;29.7
FR;79;2021-04-02;23095;24452;1421467;682493;64.1;30.8
FR;79;2021-04-03;10015;17370;1431482;699863;64.6;31.6
FR;79;2021-04-04;2805;5064;1434287;704927;64.7;31.8
FR;79;2021-04-05;4199;2751;1438486;707678;64.9;31.9
FR;79;2021-04-06;19028;28977;1457514;736655;65.7;33.2
FR;79;2021-04-07;21160;29859;1478674;766514;66.7;34.6
FR;79;2021-04-08;25000;29931;1503674;796445;67.8;35.9
FR;79;2021-04-09;26831;28106;1530505;824551;69.0;37.2
FR;79;2021-04-10;13618;18929;1544123;843480;69.6;38.0
FR;79;2021-04-11;3488;6447;1547611;849927;69.8;38.3
FR;79;2021-04-12;16737;28896;1564348;878823;70.6;39.6
FR;79;2021-04-13;19113;35010;1583461;913833;71.4;41.2
FR;79;2021-04-14;18183;33150;1601644;946983;72.2;42.7
FR;79;2021-04-15;19102;33333;1620746;980316;73.1;44.2
FR;79;2021-04-16;16218;31038;1636964;1011354;73.8;45.6
FR;79;2021-04-17;8148;16695;1645112;1028049;74.2;46.4
FR;79;2021-04-18;1768;4835;1646880;1032884;74.3;46.6
FR;79;2021-04-19;9840;29169;1656720;1062053;74.7;47.9
FR;79;2021-04-20;11711;34436;1668431;1096489;75.2;49.5
FR;79;2021-04-21;11302;31205;1679733;1127694;75.8;50.9
FR;79;2021-04-22;12847;31088;1692580;1158782;76.3;52.3
FR;79;2021-04-23;11903;27683;1704483;1186465;76.9;53.5
FR;79;2021-04-24;6161;13718;1710644;1200183;77.1;54.1
FR;79;2021-04-25;1911;3424;1712555;1203607;77.2;54.3
FR;79;2021-04-26;8957;20601;1721512;1224208;77.6;55.2
FR;79;2021-04-27;11395;23661;1732907;1247869;78.2;56.3
FR;79;2021-04-28;12410;20900;1745317;1268769;78.7;57.2
FR;79;2021-04-29;13950;20668;1759267;1289437;79.3;58.2
FR;79;2021-04-30;13100;17596;1772367;1307033;79.9;58.9
FR;79;2021-05-01;3955;3913;1776322;1310946;80.1;59.1
FR;79;2021-05-02;1742;2615;1778064;1313561;80.2;59.2
FR;79;2021-05-03;8585;15092;1786649;1328653;80.6;59.9
FR;79;2021-05-04;8935;20131;1795584;1348784;81.0;60.8
FR;79;2021-05-05;8413;18970;1803997;1367754;81.4;61.7
FR;79;2021-05-06;10231;18770;1814228;1386524;81.8;62.5
FR;79;2021-05-07;8944;19429;1823172;1405953;82.2;63.4
FR;79;2021-05-08;2971;4284;1826143;1410237;82.4;63.6
FR;79;2021-05-09;1385;2987;1827528;1413224;82.4;63.7
FR;79;2021-05-10;6122;17461;1833650;1430685;82.7;64.5
FR;79;2021-05-11;8019;18538;1841669;1449223;83.1;65.4
FR;79;2021-05-12;7316;15771;1848985;1464994;83.4;66.1
FR;79;2021-05-13;3492;3779;1852477;1468773;83.5;66.2
FR;79;2021-05-14;6778;11365;1859255;1480138;83.9;66.8
FR;79;2021-05-15;3311;5090;1862566;1485228;84.0;67.0
FR;79;2021-05-16;1138;1150;1863704;1486378;84.1;67.0
FR;79;2021-05-17;4909;8978;1868613;1495356;84.3;67.4
FR;79;2021-05-18;6066;9126;1874679;1504482;84.5;67.9
FR;79;2021-05-19;5689;7944;1880368;1512426;84.8;68.2
FR;79;2021-05-20;6568;8083;1886936;1520509;85.1;68.6
FR;79;2021-05-21;5595;8723;1892531;1529232;85.4;69.0
FR;79;2021-05-22;2402;3798;1894933;1533030;85.5;69.1
FR;79;2021-05-23;729;786;1895662;1533816;85.5;69.2
FR;79;2021-05-24;1831;1599;1897493;1535415;85.6;69.2
FR;79;2021-05-25;4338;10179;1901831;1545594;85.8;69.7
FR;79;2021-05-26;4285;9503;1906116;1555097;86.0;70.1
FR;79;2021-05-27;5180;10955;1911296;1566052;86.2;70.6
FR;79;2021-05-28;4689;12371;1915985;1578423;86.4;71.2
FR;79;2021-05-29;2042;6651;1918027;1585074;86.5;71.5
FR;79;2021-05-30;434;1252;1918461;1586326;86.5;71.5
FR;79;2021-05-31;3174;9022;1921635;1595348;86.7;71.9
FR;79;2021-06-01;4401;11092;1926036;1606440;86.9;72.4
FR;79;2021-06-02;3829;9706;1929865;1616146;87.0;72.9
FR;79;2021-06-03;4743;11220;1934608;1627366;87.3;73.4
FR;79;2021-06-04;4252;12684;1938860;1640050;87.4;74.0
FR;79;2021-06-05;1911;6442;1940771;1646492;87.5;74.3
FR;79;2021-06-06;430;1438;1941201;1647930;87.5;74.3
FR;79;2021-06-07;2689;10040;1943890;1657970;87.7;74.8
FR;79;2021-06-08;6553;9677;1950443;1667647;88.0;75.2
FR;79;2021-06-09;6439;9958;1956882;1677605;88.3;75.7
FR;79;2021-06-10;3741;11014;1960623;1688619;88.4;76.2
FR;80;2020-12-27;10;2;10;2;0.0;0.0
FR;80;2020-12-28;41;0;51;2;0.0;0.0
FR;80;2020-12-29;78;0;129;2;0.0;0.0
FR;80;2020-12-30;69;0;198;2;0.0;0.0
FR;80;2020-12-31;49;0;247;2;0.0;0.0
FR;80;2021-01-01;9;0;256;2;0.0;0.0
FR;80;2021-01-02;9;0;265;2;0.0;0.0
FR;80;2021-01-03;2;0;267;2;0.0;0.0
FR;80;2021-01-04;297;1;564;3;0.0;0.0
FR;80;2021-01-05;909;2;1473;5;0.0;0.0
FR;80;2021-01-06;1675;2;3148;7;0.1;0.0
FR;80;2021-01-07;6297;4;9445;11;0.2;0.0
FR;80;2021-01-08;5770;11;15215;22;0.4;0.0
FR;80;2021-01-09;979;0;16194;22;0.4;0.0
FR;80;2021-01-10;310;0;16504;22;0.4;0.0
FR;80;2021-01-11;4445;8;20949;30;0.5;0.0
FR;80;2021-01-12;12734;18;33683;48;0.8;0.0
FR;80;2021-01-13;12473;19;46156;67;1.1;0.0
FR;80;2021-01-14;18268;112;64424;179;1.5;0.0
FR;80;2021-01-15;12174;34;76598;213;1.8;0.0
FR;80;2021-01-16;4050;28;80648;241;1.9;0.0
FR;80;2021-01-17;3746;20;84394;261;2.0;0.0
FR;80;2021-01-18;28775;72;113169;333;2.7;0.0
FR;80;2021-01-19;53800;111;166969;444;4.0;0.0
FR;80;2021-01-20;59519;116;226488;560;5.4;0.0
FR;80;2021-01-21;70026;90;296514;650;7.1;0.0
FR;80;2021-01-22;48392;72;344906;722;8.3;0.0
FR;80;2021-01-23;16248;10;361154;732;8.7;0.0
FR;80;2021-01-24;4314;2;365468;734;8.8;0.0
FR;80;2021-01-25;32461;152;397929;886;9.6;0.0
FR;80;2021-01-26;45156;538;443085;1424;10.7;0.0
FR;80;2021-01-27;50905;897;493990;2321;11.9;0.1
FR;80;2021-01-28;60055;3950;554045;6271;13.3;0.2
FR;80;2021-01-29;39356;3282;593401;9553;14.3;0.2
FR;80;2021-01-30;13226;592;606627;10145;14.6;0.2
FR;80;2021-01-31;2333;288;608960;10433;14.6;0.3
FR;80;2021-02-01;23034;2790;631994;13223;15.2;0.3
FR;80;2021-02-02;33546;7434;665540;20657;16.0;0.5
FR;80;2021-02-03;34443;7882;699983;28539;16.8;0.7
FR;80;2021-02-04;38105;12587;738088;41126;17.8;1.0
FR;80;2021-02-05;29812;9538;767900;50664;18.5;1.2
FR;80;2021-02-06;9712;2126;777612;52790;18.7;1.3
FR;80;2021-02-07;1451;1867;779063;54657;18.7;1.3
FR;80;2021-02-08;19373;11145;798436;65802;19.2;1.6
FR;80;2021-02-09;25931;25621;824367;91423;19.8;2.2
FR;80;2021-02-10;26333;28930;850700;120353;20.5;2.9
FR;80;2021-02-11;30548;38130;881248;158483;21.2;3.8
FR;80;2021-02-12;26750;24687;907998;183170;21.8;4.4
FR;80;2021-02-13;7943;6529;915941;189699;22.0;4.6
FR;80;2021-02-14;1508;3101;917449;192800;22.1;4.6
FR;80;2021-02-15;11145;28318;928594;221118;22.3;5.3
FR;80;2021-02-16;15568;38945;944162;260063;22.7;6.3
FR;80;2021-02-17;15945;44493;960107;304556;23.1;7.3
FR;80;2021-02-18;21556;52523;981663;357079;23.6;8.6
FR;80;2021-02-19;19068;37505;1000731;394584;24.1;9.5
FR;80;2021-02-20;6302;12328;1007033;406912;24.2;9.8
FR;80;2021-02-21;913;2970;1007946;409882;24.2;9.9
FR;80;2021-02-22;11178;30701;1019124;440583;24.5;10.6
FR;80;2021-02-23;17108;37268;1036232;477851;24.9;11.5
FR;80;2021-02-24;18004;37090;1054236;514941;25.4;12.4
FR;80;2021-02-25;22307;40882;1076543;555823;25.9;13.4
FR;80;2021-02-26;20545;30924;1097088;586747;26.4;14.1
FR;80;2021-02-27;7185;10286;1104273;597033;26.6;14.4
FR;80;2021-02-28;1261;2121;1105534;599154;26.6;14.4
FR;80;2021-03-01;18806;23220;1124340;622374;27.0;15.0
FR;80;2021-03-02;26918;29118;1151258;651492;27.7;15.7
FR;80;2021-03-03;28749;29255;1180007;680747;28.4;16.4
FR;80;2021-03-04;34977;29727;1214984;710474;29.2;17.1
FR;80;2021-03-05;35907;27502;1250891;737976;30.1;17.7
FR;80;2021-03-06;41404;8376;1292295;746352;31.1;18.0
FR;80;2021-03-07;29724;2052;1322019;748404;31.8;18.0
FR;80;2021-03-08;27199;22504;1349218;770908;32.4;18.5
FR;80;2021-03-09;40752;24683;1389970;795591;33.4;19.1
FR;80;2021-03-10;43145;25402;1433115;820993;34.5;19.7
FR;80;2021-03-11;51702;26908;1484817;847901;35.7;20.4
FR;80;2021-03-12;52173;22992;1536990;870893;37.0;20.9
FR;80;2021-03-13;37527;7034;1574517;877927;37.9;21.1
FR;80;2021-03-14;13914;1528;1588431;879455;38.2;21.2
FR;80;2021-03-15;44108;13948;1632539;893403;39.3;21.5
FR;80;2021-03-16;51811;17054;1684350;910457;40.5;21.9
FR;80;2021-03-17;54653;16565;1739003;927022;41.8;22.3
FR;80;2021-03-18;58498;18850;1797501;945872;43.2;22.7
FR;80;2021-03-19;57423;15751;1854924;961623;44.6;23.1
FR;80;2021-03-20;31038;5346;1885962;966969;45.4;23.3
FR;80;2021-03-21;8686;1097;1894648;968066;45.6;23.3
FR;80;2021-03-22;42890;14564;1937538;982630;46.6;23.6
FR;80;2021-03-23;55663;18051;1993201;1000681;47.9;24.1
FR;80;2021-03-24;54562;19082;2047763;1019763;49.3;24.5
FR;80;2021-03-25;64024;19611;2111787;1039374;50.8;25.0
FR;80;2021-03-26;60204;18276;2171991;1057650;52.2;25.4
FR;80;2021-03-27;26609;7357;2198600;1065007;52.9;25.6
FR;80;2021-03-28;6925;1452;2205525;1066459;53.0;25.6
FR;80;2021-03-29;32880;23405;2238405;1089864;53.8;26.2
FR;80;2021-03-30;43353;30756;2281758;1120620;54.9;27.0
FR;80;2021-03-31;40631;32107;2322389;1152727;55.9;27.7
FR;80;2021-04-01;46150;37742;2368539;1190469;57.0;28.6
FR;80;2021-04-02;37130;39736;2405669;1230205;57.9;29.6
FR;80;2021-04-03;14540;26094;2420209;1256299;58.2;30.2
FR;80;2021-04-04;3869;7569;2424078;1263868;58.3;30.4
FR;80;2021-04-05;5629;4084;2429707;1267952;58.4;30.5
FR;80;2021-04-06;27686;44952;2457393;1312904;59.1;31.6
FR;80;2021-04-07;33629;48388;2491022;1361292;59.9;32.7
FR;80;2021-04-08;40062;49534;2531084;1410826;60.9;33.9
FR;80;2021-04-09;43481;46335;2574565;1457161;61.9;35.0
FR;80;2021-04-10;19819;28879;2594384;1486040;62.4;35.7
FR;80;2021-04-11;4815;9362;2599199;1495402;62.5;36.0
FR;80;2021-04-12;23502;45152;2622701;1540554;63.1;37.1
FR;80;2021-04-13;30174;54615;2652875;1595169;63.8;38.4
FR;80;2021-04-14;29019;52144;2681894;1647313;64.5;39.6
FR;80;2021-04-15;31393;52645;2713287;1699958;65.3;40.9
FR;80;2021-04-16;26413;48975;2739700;1748933;65.9;42.1
FR;80;2021-04-17;12345;25595;2752045;1774528;66.2;42.7
FR;80;2021-04-18;2530;7619;2754575;1782147;66.2;42.9
FR;80;2021-04-19;14239;43663;2768814;1825810;66.6;43.9
FR;80;2021-04-20;17939;53032;2786753;1878842;67.0;45.2
FR;80;2021-04-21;17963;49769;2804716;1928611;67.5;46.4
FR;80;2021-04-22;20634;51190;2825350;1979801;68.0;47.6
FR;80;2021-04-23;19086;44593;2844436;2024394;68.4;48.7
FR;80;2021-04-24;9414;21197;2853850;2045591;68.6;49.2
FR;80;2021-04-25;2687;5150;2856537;2050741;68.7;49.3
FR;80;2021-04-26;12392;30571;2868929;2081312;69.0;50.1
FR;80;2021-04-27;17219;36401;2886148;2117713;69.4;50.9
FR;80;2021-04-28;19078;34575;2905226;2152288;69.9;51.8
FR;80;2021-04-29;22118;35633;2927344;2187921;70.4;52.6
FR;80;2021-04-30;20767;29556;2948111;2217477;70.9;53.3
FR;80;2021-05-01;6001;5813;2954112;2223290;71.0;53.5
FR;80;2021-05-02;2612;3853;2956724;2227143;71.1;53.6
FR;80;2021-05-03;12489;21318;2969213;2248461;71.4;54.1
FR;80;2021-05-04;13875;29946;2983088;2278407;71.7;54.8
FR;80;2021-05-05;13597;29294;2996685;2307701;72.1;55.5
FR;80;2021-05-06;15927;29528;3012612;2337229;72.5;56.2
FR;80;2021-05-07;14593;29748;3027205;2366977;72.8;56.9
FR;80;2021-05-08;4517;6038;3031722;2373015;72.9;57.1
FR;80;2021-05-09;1914;4142;3033636;2377157;73.0;57.2
FR;80;2021-05-10;9200;24343;3042836;2401500;73.2;57.8
FR;80;2021-05-11;12652;27182;3055488;2428682;73.5;58.4
FR;80;2021-05-12;11647;23564;3067135;2452246;73.8;59.0
FR;80;2021-05-13;4894;5396;3072029;2457642;73.9;59.1
FR;80;2021-05-14;10457;16362;3082486;2474004;74.1;59.5
FR;80;2021-05-15;4859;7333;3087345;2481337;74.3;59.7
FR;80;2021-05-16;1537;1526;3088882;2482863;74.3;59.7
FR;80;2021-05-17;7055;13098;3095937;2495961;74.5;60.0
FR;80;2021-05-18;9535;13476;3105472;2509437;74.7;60.4
FR;80;2021-05-19;8928;12072;3114400;2521509;74.9;60.6
FR;80;2021-05-20;10665;12668;3125065;2534177;75.2;60.9
FR;80;2021-05-21;8828;13057;3133893;2547234;75.4;61.3
FR;80;2021-05-22;3842;5188;3137735;2552422;75.5;61.4
FR;80;2021-05-23;1008;1132;3138743;2553554;75.5;61.4
FR;80;2021-05-24;2578;2222;3141321;2555776;75.6;61.5
FR;80;2021-05-25;6570;14202;3147891;2569978;75.7;61.8
FR;80;2021-05-26;6760;14230;3154651;2584208;75.9;62.2
FR;80;2021-05-27;8627;16854;3163278;2601062;76.1;62.6
FR;80;2021-05-28;8244;18060;3171522;2619122;76.3;63.0
FR;80;2021-05-29;3435;8802;3174957;2627924;76.4;63.2
FR;80;2021-05-30;638;1595;3175595;2629519;76.4;63.2
FR;80;2021-05-31;4953;12683;3180548;2642202;76.5;63.5
FR;80;2021-06-01;7238;16625;3187786;2658827;76.7;63.9
FR;80;2021-06-02;6340;14848;3194126;2673675;76.8;64.3
FR;80;2021-06-03;8325;16918;3202451;2690593;77.0;64.7
FR;80;2021-06-04;7501;18906;3209952;2709499;77.2;65.2
FR;80;2021-06-05;3310;9196;3213262;2718695;77.3;65.4
FR;80;2021-06-06;630;2041;3213892;2720736;77.3;65.4
FR;80;2021-06-07;4245;14124;3218137;2734860;77.4;65.8
FR;80;2021-06-08;10092;14425;3228229;2749285;77.6;66.1
FR;80;2021-06-09;9954;15157;3238183;2764442;77.9;66.5
FR;80;2021-06-10;6476;16873;3244659;2781315;78.0;66.9
FR;0;2020-12-27;20;2;20;2;0.0;0.0
FR;0;2020-12-28;70;0;90;2;0.0;0.0
FR;0;2020-12-29;108;0;198;2;0.0;0.0
FR;0;2020-12-30;123;0;321;2;0.0;0.0
FR;0;2020-12-31;85;0;406;2;0.0;0.0
FR;0;2021-01-01;71;1;477;3;0.0;0.0
FR;0;2021-01-02;88;2;565;5;0.0;0.0
FR;0;2021-01-03;92;0;657;5;0.0;0.0
FR;0;2021-01-04;1479;8;2136;13;0.0;0.0
FR;0;2021-01-05;5400;20;7536;33;0.0;0.0
FR;0;2021-01-06;11323;31;18859;64;0.0;0.0
FR;0;2021-01-07;28575;65;47434;129;0.1;0.0
FR;0;2021-01-08;36275;79;83709;208;0.1;0.0
FR;0;2021-01-09;10929;15;94638;223;0.1;0.0
FR;0;2021-01-10;5624;9;100262;232;0.1;0.0
FR;0;2021-01-11;39042;98;139304;330;0.2;0.0
FR;0;2021-01-12;60946;155;200250;485;0.3;0.0
FR;0;2021-01-13;63868;183;264118;668;0.4;0.0
FR;0;2021-01-14;79940;728;344058;1396;0.5;0.0
FR;0;2021-01-15;67541;293;411599;1689;0.6;0.0
FR;0;2021-01-16;19743;125;431342;1814;0.6;0.0
FR;0;2021-01-17;10473;62;441815;1876;0.7;0.0
FR;0;2021-01-18;84437;337;526252;2213;0.8;0.0
FR;0;2021-01-19;128519;370;654771;2583;1.0;0.0
FR;0;2021-01-20;135281;362;790052;2945;1.2;0.0
FR;0;2021-01-21;155507;361;945559;3306;1.4;0.0
FR;0;2021-01-22;118689;375;1064248;3681;1.6;0.0
FR;0;2021-01-23;37843;81;1102091;3762;1.6;0.0
FR;0;2021-01-24;9371;41;1111462;3803;1.7;0.0
FR;0;2021-01-25;76880;1340;1188342;5143;1.8;0.0
FR;0;2021-01-26;98901;3255;1287243;8398;1.9;0.0
FR;0;2021-01-27;105699;5766;1392942;14164;2.1;0.0
FR;0;2021-01-28;122400;14623;1515342;28787;2.3;0.0
FR;0;2021-01-29;90915;17499;1606257;46286;2.4;0.1
FR;0;2021-01-30;28657;4272;1634914;50558;2.4;0.1
FR;0;2021-01-31;4873;1688;1639787;52246;2.4;0.1
FR;0;2021-02-01;51620;21224;1691407;73470;2.5;0.1
FR;0;2021-02-02;70732;34745;1762139;108215;2.6;0.2
FR;0;2021-02-03;71018;37174;1833157;145389;2.7;0.2
FR;0;2021-02-04;80635;50302;1913792;195691;2.9;0.3
FR;0;2021-02-05;67155;45546;1980947;241237;3.0;0.4
FR;0;2021-02-06;21344;10446;2002291;251683;3.0;0.4
FR;0;2021-02-07;4829;5084;2007120;256767;3.0;0.4
FR;0;2021-02-08;45921;46235;2053041;303002;3.1;0.5
FR;0;2021-02-09;64894;72976;2117935;375978;3.2;0.6
FR;0;2021-02-10;69328;77366;2187263;453344;3.3;0.7
FR;0;2021-02-11;85707;100130;2272970;553474;3.4;0.8
FR;0;2021-02-12;77805;75175;2350775;628649;3.5;0.9
FR;0;2021-02-13;21701;19642;2372476;648291;3.5;1.0
FR;0;2021-02-14;4593;7235;2377069;655526;3.5;1.0
FR;0;2021-02-15;37107;77069;2414176;732595;3.6;1.1
FR;0;2021-02-16;49282;101435;2463458;834030;3.7;1.2
FR;0;2021-02-17;49340;103679;2512798;937709;3.7;1.4
FR;0;2021-02-18;68028;119650;2580826;1057359;3.8;1.6
FR;0;2021-02-19;63854;91720;2644680;1149079;3.9;1.7
FR;0;2021-02-20;17965;28616;2662645;1177695;4.0;1.8
FR;0;2021-02-21;2860;6414;2665505;1184109;4.0;1.8
FR;0;2021-02-22;36508;73712;2702013;1257821;4.0;1.9
FR;0;2021-02-23;52662;84805;2754675;1342626;4.1;2.0
FR;0;2021-02-24;58096;81873;2812771;1424499;4.2;2.1
FR;0;2021-02-25;98675;92985;2911446;1517484;4.3;2.3
FR;0;2021-02-26;111832;72557;3023278;1590041;4.5;2.4
FR;0;2021-02-27;51224;22513;3074502;1612554;4.6;2.4
FR;0;2021-02-28;5680;4494;3080182;1617048;4.6;2.4
FR;0;2021-03-01;63702;53615;3143884;1670663;4.7;2.5
FR;0;2021-03-02;99483;67605;3243367;1738268;4.8;2.6
FR;0;2021-03-03;113875;67154;3357242;1805422;5.0;2.7
FR;0;2021-03-04;160736;71433;3517978;1876855;5.2;2.8
FR;0;2021-03-05;198323;66430;3716301;1943285;5.5;2.9
FR;0;2021-03-06;205285;19948;3921586;1963233;5.8;2.9
FR;0;2021-03-07;119934;6706;4041520;1969939;6.0;2.9
FR;0;2021-03-08;105076;52238;4146596;2022177;6.2;3.0
FR;0;2021-03-09;170062;59105;4316658;2081282;6.4;3.1
FR;0;2021-03-10;176258;59552;4492916;2140834;6.7;3.2
FR;0;2021-03-11;240127;66630;4733043;2207464;7.1;3.3
FR;0;2021-03-12;291841;57559;5024884;2265023;7.5;3.4
FR;0;2021-03-13;228991;17679;5253875;2282702;7.8;3.4
FR;0;2021-03-14;62383;4216;5316258;2286918;7.9;3.4
FR;0;2021-03-15;156543;35006;5472801;2321924;8.2;3.5
FR;0;2021-03-16;139321;41642;5612122;2363566;8.4;3.5
FR;0;2021-03-17;148086;41220;5760208;2404786;8.6;3.6
FR;0;2021-03-18;165147;47922;5925355;2452708;8.8;3.7
FR;0;2021-03-19;227323;41685;6152678;2494393;9.2;3.7
FR;0;2021-03-20;165195;14254;6317873;2508647;9.4;3.7
FR;0;2021-03-21;48796;3570;6366669;2512217;9.5;3.7
FR;0;2021-03-22;167552;37577;6534221;2549794;9.7;3.8
FR;0;2021-03-23;247958;47061;6782179;2596855;10.1;3.9
FR;0;2021-03-24;255451;48633;7037630;2645488;10.5;3.9
FR;0;2021-03-25;338695;51340;7376325;2696828;11.0;4.0
FR;0;2021-03-26;355762;49037;7732087;2745865;11.5;4.1
FR;0;2021-03-27;193385;20493;7925472;2766358;11.8;4.1
FR;0;2021-03-28;58346;4920;7983818;2771278;11.9;4.1
FR;0;2021-03-29;200789;58539;8184607;2829817;12.2;4.2
FR;0;2021-03-30;283290;76175;8467897;2905992;12.6;4.3
FR;0;2021-03-31;261327;79469;8729224;2985461;13.0;4.4
FR;0;2021-04-01;310672;96586;9039896;3082047;13.5;4.6
FR;0;2021-04-02;278249;99629;9318145;3181676;13.9;4.7
FR;0;2021-04-03;139337;65307;9457482;3246983;14.1;4.8
FR;0;2021-04-04;44900;20001;9502382;3266984;14.2;4.9
FR;0;2021-04-05;58839;12820;9561221;3279804;14.2;4.9
FR;0;2021-04-06;214032;113727;9775253;3393531;14.6;5.1
FR;0;2021-04-07;257471;123173;10032724;3516704;14.9;5.2
FR;0;2021-04-08;333165;132272;10365889;3648976;15.4;5.4
FR;0;2021-04-09;405141;128057;10771030;3777033;16.0;5.6
FR;0;2021-04-10;210234;88495;10981264;3865528;16.4;5.8
FR;0;2021-04-11;54925;36405;11036189;3901933;16.4;5.8
FR;0;2021-04-12;233981;121939;11270170;4023872;16.8;6.0
FR;0;2021-04-13;305392;154044;11575562;4177916;17.2;6.2
FR;0;2021-04-14;289877;148937;11865439;4326853;17.7;6.4
FR;0;2021-04-15;331900;158941;12197339;4485794;18.2;6.7
FR;0;2021-04-16;335011;156227;12532350;4642021;18.7;6.9
FR;0;2021-04-17;186282;95855;12718632;4737876;19.0;7.1
FR;0;2021-04-18;50442;37293;12769074;4775169;19.0;7.1
FR;0;2021-04-19;202730;145367;12971804;4920536;19.3;7.3
FR;0;2021-04-20;251096;179627;13222900;5100163;19.7;7.6
FR;0;2021-04-21;249614;177952;13472514;5278115;20.1;7.9
FR;0;2021-04-22;283467;199207;13755981;5477322;20.5;8.2
FR;0;2021-04-23;290956;195354;14046937;5672676;20.9;8.5
FR;0;2021-04-24;188348;120003;14235285;5792679;21.2;8.6
FR;0;2021-04-25;68535;41871;14303820;5834550;21.3;8.7
FR;0;2021-04-26;218560;167221;14522380;6001771;21.6;8.9
FR;0;2021-04-27;290049;207809;14812429;6209580;22.1;9.3
FR;0;2021-04-28;319078;205059;15131507;6414639;22.5;9.6
FR;0;2021-04-29;361177;227236;15492684;6641875;23.1;9.9
FR;0;2021-04-30;377315;220232;15869999;6862107;23.6;10.2
FR;0;2021-05-01;168776;61839;16038775;6923946;23.9;10.3
FR;0;2021-05-02;90149;42544;16128924;6966490;24.0;10.4
FR;0;2021-05-03;283583;187385;16412507;7153875;24.5;10.7
FR;0;2021-05-04;310646;247413;16723153;7401288;24.9;11.0
FR;0;2021-05-05;320806;246715;17043959;7648003;25.4;11.4
FR;0;2021-05-06;373047;269823;17417006;7917826;26.0;11.8
FR;0;2021-05-07;367142;295308;17784148;8213134;26.5;12.2
FR;0;2021-05-08;209964;79639;17994112;8292773;26.8;12.4
FR;0;2021-05-09;127626;54322;18121738;8347095;27.0;12.4
FR;0;2021-05-10;304768;252149;18426506;8599244;27.5;12.8
FR;0;2021-05-11;398215;293422;18824721;8892666;28.0;13.2
FR;0;2021-05-12;425706;265905;19250427;9158571;28.7;13.6
FR;0;2021-05-13;331908;76203;19582335;9234774;29.2;13.8
FR;0;2021-05-14;446990;199991;20029325;9434765;29.8;14.1
FR;0;2021-05-15;367874;117935;20397199;9552700;30.4;14.2
FR;0;2021-05-16;199380;33032;20596579;9585732;30.7;14.3
FR;0;2021-05-17;368887;176422;20965466;9762154;31.2;14.5
FR;0;2021-05-18;447458;188769;21412924;9950923;31.9;14.8
FR;0;2021-05-19;458446;179248;21871370;10130171;32.6;15.1
FR;0;2021-05-20;496283;200806;22367653;10330977;33.3;15.4
FR;0;2021-05-21;480335;217844;22847988;10548821;34.0;15.7
FR;0;2021-05-22;341923;106290;23189911;10655111;34.6;15.9
FR;0;2021-05-23;159004;25868;23348915;10680979;34.8;15.9
FR;0;2021-05-24;257387;51675;23606302;10732654;35.2;16.0
FR;0;2021-05-25;391398;223362;23997700;10956016;35.8;16.3
FR;0;2021-05-26;400767;223237;24398467;11179253;36.4;16.7
FR;0;2021-05-27;440770;263285;24839237;11442538;37.0;17.0
FR;0;2021-05-28;420422;314997;25259659;11757535;37.6;17.5
FR;0;2021-05-29;294633;180555;25554292;11938090;38.1;17.8
FR;0;2021-05-30;104821;41519;25659113;11979609;38.2;17.8
FR;0;2021-05-31;351494;239689;26010607;12219298;38.8;18.2
FR;0;2021-06-01;412607;300270;26423214;12519568;39.4;18.7
FR;0;2021-06-02;400605;275383;26823819;12794951;40.0;19.1
FR;0;2021-06-03;450681;310932;27274500;13105883;40.6;19.5
FR;0;2021-06-04;440865;359623;27715365;13465506;41.3;20.1
FR;0;2021-06-05;297321;220398;28012686;13685904;41.7;20.4
FR;0;2021-06-06;128942;60351;28141628;13746255;41.9;20.5
FR;0;2021-06-07;327110;297780;28468738;14044035;42.4;20.9
FR;0;2021-06-08;489747;284675;28958485;14328710;43.1;21.3
FR;0;2021-06-09;513431;315440;29471916;14644150;43.9;21.8
FR;0;2021-06-10;377149;333311;29849065;14977461;44.5;22.3
