fra;clage_vacsi;jour;n_dose1;n_complet;n_cum_dose1;n_cum_complet;couv_dose1;couv_complet
FR;24;2020-12-27;1;0;1;0;0.0;0.0
FR;24;2020-12-28;3;0;4;0;0.0;0.0
FR;24;2020-12-29;0;0;4;0;0.0;0.0
FR;24;2020-12-30;0;0;4;0;0.0;0.0
FR;24;2020-12-31;1;0;5;0;0.0;0.0
FR;24;2021-01-01;2;0;7;0;0.0;0.0
FR;24;2021-01-02;1;0;8;0;0.0;0.0
FR;24;2021-01-03;2;0;10;0;0.0;0.0
FR;24;2021-01-04;4;0;14;0;0.0;0.0
FR;24;2021-01-05;17;1;31;1;0.0;0.0
FR;24;2021-01-06;36;0;67;1;0.0;0.0
FR;24;2021-01-07;180;0;247;1;0.0;0.0
FR;24;2021-01-08;216;0;463;1;0.0;0.0
FR;24;2021-01-09;39;0;502;1;0.0;0.0
FR;24;2021-01-10;35;0;537;1;0.0;0.0
FR;24;2021-01-11;254;2;791;3;0.0;0.0
FR;24;2021-01-12;398;5;1189;8;0.0;0.0
FR;24;2021-01-13;482;5;1671;13;0.0;0.0
FR;24;2021-01-14;616;6;2287;19;0.0;0.0
FR;24;2021-01-15;599;2;2886;21;0.1;0.0
FR;24;2021-01-16;118;3;3004;24;0.1;0.0
FR;24;2021-01-17;94;0;3098;24;0.1;0.0
FR;24;2021-01-18;509;4;3607;28;0.1;0.0
FR;24;2021-01-19;599;5;4206;33;0.1;0.0
FR;24;2021-01-20;652;2;4858;35;0.1;0.0
FR;24;2021-01-21;760;4;5618;39;0.1;0.0
FR;24;2021-01-22;604;4;6222;43;0.1;0.0
FR;24;2021-01-23;117;0;6339;43;0.1;0.0
FR;24;2021-01-24;22;0;6361;43;0.1;0.0
FR;24;2021-01-25;294;5;6655;48;0.1;0.0
FR;24;2021-01-26;367;13;7022;61;0.1;0.0
FR;24;2021-01-27;447;14;7469;75;0.1;0.0
FR;24;2021-01-28;598;51;8067;126;0.1;0.0
FR;24;2021-01-29;469;85;8536;211;0.2;0.0
FR;24;2021-01-30;87;16;8623;227;0.2;0.0
FR;24;2021-01-31;25;13;8648;240;0.2;0.0
FR;24;2021-02-01;157;135;8805;375;0.2;0.0
FR;24;2021-02-02;219;182;9024;557;0.2;0.0
FR;24;2021-02-03;218;187;9242;744;0.2;0.0
FR;24;2021-02-04;359;315;9601;1059;0.2;0.0
FR;24;2021-02-05;348;345;9949;1404;0.2;0.0
FR;24;2021-02-06;83;71;10032;1475;0.2;0.0
FR;24;2021-02-07;169;31;10201;1506;0.2;0.0
FR;24;2021-02-08;388;360;10589;1866;0.2;0.0
FR;24;2021-02-09;748;459;11337;2325;0.2;0.0
FR;24;2021-02-10;1095;604;12432;2929;0.2;0.1
FR;24;2021-02-11;1580;726;14012;3655;0.3;0.1
FR;24;2021-02-12;1625;574;15637;4229;0.3;0.1
FR;24;2021-02-13;292;95;15929;4324;0.3;0.1
FR;24;2021-02-14;63;31;15992;4355;0.3;0.1
FR;24;2021-02-15;1045;389;17037;4744;0.3;0.1
FR;24;2021-02-16;1567;589;18604;5333;0.3;0.1
FR;24;2021-02-17;1494;506;20098;5839;0.4;0.1
FR;24;2021-02-18;1950;639;22048;6478;0.4;0.1
FR;24;2021-02-19;1861;577;23909;7055;0.4;0.1
FR;24;2021-02-20;333;89;24242;7144;0.4;0.1
FR;24;2021-02-21;41;19;24283;7163;0.4;0.1
FR;24;2021-02-22;1171;298;25454;7461;0.5;0.1
FR;24;2021-02-23;1591;401;27045;7862;0.5;0.1
FR;24;2021-02-24;1657;351;28702;8213;0.5;0.2
FR;24;2021-02-25;2291;500;30993;8713;0.6;0.2
FR;24;2021-02-26;2203;420;33196;9133;0.6;0.2
FR;24;2021-02-27;534;91;33730;9224;0.6;0.2
FR;24;2021-02-28;92;17;33822;9241;0.6;0.2
FR;24;2021-03-01;1270;253;35092;9494;0.6;0.2
FR;24;2021-03-02;1668;333;36760;9827;0.7;0.2
FR;24;2021-03-03;1773;385;38533;10212;0.7;0.2
FR;24;2021-03-04;2185;549;40718;10761;0.8;0.2
FR;24;2021-03-05;3328;545;44046;11306;0.8;0.2
FR;24;2021-03-06;1724;161;45770;11467;0.8;0.2
FR;24;2021-03-07;989;89;46759;11556;0.9;0.2
FR;24;2021-03-08;1984;277;48743;11833;0.9;0.2
FR;24;2021-03-09;2642;357;51385;12190;0.9;0.2
FR;24;2021-03-10;2453;396;53838;12586;1.0;0.2
FR;24;2021-03-11;2962;554;56800;13140;1.0;0.2
FR;24;2021-03-12;3857;489;60657;13629;1.1;0.3
FR;24;2021-03-13;1499;124;62156;13753;1.1;0.3
FR;24;2021-03-14;535;42;62691;13795;1.2;0.3
FR;24;2021-03-15;1844;283;64535;14078;1.2;0.3
FR;24;2021-03-16;830;316;65365;14394;1.2;0.3
FR;24;2021-03-17;1079;333;66444;14727;1.2;0.3
FR;24;2021-03-18;1310;460;67754;15187;1.2;0.3
FR;24;2021-03-19;1877;385;69631;15572;1.3;0.3
FR;24;2021-03-20;839;94;70470;15666;1.3;0.3
FR;24;2021-03-21;637;78;71107;15744;1.3;0.3
FR;24;2021-03-22;1505;318;72612;16062;1.3;0.3
FR;24;2021-03-23;1808;414;74420;16476;1.4;0.3
FR;24;2021-03-24;2162;385;76582;16861;1.4;0.3
FR;24;2021-03-25;2567;520;79149;17381;1.5;0.3
FR;24;2021-03-26;3171;519;82320;17900;1.5;0.3
FR;24;2021-03-27;1904;219;84224;18119;1.6;0.3
FR;24;2021-03-28;1011;83;85235;18202;1.6;0.3
FR;24;2021-03-29;2460;388;87695;18590;1.6;0.3
FR;24;2021-03-30;3649;556;91344;19146;1.7;0.4
FR;24;2021-03-31;4190;561;95534;19707;1.8;0.4
FR;24;2021-04-01;5437;812;100971;20519;1.9;0.4
FR;24;2021-04-02;4481;669;105452;21188;1.9;0.4
FR;24;2021-04-03;1755;350;107207;21538;2.0;0.4
FR;24;2021-04-04;957;131;108164;21669;2.0;0.4
FR;24;2021-04-05;1101;142;109265;21811;2.0;0.4
FR;24;2021-04-06;3570;620;112835;22431;2.1;0.4
FR;24;2021-04-07;4797;867;117632;23298;2.2;0.4
FR;24;2021-04-08;6398;1160;124030;24458;2.3;0.5
FR;24;2021-04-09;5797;1107;129827;25565;2.4;0.5
FR;24;2021-04-10;2629;587;132456;26152;2.4;0.5
FR;24;2021-04-11;1259;319;133715;26471;2.5;0.5
FR;24;2021-04-12;3454;956;137169;27427;2.5;0.5
FR;24;2021-04-13;4784;1175;141953;28602;2.6;0.5
FR;24;2021-04-14;4973;1348;146926;29950;2.7;0.6
FR;24;2021-04-15;5237;1620;152163;31570;2.8;0.6
FR;24;2021-04-16;4847;1705;157010;33275;2.9;0.6
FR;24;2021-04-17;2141;813;159151;34088;2.9;0.6
FR;24;2021-04-18;724;444;159875;34532;2.9;0.6
FR;24;2021-04-19;2952;1531;162827;36063;3.0;0.7
FR;24;2021-04-20;3136;2146;165963;38209;3.1;0.7
FR;24;2021-04-21;3451;2501;169414;40710;3.1;0.8
FR;24;2021-04-22;4048;3164;173462;43874;3.2;0.8
FR;24;2021-04-23;4224;3316;177686;47190;3.3;0.9
FR;24;2021-04-24;2397;1689;180083;48879;3.3;0.9
FR;24;2021-04-25;1232;804;181315;49683;3.3;0.9
FR;24;2021-04-26;3127;2199;184442;51882;3.4;1.0
FR;24;2021-04-27;3952;3194;188394;55076;3.5;1.0
FR;24;2021-04-28;4480;3771;192874;58847;3.6;1.1
FR;24;2021-04-29;5541;4484;198415;63331;3.7;1.2
FR;24;2021-04-30;6265;4646;204680;67977;3.8;1.3
FR;24;2021-05-01;4027;1099;208707;69076;3.8;1.3
FR;24;2021-05-02;2791;909;211498;69985;3.9;1.3
FR;24;2021-05-03;6365;4171;217863;74156;4.0;1.4
FR;24;2021-05-04;7608;4740;225471;78896;4.2;1.5
FR;24;2021-05-05;8784;4994;234255;83890;4.3;1.5
FR;24;2021-05-06;10921;6402;245176;90292;4.5;1.7
FR;24;2021-05-07;12133;6455;257309;96747;4.7;1.8
FR;24;2021-05-08;10061;2559;267370;99306;4.9;1.8
FR;24;2021-05-09;6888;1944;274258;101250;5.1;1.9
FR;24;2021-05-10;11119;4988;285377;106238;5.3;2.0
FR;24;2021-05-11;15607;5793;300984;112031;5.5;2.1
FR;24;2021-05-12;22910;6214;323894;118245;6.0;2.2
FR;24;2021-05-13;27614;3099;351508;121344;6.5;2.2
FR;24;2021-05-14;32736;5595;384244;126939;7.1;2.3
FR;24;2021-05-15;34153;4031;418397;130970;7.7;2.4
FR;24;2021-05-16;21901;2009;440298;132979;8.1;2.5
FR;24;2021-05-17;29599;5277;469897;138256;8.7;2.5
FR;24;2021-05-18;37963;6100;507860;144356;9.4;2.7
FR;24;2021-05-19;40189;7082;548049;151438;10.1;2.8
FR;24;2021-05-20;45913;7491;593962;158929;11.0;2.9
FR;24;2021-05-21;47381;7264;641343;166193;11.8;3.1
FR;24;2021-05-22;44675;4531;686018;170724;12.6;3.1
FR;24;2021-05-23;24015;2336;710033;173060;13.1;3.2
FR;24;2021-05-24;34385;3593;744418;176653;13.7;3.3
FR;24;2021-05-25;44755;7803;789173;184456;14.5;3.4
FR;24;2021-05-26;45831;7358;835004;191814;15.4;3.5
FR;24;2021-05-27;51983;8502;886987;200316;16.4;3.7
FR;24;2021-05-28;48727;8927;935714;209243;17.3;3.9
FR;24;2021-05-29;44013;5893;979727;215136;18.1;4.0
FR;24;2021-05-30;18356;2240;998083;217376;18.4;4.0
FR;24;2021-05-31;51814;8181;1049897;225557;19.4;4.2
FR;24;2021-06-01;59331;10082;1109228;235639;20.5;4.3
FR;24;2021-06-02;60661;9497;1169889;245136;21.6;4.5
FR;24;2021-06-03;67222;10450;1237111;255586;22.8;4.7
FR;24;2021-06-04;64493;10601;1301604;266187;24.0;4.9
FR;24;2021-06-05;54729;7704;1356333;273891;25.0;5.0
FR;24;2021-06-06;26685;3581;1383018;277472;25.5;5.1
FR;24;2021-06-07;56648;9797;1439666;287269;26.5;5.3
FR;24;2021-06-08;62482;10668;1502148;297937;27.7;5.5
FR;24;2021-06-09;62154;10871;1564302;308808;28.8;5.7
FR;24;2021-06-10;63403;13312;1627705;322120;30.0;5.9
FR;24;2021-06-11;59153;12876;1686858;334996;31.1;6.2
FR;24;2021-06-12;53004;11432;1739862;346428;32.1;6.4
FR;24;2021-06-13;20535;5301;1760397;351729;32.5;6.5
FR;29;2020-12-27;0;0;0;0;0.0;0.0
FR;29;2020-12-28;1;0;1;0;0.0;0.0
FR;29;2020-12-29;0;0;1;0;0.0;0.0
FR;29;2020-12-30;0;0;1;0;0.0;0.0
FR;29;2020-12-31;1;0;2;0;0.0;0.0
FR;29;2021-01-01;2;0;4;0;0.0;0.0
FR;29;2021-01-02;3;0;7;0;0.0;0.0
FR;29;2021-01-03;3;0;10;0;0.0;0.0
FR;29;2021-01-04;10;0;20;0;0.0;0.0
FR;29;2021-01-05;42;0;62;0;0.0;0.0
FR;29;2021-01-06;142;0;204;0;0.0;0.0
FR;29;2021-01-07;307;2;511;2;0.0;0.0
FR;29;2021-01-08;521;5;1032;7;0.0;0.0
FR;29;2021-01-09;113;0;1145;7;0.0;0.0
FR;29;2021-01-10;91;1;1236;8;0.0;0.0
FR;29;2021-01-11;647;4;1883;12;0.1;0.0
FR;29;2021-01-12;941;14;2824;26;0.1;0.0
FR;29;2021-01-13;1221;13;4045;39;0.1;0.0
FR;29;2021-01-14;1568;17;5613;56;0.2;0.0
FR;29;2021-01-15;1316;7;6929;63;0.2;0.0
FR;29;2021-01-16;193;4;7122;67;0.2;0.0
FR;29;2021-01-17;158;0;7280;67;0.2;0.0
FR;29;2021-01-18;1040;15;8320;82;0.2;0.0
FR;29;2021-01-19;1151;6;9471;88;0.3;0.0
FR;29;2021-01-20;1198;8;10669;96;0.3;0.0
FR;29;2021-01-21;1463;8;12132;104;0.3;0.0
FR;29;2021-01-22;1155;11;13287;115;0.4;0.0
FR;29;2021-01-23;170;2;13457;117;0.4;0.0
FR;29;2021-01-24;52;0;13509;117;0.4;0.0
FR;29;2021-01-25;541;19;14050;136;0.4;0.0
FR;29;2021-01-26;667;35;14717;171;0.4;0.0
FR;29;2021-01-27;729;63;15446;234;0.4;0.0
FR;29;2021-01-28;1038;125;16484;359;0.4;0.0
FR;29;2021-01-29;805;171;17289;530;0.5;0.0
FR;29;2021-01-30;141;40;17430;570;0.5;0.0
FR;29;2021-01-31;34;26;17464;596;0.5;0.0
FR;29;2021-02-01;263;295;17727;891;0.5;0.0
FR;29;2021-02-02;410;372;18137;1263;0.5;0.0
FR;29;2021-02-03;459;461;18596;1724;0.5;0.0
FR;29;2021-02-04;618;717;19214;2441;0.5;0.1
FR;29;2021-02-05;536;749;19750;3190;0.5;0.1
FR;29;2021-02-06;143;109;19893;3299;0.5;0.1
FR;29;2021-02-07;304;67;20197;3366;0.5;0.1
FR;29;2021-02-08;605;807;20802;4173;0.6;0.1
FR;29;2021-02-09;1250;1027;22052;5200;0.6;0.1
FR;29;2021-02-10;1716;1150;23768;6350;0.6;0.2
FR;29;2021-02-11;2472;1443;26240;7793;0.7;0.2
FR;29;2021-02-12;2222;1240;28462;9033;0.8;0.2
FR;29;2021-02-13;429;157;28891;9190;0.8;0.2
FR;29;2021-02-14;134;81;29025;9271;0.8;0.2
FR;29;2021-02-15;1573;806;30598;10077;0.8;0.3
FR;29;2021-02-16;1925;1172;32523;11249;0.9;0.3
FR;29;2021-02-17;1890;962;34413;12211;0.9;0.3
FR;29;2021-02-18;2400;1182;36813;13393;1.0;0.4
FR;29;2021-02-19;2324;958;39137;14351;1.1;0.4
FR;29;2021-02-20;384;126;39521;14477;1.1;0.4
FR;29;2021-02-21;86;43;39607;14520;1.1;0.4
FR;29;2021-02-22;1364;540;40971;15060;1.1;0.4
FR;29;2021-02-23;1764;666;42735;15726;1.1;0.4
FR;29;2021-02-24;1790;548;44525;16274;1.2;0.4
FR;29;2021-02-25;2410;954;46935;17228;1.3;0.5
FR;29;2021-02-26;2583;679;49518;17907;1.3;0.5
FR;29;2021-02-27;607;112;50125;18019;1.3;0.5
FR;29;2021-02-28;112;28;50237;18047;1.4;0.5
FR;29;2021-03-01;1313;360;51550;18407;1.4;0.5
FR;29;2021-03-02;1808;613;53358;19020;1.4;0.5
FR;29;2021-03-03;1996;617;55354;19637;1.5;0.5
FR;29;2021-03-04;2514;789;57868;20426;1.6;0.5
FR;29;2021-03-05;3641;756;61509;21182;1.7;0.6
FR;29;2021-03-06;1647;153;63156;21335;1.7;0.6
FR;29;2021-03-07;820;104;63976;21439;1.7;0.6
FR;29;2021-03-08;1972;418;65948;21857;1.8;0.6
FR;29;2021-03-09;2671;516;68619;22373;1.8;0.6
FR;29;2021-03-10;2592;544;71211;22917;1.9;0.6
FR;29;2021-03-11;3374;875;74585;23792;2.0;0.6
FR;29;2021-03-12;3993;774;78578;24566;2.1;0.7
FR;29;2021-03-13;1636;154;80214;24720;2.2;0.7
FR;29;2021-03-14;567;65;80781;24785;2.2;0.7
FR;29;2021-03-15;1895;390;82676;25175;2.2;0.7
FR;29;2021-03-16;1122;511;83798;25686;2.3;0.7
FR;29;2021-03-17;1383;517;85181;26203;2.3;0.7
FR;29;2021-03-18;1655;696;86836;26899;2.3;0.7
FR;29;2021-03-19;2242;579;89078;27478;2.4;0.7
FR;29;2021-03-20;988;136;90066;27614;2.4;0.7
FR;29;2021-03-21;725;67;90791;27681;2.4;0.7
FR;29;2021-03-22;1668;421;92459;28102;2.5;0.8
FR;29;2021-03-23;2221;616;94680;28718;2.5;0.8
FR;29;2021-03-24;2542;592;97222;29310;2.6;0.8
FR;29;2021-03-25;3390;717;100612;30027;2.7;0.8
FR;29;2021-03-26;3742;739;104354;30766;2.8;0.8
FR;29;2021-03-27;2150;277;106504;31043;2.9;0.8
FR;29;2021-03-28;966;82;107470;31125;2.9;0.8
FR;29;2021-03-29;2770;555;110240;31680;3.0;0.9
FR;29;2021-03-30;4017;752;114257;32432;3.1;0.9
FR;29;2021-03-31;4548;846;118805;33278;3.2;0.9
FR;29;2021-04-01;5882;1056;124687;34334;3.4;0.9
FR;29;2021-04-02;4931;964;129618;35298;3.5;0.9
FR;29;2021-04-03;1782;346;131400;35644;3.5;1.0
FR;29;2021-04-04;900;127;132300;35771;3.6;1.0
FR;29;2021-04-05;926;118;133226;35889;3.6;1.0
FR;29;2021-04-06;3520;788;136746;36677;3.7;1.0
FR;29;2021-04-07;4562;1145;141308;37822;3.8;1.0
FR;29;2021-04-08;6296;1519;147604;39341;4.0;1.1
FR;29;2021-04-09;6309;1313;153913;40654;4.1;1.1
FR;29;2021-04-10;2652;639;156565;41293;4.2;1.1
FR;29;2021-04-11;1163;343;157728;41636;4.2;1.1
FR;29;2021-04-12;3606;1062;161334;42698;4.3;1.1
FR;29;2021-04-13;4896;1531;166230;44229;4.5;1.2
FR;29;2021-04-14;4785;1527;171015;45756;4.6;1.2
FR;29;2021-04-15;5630;1847;176645;47603;4.8;1.3
FR;29;2021-04-16;4821;1907;181466;49510;4.9;1.3
FR;29;2021-04-17;2248;927;183714;50437;4.9;1.4
FR;29;2021-04-18;775;521;184489;50958;5.0;1.4
FR;29;2021-04-19;2871;1783;187360;52741;5.0;1.4
FR;29;2021-04-20;3532;2523;190892;55264;5.1;1.5
FR;29;2021-04-21;3495;2805;194387;58069;5.2;1.6
FR;29;2021-04-22;4479;3874;198866;61943;5.4;1.7
FR;29;2021-04-23;4622;3813;203488;65756;5.5;1.8
FR;29;2021-04-24;2709;1840;206197;67596;5.5;1.8
FR;29;2021-04-25;1193;742;207390;68338;5.6;1.8
FR;29;2021-04-26;3014;2482;210404;70820;5.7;1.9
FR;29;2021-04-27;4015;3616;214419;74436;5.8;2.0
FR;29;2021-04-28;4736;4052;219155;78488;5.9;2.1
FR;29;2021-04-29;5946;5006;225101;83494;6.1;2.2
FR;29;2021-04-30;6522;5247;231623;88741;6.2;2.4
FR;29;2021-05-01;4288;1231;235911;89972;6.3;2.4
FR;29;2021-05-02;2636;927;238547;90899;6.4;2.4
FR;29;2021-05-03;6945;4300;245492;95199;6.6;2.6
FR;29;2021-05-04;8215;5219;253707;100418;6.8;2.7
FR;29;2021-05-05;9681;5213;263388;105631;7.1;2.8
FR;29;2021-05-06;11312;6576;274700;112207;7.4;3.0
FR;29;2021-05-07;11772;6637;286472;118844;7.7;3.2
FR;29;2021-05-08;9023;2289;295495;121133;8.0;3.3
FR;29;2021-05-09;5932;1756;301427;122889;8.1;3.3
FR;29;2021-05-10;10710;5318;312137;128207;8.4;3.4
FR;29;2021-05-11;14643;6390;326780;134597;8.8;3.6
FR;29;2021-05-12;20123;6354;346903;140951;9.3;3.8
FR;29;2021-05-13;19870;2384;366773;143335;9.9;3.9
FR;29;2021-05-14;22760;4454;389533;147789;10.5;4.0
FR;29;2021-05-15;21538;2990;411071;150779;11.1;4.1
FR;29;2021-05-16;13414;1362;424485;152141;11.4;4.1
FR;29;2021-05-17;21617;5002;446102;157143;12.0;4.2
FR;29;2021-05-18;28481;5760;474583;162903;12.8;4.4
FR;29;2021-05-19;29099;6003;503682;168906;13.6;4.5
FR;29;2021-05-20;32898;6570;536580;175476;14.4;4.7
FR;29;2021-05-21;32131;6215;568711;181691;15.3;4.9
FR;29;2021-05-22;26219;3058;594930;184749;16.0;5.0
FR;29;2021-05-23;14219;1507;609149;186256;16.4;5.0
FR;29;2021-05-24;22604;2657;631753;188913;17.0;5.1
FR;29;2021-05-25;30652;6586;662405;195499;17.8;5.3
FR;29;2021-05-26;32725;6643;695130;202142;18.7;5.4
FR;29;2021-05-27;35810;7644;730940;209786;19.7;5.6
FR;29;2021-05-28;33383;7928;764323;217714;20.6;5.9
FR;29;2021-05-29;26619;4274;790942;221988;21.3;6.0
FR;29;2021-05-30;11842;1643;802784;223631;21.6;6.0
FR;29;2021-05-31;33643;6816;836427;230447;22.5;6.2
FR;29;2021-06-01;38512;8250;874939;238697;23.5;6.4
FR;29;2021-06-02;38883;7832;913822;246529;24.6;6.6
FR;29;2021-06-03;43880;8853;957702;255382;25.8;6.9
FR;29;2021-06-04;42517;9066;1000219;264448;26.9;7.1
FR;29;2021-06-05;31607;5622;1031826;270070;27.8;7.3
FR;29;2021-06-06;16856;2558;1048682;272628;28.2;7.3
FR;29;2021-06-07;37095;8207;1085777;280835;29.2;7.6
FR;29;2021-06-08;41305;8939;1127082;289774;30.3;7.8
FR;29;2021-06-09;39954;9032;1167036;298806;31.4;8.0
FR;29;2021-06-10;41822;10739;1208858;309545;32.5;8.3
FR;29;2021-06-11;38110;11001;1246968;320546;33.6;8.6
FR;29;2021-06-12;31386;8504;1278354;329050;34.4;8.9
FR;29;2021-06-13;13688;4291;1292042;333341;34.8;9.0
FR;39;2020-12-27;0;0;0;0;0.0;0.0
FR;39;2020-12-28;0;0;0;0;0.0;0.0
FR;39;2020-12-29;1;0;1;0;0.0;0.0
FR;39;2020-12-30;5;0;6;0;0.0;0.0
FR;39;2020-12-31;1;0;7;0;0.0;0.0
FR;39;2021-01-01;4;0;11;0;0.0;0.0
FR;39;2021-01-02;2;1;13;1;0.0;0.0
FR;39;2021-01-03;2;0;15;1;0.0;0.0
FR;39;2021-01-04;23;0;38;1;0.0;0.0
FR;39;2021-01-05;140;0;178;1;0.0;0.0
FR;39;2021-01-06;386;0;564;1;0.0;0.0
FR;39;2021-01-07;1178;6;1742;7;0.0;0.0
FR;39;2021-01-08;1791;5;3533;12;0.0;0.0
FR;39;2021-01-09;476;0;4009;12;0.0;0.0
FR;39;2021-01-10;308;1;4317;13;0.1;0.0
FR;39;2021-01-11;2217;10;6534;23;0.1;0.0
FR;39;2021-01-12;3421;21;9955;44;0.1;0.0
FR;39;2021-01-13;3509;18;13464;62;0.2;0.0
FR;39;2021-01-14;4787;57;18251;119;0.2;0.0
FR;39;2021-01-15;4404;24;22655;143;0.3;0.0
FR;39;2021-01-16;771;4;23426;147;0.3;0.0
FR;39;2021-01-17;492;5;23918;152;0.3;0.0
FR;39;2021-01-18;3079;38;26997;190;0.3;0.0
FR;39;2021-01-19;4013;19;31010;209;0.4;0.0
FR;39;2021-01-20;3916;21;34926;230;0.4;0.0
FR;39;2021-01-21;5157;25;40083;255;0.5;0.0
FR;39;2021-01-22;3974;40;44057;295;0.5;0.0
FR;39;2021-01-23;594;4;44651;299;0.5;0.0
FR;39;2021-01-24;184;0;44835;299;0.5;0.0
FR;39;2021-01-25;1599;45;46434;344;0.6;0.0
FR;39;2021-01-26;2171;104;48605;448;0.6;0.0
FR;39;2021-01-27;2289;217;50894;665;0.6;0.0
FR;39;2021-01-28;3485;477;54379;1142;0.7;0.0
FR;39;2021-01-29;2678;701;57057;1843;0.7;0.0
FR;39;2021-01-30;396;215;57453;2058;0.7;0.0
FR;39;2021-01-31;89;78;57542;2136;0.7;0.0
FR;39;2021-02-01;752;1059;58294;3195;0.7;0.0
FR;39;2021-02-02;1336;1650;59630;4845;0.7;0.1
FR;39;2021-02-03;1363;1662;60993;6507;0.7;0.1
FR;39;2021-02-04;1990;2539;62983;9046;0.8;0.1
FR;39;2021-02-05;1649;2707;64632;11753;0.8;0.1
FR;39;2021-02-06;400;433;65032;12186;0.8;0.1
FR;39;2021-02-07;554;212;65586;12398;0.8;0.1
FR;39;2021-02-08;1520;2431;67106;14829;0.8;0.2
FR;39;2021-02-09;3170;3390;70276;18219;0.8;0.2
FR;39;2021-02-10;3896;3538;74172;21757;0.9;0.3
FR;39;2021-02-11;6177;4885;80349;26642;1.0;0.3
FR;39;2021-02-12;5827;4018;86176;30660;1.0;0.4
FR;39;2021-02-13;1242;548;87418;31208;1.1;0.4
FR;39;2021-02-14;389;268;87807;31476;1.1;0.4
FR;39;2021-02-15;3424;2402;91231;33878;1.1;0.4
FR;39;2021-02-16;4424;3381;95655;37259;1.2;0.4
FR;39;2021-02-17;3991;2889;99646;40148;1.2;0.5
FR;39;2021-02-18;5983;3926;105629;44074;1.3;0.5
FR;39;2021-02-19;5855;3107;111484;47181;1.3;0.6
FR;39;2021-02-20;1140;479;112624;47660;1.4;0.6
FR;39;2021-02-21;187;122;112811;47782;1.4;0.6
FR;39;2021-02-22;3015;1683;115826;49465;1.4;0.6
FR;39;2021-02-23;3929;1949;119755;51414;1.4;0.6
FR;39;2021-02-24;3736;1743;123491;53157;1.5;0.6
FR;39;2021-02-25;5622;2577;129113;55734;1.6;0.7
FR;39;2021-02-26;6108;1964;135221;57698;1.6;0.7
FR;39;2021-02-27;1667;317;136888;58015;1.7;0.7
FR;39;2021-02-28;241;125;137129;58140;1.7;0.7
FR;39;2021-03-01;2964;1023;140093;59163;1.7;0.7
FR;39;2021-03-02;4278;1664;144371;60827;1.7;0.7
FR;39;2021-03-03;4281;1570;148652;62397;1.8;0.8
FR;39;2021-03-04;6357;2382;155009;64779;1.9;0.8
FR;39;2021-03-05;9224;2201;164233;66980;2.0;0.8
FR;39;2021-03-06;4977;459;169210;67439;2.0;0.8
FR;39;2021-03-07;2659;291;171869;67730;2.1;0.8
FR;39;2021-03-08;4704;1161;176573;68891;2.1;0.8
FR;39;2021-03-09;6947;1594;183520;70485;2.2;0.8
FR;39;2021-03-10;6149;1599;189669;72084;2.3;0.9
FR;39;2021-03-11;8757;2513;198426;74597;2.4;0.9
FR;39;2021-03-12;11527;2260;209953;76857;2.5;0.9
FR;39;2021-03-13;5263;471;215216;77328;2.6;0.9
FR;39;2021-03-14;1757;181;216973;77509;2.6;0.9
FR;39;2021-03-15;4804;1093;221777;78602;2.7;0.9
FR;39;2021-03-16;3379;1432;225156;80034;2.7;1.0
FR;39;2021-03-17;3462;1533;228618;81567;2.8;1.0
FR;39;2021-03-18;4671;2018;233289;83585;2.8;1.0
FR;39;2021-03-19;6301;1707;239590;85292;2.9;1.0
FR;39;2021-03-20;3178;390;242768;85682;2.9;1.0
FR;39;2021-03-21;2072;174;244840;85856;3.0;1.0
FR;39;2021-03-22;4462;1140;249302;86996;3.0;1.0
FR;39;2021-03-23;6188;1700;255490;88696;3.1;1.1
FR;39;2021-03-24;6335;1414;261825;90110;3.2;1.1
FR;39;2021-03-25;9085;1799;270910;91909;3.3;1.1
FR;39;2021-03-26;10679;1791;281589;93700;3.4;1.1
FR;39;2021-03-27;6005;672;287594;94372;3.5;1.1
FR;39;2021-03-28;2740;199;290334;94571;3.5;1.1
FR;39;2021-03-29;7224;1343;297558;95914;3.6;1.2
FR;39;2021-03-30;10585;1977;308143;97891;3.7;1.2
FR;39;2021-03-31;11225;1939;319368;99830;3.8;1.2
FR;39;2021-04-01;15075;2753;334443;102583;4.0;1.2
FR;39;2021-04-02;13318;2576;347761;105159;4.2;1.3
FR;39;2021-04-03;5620;1036;353381;106195;4.3;1.3
FR;39;2021-04-04;2529;355;355910;106550;4.3;1.3
FR;39;2021-04-05;2539;333;358449;106883;4.3;1.3
FR;39;2021-04-06;9324;2368;367773;109251;4.4;1.3
FR;39;2021-04-07;12234;2825;380007;112076;4.6;1.4
FR;39;2021-04-08;16925;3833;396932;115909;4.8;1.4
FR;39;2021-04-09;16959;3724;413891;119633;5.0;1.4
FR;39;2021-04-10;7420;1975;421311;121608;5.1;1.5
FR;39;2021-04-11;2989;995;424300;122603;5.1;1.5
FR;39;2021-04-12;9647;2796;433947;125399;5.2;1.5
FR;39;2021-04-13;13003;4095;446950;129494;5.4;1.6
FR;39;2021-04-14;12959;3905;459909;133399;5.5;1.6
FR;39;2021-04-15;14874;4906;474783;138305;5.7;1.7
FR;39;2021-04-16;12879;5357;487662;143662;5.9;1.7
FR;39;2021-04-17;6159;2746;493821;146408;6.0;1.8
FR;39;2021-04-18;2280;1565;496101;147973;6.0;1.8
FR;39;2021-04-19;7963;4746;504064;152719;6.1;1.8
FR;39;2021-04-20;9544;6764;513608;159483;6.2;1.9
FR;39;2021-04-21;10378;7247;523986;166730;6.3;2.0
FR;39;2021-04-22;12011;10401;535997;177131;6.5;2.1
FR;39;2021-04-23;12340;10590;548337;187721;6.6;2.3
FR;39;2021-04-24;7885;5117;556222;192838;6.7;2.3
FR;39;2021-04-25;3538;2179;559760;195017;6.7;2.4
FR;39;2021-04-26;8754;6995;568514;202012;6.9;2.4
FR;39;2021-04-27;11969;9626;580483;211638;7.0;2.6
FR;39;2021-04-28;13435;10147;593918;221785;7.2;2.7
FR;39;2021-04-29;17500;13056;611418;234841;7.4;2.8
FR;39;2021-04-30;20044;13378;631462;248219;7.6;3.0
FR;39;2021-05-01;13735;3593;645197;251812;7.8;3.0
FR;39;2021-05-02;9402;2535;654599;254347;7.9;3.1
FR;39;2021-05-03;22681;11392;677280;265739;8.2;3.2
FR;39;2021-05-04;27210;14028;704490;279767;8.5;3.4
FR;39;2021-05-05;31001;14367;735491;294134;8.9;3.5
FR;39;2021-05-06;37333;17795;772824;311929;9.3;3.8
FR;39;2021-05-07;38825;18619;811649;330548;9.8;4.0
FR;39;2021-05-08;29302;5705;840951;336253;10.1;4.1
FR;39;2021-05-09;18832;4325;859783;340578;10.4;4.1
FR;39;2021-05-10;34137;14596;893920;355174;10.8;4.3
FR;39;2021-05-11;44481;17235;938401;372409;11.3;4.5
FR;39;2021-05-12;56797;16358;995198;388767;12.0;4.7
FR;39;2021-05-13;53580;5688;1048778;394455;12.6;4.8
FR;39;2021-05-14;63039;11158;1111817;405613;13.4;4.9
FR;39;2021-05-15;56891;6990;1168708;412603;14.1;5.0
FR;39;2021-05-16;36087;3144;1204795;415747;14.5;5.0
FR;39;2021-05-17;56687;12025;1261482;427772;15.2;5.2
FR;39;2021-05-18;71604;13739;1333086;441511;16.1;5.3
FR;39;2021-05-19;75034;14203;1408120;455714;17.0;5.5
FR;39;2021-05-20;83486;15061;1491606;470775;18.0;5.7
FR;39;2021-05-21;82795;15080;1574401;485855;19.0;5.9
FR;39;2021-05-22;63825;7484;1638226;493339;19.7;5.9
FR;39;2021-05-23;34098;3339;1672324;496678;20.2;6.0
FR;39;2021-05-24;52402;5417;1724726;502095;20.8;6.1
FR;39;2021-05-25;73756;15882;1798482;517977;21.7;6.2
FR;39;2021-05-26;77160;15934;1875642;533911;22.6;6.4
FR;39;2021-05-27;85140;17988;1960782;551899;23.6;6.7
FR;39;2021-05-28;79016;19553;2039798;571452;24.6;6.9
FR;39;2021-05-29;57889;10144;2097687;581596;25.3;7.0
FR;39;2021-05-30;24567;3660;2122254;585256;25.6;7.1
FR;39;2021-05-31;74835;15895;2197089;601151;26.5;7.2
FR;39;2021-06-01;86000;19675;2283089;620826;27.5;7.5
FR;39;2021-06-02;86113;19055;2369202;639881;28.6;7.7
FR;39;2021-06-03;97394;21542;2466596;661423;29.7;8.0
FR;39;2021-06-04;95584;23004;2562180;684427;30.9;8.3
FR;39;2021-06-05;63794;13622;2625974;698049;31.7;8.4
FR;39;2021-06-06;31776;5754;2657750;703803;32.0;8.5
FR;39;2021-06-07;74629;20357;2732379;724160;32.9;8.7
FR;39;2021-06-08;86243;22046;2818622;746206;34.0;9.0
FR;39;2021-06-09;84913;22665;2903535;768871;35.0;9.3
FR;39;2021-06-10;86970;25321;2990505;794192;36.1;9.6
FR;39;2021-06-11;83340;30429;3073845;824621;37.1;9.9
FR;39;2021-06-12;59955;23105;3133800;847726;37.8;10.2
FR;39;2021-06-13;24952;11573;3158752;859299;38.1;10.4
FR;49;2020-12-27;2;0;2;0;0.0;0.0
FR;49;2020-12-28;3;0;5;0;0.0;0.0
FR;49;2020-12-29;1;0;6;0;0.0;0.0
FR;49;2020-12-30;6;0;12;0;0.0;0.0
FR;49;2020-12-31;1;0;13;0;0.0;0.0
FR;49;2021-01-01;4;0;17;0;0.0;0.0
FR;49;2021-01-02;11;0;28;0;0.0;0.0
FR;49;2021-01-03;5;0;33;0;0.0;0.0
FR;49;2021-01-04;87;0;120;0;0.0;0.0
FR;49;2021-01-05;338;1;458;1;0.0;0.0
FR;49;2021-01-06;861;5;1319;6;0.0;0.0
FR;49;2021-01-07;2160;7;3479;13;0.0;0.0
FR;49;2021-01-08;3379;10;6858;23;0.1;0.0
FR;49;2021-01-09;1003;1;7861;24;0.1;0.0
FR;49;2021-01-10;474;2;8335;26;0.1;0.0
FR;49;2021-01-11;4177;17;12512;43;0.1;0.0
FR;49;2021-01-12;5871;19;18383;62;0.2;0.0
FR;49;2021-01-13;6173;23;24556;85;0.3;0.0
FR;49;2021-01-14;8343;81;32899;166;0.4;0.0
FR;49;2021-01-15;7625;36;40524;202;0.5;0.0
FR;49;2021-01-16;1426;9;41950;211;0.5;0.0
FR;49;2021-01-17;621;7;42571;218;0.5;0.0
FR;49;2021-01-18;5069;33;47640;251;0.6;0.0
FR;49;2021-01-19;6827;31;54467;282;0.6;0.0
FR;49;2021-01-20;6640;32;61107;314;0.7;0.0
FR;49;2021-01-21;8428;38;69535;352;0.8;0.0
FR;49;2021-01-22;6280;44;75815;396;0.9;0.0
FR;49;2021-01-23;1016;7;76831;403;0.9;0.0
FR;49;2021-01-24;282;3;77113;406;0.9;0.0
FR;49;2021-01-25;2623;101;79736;507;0.9;0.0
FR;49;2021-01-26;3739;229;83475;736;1.0;0.0
FR;49;2021-01-27;3988;396;87463;1132;1.0;0.0
FR;49;2021-01-28;5555;993;93018;2125;1.1;0.0
FR;49;2021-01-29;4411;1566;97429;3691;1.1;0.0
FR;49;2021-01-30;693;380;98122;4071;1.1;0.0
FR;49;2021-01-31;137;125;98259;4196;1.1;0.0
FR;49;2021-02-01;1374;2091;99633;6287;1.2;0.1
FR;49;2021-02-02;2293;3205;101926;9492;1.2;0.1
FR;49;2021-02-03;2307;3384;104233;12876;1.2;0.1
FR;49;2021-02-04;3387;4784;107620;17660;1.3;0.2
FR;49;2021-02-05;2805;4893;110425;22553;1.3;0.3
FR;49;2021-02-06;572;890;110997;23443;1.3;0.3
FR;49;2021-02-07;519;296;111516;23739;1.3;0.3
FR;49;2021-02-08;1942;4071;113458;27810;1.3;0.3
FR;49;2021-02-09;4342;5772;117800;33582;1.4;0.4
FR;49;2021-02-10;5507;6091;123307;39673;1.4;0.5
FR;49;2021-02-11;8008;8024;131315;47697;1.5;0.6
FR;49;2021-02-12;7317;6490;138632;54187;1.6;0.6
FR;49;2021-02-13;1703;1029;140335;55216;1.6;0.6
FR;49;2021-02-14;408;407;140743;55623;1.6;0.6
FR;49;2021-02-15;4129;3902;144872;59525;1.7;0.7
FR;49;2021-02-16;5389;5364;150261;64889;1.7;0.8
FR;49;2021-02-17;5139;4682;155400;69571;1.8;0.8
FR;49;2021-02-18;7502;6242;162902;75813;1.9;0.9
FR;49;2021-02-19;7083;4935;169985;80748;2.0;0.9
FR;49;2021-02-20;1496;807;171481;81555;2.0;0.9
FR;49;2021-02-21;279;226;171760;81781;2.0;1.0
FR;49;2021-02-22;3539;2674;175299;84455;2.0;1.0
FR;49;2021-02-23;4883;3160;180182;87615;2.1;1.0
FR;49;2021-02-24;4909;2877;185091;90492;2.2;1.1
FR;49;2021-02-25;7583;4230;192674;94722;2.2;1.1
FR;49;2021-02-26;8280;3210;200954;97932;2.3;1.1
FR;49;2021-02-27;2694;581;203648;98513;2.4;1.1
FR;49;2021-02-28;336;137;203984;98650;2.4;1.1
FR;49;2021-03-01;3853;1665;207837;100315;2.4;1.2
FR;49;2021-03-02;5812;2532;213649;102847;2.5;1.2
FR;49;2021-03-03;6060;2558;219709;105405;2.6;1.2
FR;49;2021-03-04;8971;3535;228680;108940;2.7;1.3
FR;49;2021-03-05;12611;3344;241291;112284;2.8;1.3
FR;49;2021-03-06;8640;659;249931;112943;2.9;1.3
FR;49;2021-03-07;4695;437;254626;113380;3.0;1.3
FR;49;2021-03-08;6435;1728;261061;115108;3.0;1.3
FR;49;2021-03-09;9592;2409;270653;117517;3.1;1.4
FR;49;2021-03-10;9022;2420;279675;119937;3.3;1.4
FR;49;2021-03-11;12881;3542;292556;123479;3.4;1.4
FR;49;2021-03-12;16503;3073;309059;126552;3.6;1.5
FR;49;2021-03-13;9564;680;318623;127232;3.7;1.5
FR;49;2021-03-14;3140;260;321763;127492;3.7;1.5
FR;49;2021-03-15;6911;1488;328674;128980;3.8;1.5
FR;49;2021-03-16;4636;2162;333310;131142;3.9;1.5
FR;49;2021-03-17;5187;2042;338497;133184;3.9;1.5
FR;49;2021-03-18;6562;2836;345059;136020;4.0;1.6
FR;49;2021-03-19;9547;2360;354606;138380;4.1;1.6
FR;49;2021-03-20;5886;593;360492;138973;4.2;1.6
FR;49;2021-03-21;3144;230;363636;139203;4.2;1.6
FR;49;2021-03-22;6317;1513;369953;140716;4.3;1.6
FR;49;2021-03-23;8612;2189;378565;142905;4.4;1.7
FR;49;2021-03-24;9535;2021;388100;144926;4.5;1.7
FR;49;2021-03-25;12375;2423;400475;147349;4.7;1.7
FR;49;2021-03-26;14741;2380;415216;149729;4.8;1.7
FR;49;2021-03-27;9371;885;424587;150614;4.9;1.8
FR;49;2021-03-28;3850;312;428437;150926;5.0;1.8
FR;49;2021-03-29;9897;1885;438334;152811;5.1;1.8
FR;49;2021-03-30;14296;2748;452630;155559;5.3;1.8
FR;49;2021-03-31;15586;2849;468216;158408;5.4;1.8
FR;49;2021-04-01;19903;3786;488119;162194;5.7;1.9
FR;49;2021-04-02;17493;3516;505612;165710;5.9;1.9
FR;49;2021-04-03;9350;1852;514962;167562;6.0;2.0
FR;49;2021-04-04;4121;632;519083;168194;6.0;2.0
FR;49;2021-04-05;4210;541;523293;168735;6.1;2.0
FR;49;2021-04-06;13215;3413;536508;172148;6.2;2.0
FR;49;2021-04-07;17701;4302;554209;176450;6.4;2.1
FR;49;2021-04-08;22471;5263;576680;181713;6.7;2.1
FR;49;2021-04-09;23566;5431;600246;187144;7.0;2.2
FR;49;2021-04-10;12428;3422;612674;190566;7.1;2.2
FR;49;2021-04-11;4477;1690;617151;192256;7.2;2.2
FR;49;2021-04-12;14146;3827;631297;196083;7.3;2.3
FR;49;2021-04-13;18751;5828;650048;201911;7.6;2.3
FR;49;2021-04-14;19434;6015;669482;207926;7.8;2.4
FR;49;2021-04-15;20397;7108;689879;215034;8.0;2.5
FR;49;2021-04-16;17532;7379;707411;222413;8.2;2.6
FR;49;2021-04-17;9897;4690;717308;227103;8.3;2.6
FR;49;2021-04-18;3372;2309;720680;229412;8.4;2.7
FR;49;2021-04-19;12031;6425;732711;235837;8.5;2.7
FR;49;2021-04-20;14221;9075;746932;244912;8.7;2.9
FR;49;2021-04-21;16031;10205;762963;255117;8.9;3.0
FR;49;2021-04-22;17657;13211;780620;268328;9.1;3.1
FR;49;2021-04-23;18151;14168;798771;282496;9.3;3.3
FR;49;2021-04-24;12670;7827;811441;290323;9.4;3.4
FR;49;2021-04-25;5504;3156;816945;293479;9.5;3.4
FR;49;2021-04-26;13741;10003;830686;303482;9.7;3.5
FR;49;2021-04-27;18712;13143;849398;316625;9.9;3.7
FR;49;2021-04-28;22723;14649;872121;331274;10.1;3.9
FR;49;2021-04-29;27701;17390;899822;348664;10.5;4.1
FR;49;2021-04-30;31980;18201;931802;366865;10.8;4.3
FR;49;2021-05-01;24288;5824;956090;372689;11.1;4.3
FR;49;2021-05-02;16570;3925;972660;376614;11.3;4.4
FR;49;2021-05-03;39662;15618;1012322;392232;11.8;4.6
FR;49;2021-05-04;46695;20385;1059017;412617;12.3;4.8
FR;49;2021-05-05;55729;21753;1114746;434370;13.0;5.1
FR;49;2021-05-06;62391;24760;1177137;459130;13.7;5.3
FR;49;2021-05-07;65790;26136;1242927;485266;14.5;5.6
FR;49;2021-05-08;51741;9253;1294668;494519;15.1;5.8
FR;49;2021-05-09;32232;6282;1326900;500801;15.4;5.8
FR;49;2021-05-10;57310;20779;1384210;521580;16.1;6.1
FR;49;2021-05-11;72046;23987;1456256;545567;16.9;6.3
FR;49;2021-05-12;90181;24128;1546437;569695;18.0;6.6
FR;49;2021-05-13;80251;7848;1626688;577543;18.9;6.7
FR;49;2021-05-14;96859;15851;1723547;593394;20.1;6.9
FR;49;2021-05-15;86608;10966;1810155;604360;21.1;7.0
FR;49;2021-05-16;53134;4569;1863289;608929;21.7;7.1
FR;49;2021-05-17;81999;16395;1945288;625324;22.6;7.3
FR;49;2021-05-18;98554;18005;2043842;643329;23.8;7.5
FR;49;2021-05-19;110290;19485;2154132;662814;25.1;7.7
FR;49;2021-05-20;114038;19863;2268170;682677;26.4;7.9
FR;49;2021-05-21;113474;20064;2381644;702741;27.7;8.2
FR;49;2021-05-22;87411;10601;2469055;713342;28.7;8.3
FR;49;2021-05-23;42843;4030;2511898;717372;29.2;8.3
FR;49;2021-05-24;67040;6908;2578938;724280;30.0;8.4
FR;49;2021-05-25;94601;20917;2673539;745197;31.1;8.7
FR;49;2021-05-26;101352;22835;2774891;768032;32.3;8.9
FR;49;2021-05-27;104241;24058;2879132;792090;33.5;9.2
FR;49;2021-05-28;99787;26806;2978919;818896;34.7;9.5
FR;49;2021-05-29;74121;15571;3053040;834467;35.5;9.7
FR;49;2021-05-30;26761;4731;3079801;839198;35.8;9.8
FR;49;2021-05-31;87524;21292;3167325;860490;36.9;10.0
FR;49;2021-06-01;100119;26445;3267444;886935;38.0;10.3
FR;49;2021-06-02;101426;26604;3368870;913539;39.2;10.6
FR;49;2021-06-03;108816;27914;3477686;941453;40.5;11.0
FR;49;2021-06-04;108443;31333;3586129;972786;41.7;11.3
FR;49;2021-06-05;74303;20929;3660432;993715;42.6;11.6
FR;49;2021-06-06;31816;7579;3692248;1001294;43.0;11.7
FR;49;2021-06-07;77187;27763;3769435;1029057;43.9;12.0
FR;49;2021-06-08;89646;29730;3859081;1058787;44.9;12.3
FR;49;2021-06-09;91645;32580;3950726;1091367;46.0;12.7
FR;49;2021-06-10;90258;32756;4040984;1124123;47.0;13.1
FR;49;2021-06-11;86849;46189;4127833;1170312;48.0;13.6
FR;49;2021-06-12;64764;38156;4192597;1208468;48.8;14.1
FR;49;2021-06-13;23405;17996;4216002;1226464;49.1;14.3
FR;59;2020-12-27;2;0;2;0;0.0;0.0
FR;59;2020-12-28;6;0;8;0;0.0;0.0
FR;59;2020-12-29;2;0;10;0;0.0;0.0
FR;59;2020-12-30;6;0;16;0;0.0;0.0
FR;59;2020-12-31;9;0;25;0;0.0;0.0
FR;59;2021-01-01;26;1;51;1;0.0;0.0
FR;59;2021-01-02;30;0;81;1;0.0;0.0
FR;59;2021-01-03;36;0;117;1;0.0;0.0
FR;59;2021-01-04;595;4;712;5;0.0;0.0
FR;59;2021-01-05;2174;8;2886;13;0.0;0.0
FR;59;2021-01-06;4815;17;7701;30;0.1;0.0
FR;59;2021-01-07;10520;34;18221;64;0.2;0.0
FR;59;2021-01-08;14344;32;32565;96;0.4;0.0
FR;59;2021-01-09;4067;11;36632;107;0.4;0.0
FR;59;2021-01-10;1987;3;38619;110;0.4;0.0
FR;59;2021-01-11;15978;38;54597;148;0.6;0.0
FR;59;2021-01-12;21172;60;75769;208;0.9;0.0
FR;59;2021-01-13;22759;72;98528;280;1.1;0.0
FR;59;2021-01-14;24782;246;123310;526;1.4;0.0
FR;59;2021-01-15;21632;118;144942;644;1.6;0.0
FR;59;2021-01-16;5443;30;150385;674;1.7;0.0
FR;59;2021-01-17;1802;13;152187;687;1.7;0.0
FR;59;2021-01-18;13601;91;165788;778;1.9;0.0
FR;59;2021-01-19;17992;103;183780;881;2.1;0.0
FR;59;2021-01-20;17141;90;200921;971;2.3;0.0
FR;59;2021-01-21;18847;88;219768;1059;2.5;0.0
FR;59;2021-01-22;13956;102;233724;1161;2.7;0.0
FR;59;2021-01-23;2962;24;236686;1185;2.7;0.0
FR;59;2021-01-24;847;16;237533;1201;2.7;0.0
FR;59;2021-01-25;6715;627;244248;1828;2.8;0.0
FR;59;2021-01-26;8461;1393;252709;3221;2.9;0.0
FR;59;2021-01-27;8839;2410;261548;5631;3.0;0.1
FR;59;2021-01-28;10523;5064;272071;10695;3.1;0.1
FR;59;2021-01-29;7848;6659;279919;17354;3.2;0.2
FR;59;2021-01-30;1764;1515;281683;18869;3.2;0.2
FR;59;2021-01-31;372;547;282055;19416;3.2;0.2
FR;59;2021-02-01;3173;8746;285228;28162;3.2;0.3
FR;59;2021-02-02;4699;12487;289927;40649;3.3;0.5
FR;59;2021-02-03;4824;13551;294751;54200;3.4;0.6
FR;59;2021-02-04;5962;15909;300713;70109;3.4;0.8
FR;59;2021-02-05;4831;14927;305544;85036;3.5;1.0
FR;59;2021-02-06;1162;3000;306706;88036;3.5;1.0
FR;59;2021-02-07;389;985;307095;89021;3.5;1.0
FR;59;2021-02-08;2761;12482;309856;101503;3.5;1.2
FR;59;2021-02-09;4916;16184;314772;117687;3.6;1.3
FR;59;2021-02-10;5701;16077;320473;133764;3.6;1.5
FR;59;2021-02-11;7677;19737;328150;153501;3.7;1.7
FR;59;2021-02-12;6778;16043;334928;169544;3.8;1.9
FR;59;2021-02-13;1700;3450;336628;172994;3.8;2.0
FR;59;2021-02-14;362;983;336990;173977;3.8;2.0
FR;59;2021-02-15;3272;10547;340262;184524;3.9;2.1
FR;59;2021-02-16;4742;13580;345004;198104;3.9;2.3
FR;59;2021-02-17;4966;12345;349970;210449;4.0;2.4
FR;59;2021-02-18;7082;13880;357052;224329;4.1;2.6
FR;59;2021-02-19;6490;10738;363542;235067;4.1;2.7
FR;59;2021-02-20;1417;2492;364959;237559;4.2;2.7
FR;59;2021-02-21;284;571;365243;238130;4.2;2.7
FR;59;2021-02-22;3265;6381;368508;244511;4.2;2.8
FR;59;2021-02-23;4852;7144;373360;251655;4.2;2.9
FR;59;2021-02-24;6869;6434;380229;258089;4.3;2.9
FR;59;2021-02-25;21246;8573;401475;266662;4.6;3.0
FR;59;2021-02-26;28287;6309;429762;272971;4.9;3.1
FR;59;2021-02-27;17130;1548;446892;274519;5.1;3.1
FR;59;2021-02-28;1113;383;448005;274902;5.1;3.1
FR;59;2021-03-01;8826;3552;456831;278454;5.2;3.2
FR;59;2021-03-02;17184;4958;474015;283412;5.4;3.2
FR;59;2021-03-03;20686;5040;494701;288452;5.6;3.3
FR;59;2021-03-04;32354;5953;527055;294405;6.0;3.3
FR;59;2021-03-05;40966;5564;568021;299969;6.5;3.4
FR;59;2021-03-06;36049;1609;604070;301578;6.9;3.4
FR;59;2021-03-07;14082;1088;618152;302666;7.0;3.4
FR;59;2021-03-08;12305;3231;630457;305897;7.2;3.5
FR;59;2021-03-09;22877;4249;653334;310146;7.4;3.5
FR;59;2021-03-10;23155;4329;676489;314475;7.7;3.6
FR;59;2021-03-11;34385;5552;710874;320027;8.1;3.6
FR;59;2021-03-12;45385;4705;756259;324732;8.6;3.7
FR;59;2021-03-13;36177;1446;792436;326178;9.0;3.7
FR;59;2021-03-14;7193;442;799629;326620;9.1;3.7
FR;59;2021-03-15;14504;2581;814133;329201;9.3;3.7
FR;59;2021-03-16;7902;2992;822035;332193;9.3;3.8
FR;59;2021-03-17;8744;3153;830779;335346;9.4;3.8
FR;59;2021-03-18;10440;4022;841219;339368;9.6;3.9
FR;59;2021-03-19;23482;3581;864701;342949;9.8;3.9
FR;59;2021-03-20;21097;1119;885798;344068;10.1;3.9
FR;59;2021-03-21;6281;395;892079;344463;10.1;3.9
FR;59;2021-03-22;15490;2692;907569;347155;10.3;3.9
FR;59;2021-03-23;25394;3531;932963;350686;10.6;4.0
FR;59;2021-03-24;28015;3540;960978;354226;10.9;4.0
FR;59;2021-03-25;37913;3903;998891;358129;11.4;4.1
FR;59;2021-03-26;42846;4160;1041737;362289;11.8;4.1
FR;59;2021-03-27;26850;1785;1068587;364074;12.2;4.1
FR;59;2021-03-28;7532;475;1076119;364549;12.2;4.1
FR;59;2021-03-29;21668;3372;1097787;367921;12.5;4.2
FR;59;2021-03-30;32108;4393;1129895;372314;12.9;4.2
FR;59;2021-03-31;31404;4688;1161299;377002;13.2;4.3
FR;59;2021-04-01;38373;5865;1199672;382867;13.6;4.4
FR;59;2021-04-02;36872;5816;1236544;388683;14.1;4.4
FR;59;2021-04-03;21306;3483;1257850;392166;14.3;4.5
FR;59;2021-04-04;7344;1231;1265194;393397;14.4;4.5
FR;59;2021-04-05;8259;1106;1273453;394503;14.5;4.5
FR;59;2021-04-06;25704;5940;1299157;400443;14.8;4.6
FR;59;2021-04-07;33879;7164;1333036;407607;15.2;4.6
FR;59;2021-04-08;44968;8559;1378004;416166;15.7;4.7
FR;59;2021-04-09;60688;9130;1438692;425296;16.4;4.8
FR;59;2021-04-10;36436;7134;1475128;432430;16.8;4.9
FR;59;2021-04-11;9736;3533;1484864;435963;16.9;5.0
FR;59;2021-04-12;35235;7456;1520099;443419;17.3;5.0
FR;59;2021-04-13;49764;10195;1569863;453614;17.9;5.2
FR;59;2021-04-14;50097;10212;1619960;463826;18.4;5.3
FR;59;2021-04-15;59417;11813;1679377;475639;19.1;5.4
FR;59;2021-04-16;63242;12512;1742619;488151;19.8;5.6
FR;59;2021-04-17;41442;9729;1784061;497880;20.3;5.7
FR;59;2021-04-18;12284;4657;1796345;502537;20.4;5.7
FR;59;2021-04-19;33235;11210;1829580;513747;20.8;5.8
FR;59;2021-04-20;44680;14761;1874260;528508;21.3;6.0
FR;59;2021-04-21;47301;16506;1921561;545014;21.9;6.2
FR;59;2021-04-22;55847;19543;1977408;564557;22.5;6.4
FR;59;2021-04-23;65229;20862;2042637;585419;23.2;6.7
FR;59;2021-04-24;47506;15593;2090143;601012;23.8;6.8
FR;59;2021-04-25;16660;5483;2106803;606495;24.0;6.9
FR;59;2021-04-26;41449;17549;2148252;624044;24.4;7.1
FR;59;2021-04-27;56604;23357;2204856;647401;25.1;7.4
FR;59;2021-04-28;64324;26010;2269180;673411;25.8;7.7
FR;59;2021-04-29;78183;31701;2347363;705112;26.7;8.0
FR;59;2021-04-30;92604;36633;2439967;741745;27.7;8.4
FR;59;2021-05-01;43600;11069;2483567;752814;28.2;8.6
FR;59;2021-05-02;23500;7318;2507067;760132;28.5;8.6
FR;59;2021-05-03;62761;26338;2569828;786470;29.2;8.9
FR;59;2021-05-04;71148;34400;2640976;820870;30.0;9.3
FR;59;2021-05-05;77374;37365;2718350;858235;30.9;9.8
FR;59;2021-05-06;89405;43635;2807755;901870;31.9;10.3
FR;59;2021-05-07;97927;53927;2905682;955797;33.0;10.9
FR;59;2021-05-08;58752;16529;2964434;972326;33.7;11.1
FR;59;2021-05-09;39268;10378;3003702;982704;34.2;11.2
FR;59;2021-05-10;95338;40081;3099040;1022785;35.2;11.6
FR;59;2021-05-11;125644;49293;3224684;1072078;36.7;12.2
FR;59;2021-05-12;123013;46149;3347697;1118227;38.1;12.7
FR;59;2021-05-13;92604;14394;3440301;1132621;39.1;12.9
FR;59;2021-05-14;129194;34251;3569495;1166872;40.6;13.3
FR;59;2021-05-15;114383;25473;3683878;1192345;41.9;13.6
FR;59;2021-05-16;55267;7152;3739145;1199497;42.5;13.6
FR;59;2021-05-17;105462;30608;3844607;1230105;43.7;14.0
FR;59;2021-05-18;117510;34102;3962117;1264207;45.1;14.4
FR;59;2021-05-19;118792;35383;4080909;1299590;46.4;14.8
FR;59;2021-05-20;122440;42217;4203349;1341807;47.8;15.3
FR;59;2021-05-21;121954;48559;4325303;1390366;49.2;15.8
FR;59;2021-05-22;81836;25340;4407139;1415706;50.1;16.1
FR;59;2021-05-23;31259;5142;4438398;1420848;50.5;16.2
FR;59;2021-05-24;51947;9905;4490345;1430753;51.1;16.3
FR;59;2021-05-25;84376;41918;4574721;1472671;52.0;16.7
FR;59;2021-05-26;83319;44192;4658040;1516863;53.0;17.3
FR;59;2021-05-27;90014;52376;4748054;1569239;54.0;17.8
FR;59;2021-05-28;91768;66584;4839822;1635823;55.0;18.6
FR;59;2021-05-29;60366;40028;4900188;1675851;55.7;19.1
FR;59;2021-05-30;16133;7788;4916321;1683639;55.9;19.1
FR;59;2021-05-31;58621;42382;4974942;1726021;56.6;19.6
FR;59;2021-06-01;68193;53727;5043135;1779748;57.4;20.2
FR;59;2021-06-02;62306;52708;5105441;1832456;58.1;20.8
FR;59;2021-06-03;69692;58344;5175133;1890800;58.9;21.5
FR;59;2021-06-04;71672;71715;5246805;1962515;59.7;22.3
FR;59;2021-06-05;45694;48756;5292499;2011271;60.2;22.9
FR;59;2021-06-06;14248;12578;5306747;2023849;60.4;23.0
FR;59;2021-06-07;43770;54772;5350517;2078621;60.9;23.6
FR;59;2021-06-08;56907;58277;5407424;2136898;61.5;24.3
FR;59;2021-06-09;58200;57166;5465624;2194064;62.2;25.0
FR;59;2021-06-10;62500;55549;5528124;2249613;62.9;25.6
FR;59;2021-06-11;55485;85023;5583609;2334636;63.5;26.6
FR;59;2021-06-12;38514;56572;5622123;2391208;63.9;27.2
FR;59;2021-06-13;11041;19600;5633164;2410808;64.1;27.4
FR;64;2020-12-27;1;0;1;0;0.0;0.0
FR;64;2020-12-28;1;0;2;0;0.0;0.0
FR;64;2020-12-29;2;0;4;0;0.0;0.0
FR;64;2020-12-30;6;0;10;0;0.0;0.0
FR;64;2020-12-31;5;0;15;0;0.0;0.0
FR;64;2021-01-01;8;0;23;0;0.0;0.0
FR;64;2021-01-02;13;0;36;0;0.0;0.0
FR;64;2021-01-03;19;0;55;0;0.0;0.0
FR;64;2021-01-04;209;1;264;1;0.0;0.0
FR;64;2021-01-05;899;4;1163;5;0.0;0.0
FR;64;2021-01-06;1691;3;2854;8;0.1;0.0
FR;64;2021-01-07;3662;10;6516;18;0.2;0.0
FR;64;2021-01-08;4892;12;11408;30;0.3;0.0
FR;64;2021-01-09;1959;2;13367;32;0.3;0.0
FR;64;2021-01-10;1027;1;14394;33;0.4;0.0
FR;64;2021-01-11;5292;10;19686;43;0.5;0.0
FR;64;2021-01-12;7150;14;26836;57;0.7;0.0
FR;64;2021-01-13;7470;18;34306;75;0.8;0.0
FR;64;2021-01-14;8581;88;42887;163;1.0;0.0
FR;64;2021-01-15;7104;35;49991;198;1.2;0.0
FR;64;2021-01-16;2221;18;52212;216;1.3;0.0
FR;64;2021-01-17;844;10;53056;226;1.3;0.0
FR;64;2021-01-18;4687;17;57743;243;1.4;0.0
FR;64;2021-01-19;6411;24;64154;267;1.6;0.0
FR;64;2021-01-20;6242;35;70396;302;1.7;0.0
FR;64;2021-01-21;6928;25;77324;327;1.9;0.0
FR;64;2021-01-22;5436;34;82760;361;2.0;0.0
FR;64;2021-01-23;1417;13;84177;374;2.1;0.0
FR;64;2021-01-24;434;9;84611;383;2.1;0.0
FR;64;2021-01-25;2775;203;87386;586;2.1;0.0
FR;64;2021-01-26;3544;495;90930;1081;2.2;0.0
FR;64;2021-01-27;3771;888;94701;1969;2.3;0.0
FR;64;2021-01-28;4576;1755;99277;3724;2.4;0.1
FR;64;2021-01-29;3534;2330;102811;6054;2.5;0.1
FR;64;2021-01-30;840;708;103651;6762;2.5;0.2
FR;64;2021-01-31;172;279;103823;7041;2.5;0.2
FR;64;2021-02-01;1528;2868;105351;9909;2.6;0.2
FR;64;2021-02-02;2154;4145;107505;14054;2.6;0.3
FR;64;2021-02-03;2310;4366;109815;18420;2.7;0.4
FR;64;2021-02-04;2829;5508;112644;23928;2.7;0.6
FR;64;2021-02-05;2195;4972;114839;28900;2.8;0.7
FR;64;2021-02-06;667;1305;115506;30205;2.8;0.7
FR;64;2021-02-07;165;493;115671;30698;2.8;0.7
FR;64;2021-02-08;1489;4197;117160;34895;2.9;0.9
FR;64;2021-02-09;2352;5669;119512;40564;2.9;1.0
FR;64;2021-02-10;2575;5675;122087;46239;3.0;1.1
FR;64;2021-02-11;3469;7227;125556;53466;3.1;1.3
FR;64;2021-02-12;3116;5452;128672;58918;3.1;1.4
FR;64;2021-02-13;849;1448;129521;60366;3.2;1.5
FR;64;2021-02-14;198;436;129719;60802;3.2;1.5
FR;64;2021-02-15;1595;3886;131314;64688;3.2;1.6
FR;64;2021-02-16;2088;5143;133402;69831;3.3;1.7
FR;64;2021-02-17;2212;4643;135614;74474;3.3;1.8
FR;64;2021-02-18;3247;5460;138861;79934;3.4;1.9
FR;64;2021-02-19;3022;4212;141883;84146;3.5;2.1
FR;64;2021-02-20;811;1205;142694;85351;3.5;2.1
FR;64;2021-02-21;135;255;142829;85606;3.5;2.1
FR;64;2021-02-22;1494;2670;144323;88276;3.5;2.2
FR;64;2021-02-23;2413;2918;146736;91194;3.6;2.2
FR;64;2021-02-24;3880;2856;150616;94050;3.7;2.3
FR;64;2021-02-25;16072;3878;166688;97928;4.1;2.4
FR;64;2021-02-26;21851;2820;188539;100748;4.6;2.5
FR;64;2021-02-27;13095;783;201634;101531;4.9;2.5
FR;64;2021-02-28;799;174;202433;101705;4.9;2.5
FR;64;2021-03-01;6576;1761;209009;103466;5.1;2.5
FR;64;2021-03-02;13158;2380;222167;105846;5.4;2.6
FR;64;2021-03-03;15976;2428;238143;108274;5.8;2.6
FR;64;2021-03-04;25265;2932;263408;111206;6.4;2.7
FR;64;2021-03-05;30564;2747;293972;113953;7.2;2.8
FR;64;2021-03-06;26875;866;320847;114819;7.8;2.8
FR;64;2021-03-07;9896;545;330743;115364;8.1;2.8
FR;64;2021-03-08;8842;1826;339585;117190;8.3;2.9
FR;64;2021-03-09;16862;2080;356447;119270;8.7;2.9
FR;64;2021-03-10;17108;2216;373555;121486;9.1;3.0
FR;64;2021-03-11;26001;2911;399556;124397;9.7;3.0
FR;64;2021-03-12;33512;2520;433068;126917;10.6;3.1
FR;64;2021-03-13;27406;852;460474;127769;11.2;3.1
FR;64;2021-03-14;5445;215;465919;127984;11.4;3.1
FR;64;2021-03-15;11055;1479;476974;129463;11.6;3.2
FR;64;2021-03-16;6000;1789;482974;131252;11.8;3.2
FR;64;2021-03-17;6134;1697;489108;132949;11.9;3.2
FR;64;2021-03-18;7668;2085;496776;135034;12.1;3.3
FR;64;2021-03-19;18956;1961;515732;136995;12.6;3.3
FR;64;2021-03-20;18545;781;534277;137776;13.0;3.4
FR;64;2021-03-21;4728;231;539005;138007;13.1;3.4
FR;64;2021-03-22;13539;1595;552544;139602;13.5;3.4
FR;64;2021-03-23;23523;2057;576067;141659;14.0;3.5
FR;64;2021-03-24;25176;2158;601243;143817;14.7;3.5
FR;64;2021-03-25;36635;2451;637878;146268;15.5;3.6
FR;64;2021-03-26;40195;2414;678073;148682;16.5;3.6
FR;64;2021-03-27;21300;1051;699373;149733;17.0;3.7
FR;64;2021-03-28;5085;268;704458;150001;17.2;3.7
FR;64;2021-03-29;17561;2161;722019;152162;17.6;3.7
FR;64;2021-03-30;27313;2892;749332;155054;18.3;3.8
FR;64;2021-03-31;24145;2946;773477;158000;18.9;3.9
FR;64;2021-04-01;30554;3825;804031;161825;19.6;3.9
FR;64;2021-04-02;29218;3645;833249;165470;20.3;4.0
FR;64;2021-04-03;15985;2395;849234;167865;20.7;4.1
FR;64;2021-04-04;4032;802;853266;168667;20.8;4.1
FR;64;2021-04-05;5106;805;858372;169472;20.9;4.1
FR;64;2021-04-06;19200;4301;877572;173773;21.4;4.2
FR;64;2021-04-07;23548;4833;901120;178606;22.0;4.4
FR;64;2021-04-08;34572;5676;935692;184282;22.8;4.5
FR;64;2021-04-09;53462;6169;989154;190451;24.1;4.6
FR;64;2021-04-10;29835;5054;1018989;195505;24.8;4.8
FR;64;2021-04-11;6265;2616;1025254;198121;25.0;4.8
FR;64;2021-04-12;28030;5210;1053284;203331;25.7;5.0
FR;64;2021-04-13;42466;7420;1095750;210751;26.7;5.1
FR;64;2021-04-14;40715;7179;1136465;217930;27.7;5.3
FR;64;2021-04-15;51887;8437;1188352;226367;29.0;5.5
FR;64;2021-04-16;64200;8953;1252552;235320;30.5;5.7
FR;64;2021-04-17;38500;7153;1291052;242473;31.5;5.9
FR;64;2021-04-18;10923;3351;1301975;245824;31.7;6.0
FR;64;2021-04-19;41956;8624;1343931;254448;32.8;6.2
FR;64;2021-04-20;52620;10464;1396551;264912;34.0;6.5
FR;64;2021-04-21;52475;10924;1449026;275836;35.3;6.7
FR;64;2021-04-22;57366;12821;1506392;288657;36.7;7.0
FR;64;2021-04-23;60836;12775;1567228;301432;38.2;7.3
FR;64;2021-04-24;43373;9131;1610601;310563;39.3;7.6
FR;64;2021-04-25;16228;3383;1626829;313946;39.7;7.7
FR;64;2021-04-26;50021;11577;1676850;325523;40.9;7.9
FR;64;2021-04-27;62987;15591;1739837;341114;42.4;8.3
FR;64;2021-04-28;64006;16048;1803843;357162;44.0;8.7
FR;64;2021-04-29;73695;20482;1877538;377644;45.8;9.2
FR;64;2021-04-30;75230;22051;1952768;399695;47.6;9.7
FR;64;2021-05-01;29341;6704;1982109;406399;48.3;9.9
FR;64;2021-05-02;14490;4002;1996599;410401;48.7;10.0
FR;64;2021-05-03;52199;15883;2048798;426284;49.9;10.4
FR;64;2021-05-04;53080;21636;2101878;447920;51.2;10.9
FR;64;2021-05-05;49293;22704;2151171;470624;52.4;11.5
FR;64;2021-05-06;56729;28815;2207900;499439;53.8;12.2
FR;64;2021-05-07;50832;34000;2258732;533439;55.1;13.0
FR;64;2021-05-08;20322;9314;2279054;542753;55.6;13.2
FR;64;2021-05-09;10002;5492;2289056;548245;55.8;13.4
FR;64;2021-05-10;34384;26772;2323440;575017;56.6;14.0
FR;64;2021-05-11;43976;37122;2367416;612139;57.7;14.9
FR;64;2021-05-12;38983;34962;2406399;647101;58.7;15.8
FR;64;2021-05-13;21995;10048;2428394;657149;59.2;16.0
FR;64;2021-05-14;36336;29045;2464730;686194;60.1;16.7
FR;64;2021-05-15;21253;18996;2485983;705190;60.6;17.2
FR;64;2021-05-16;7964;4304;2493947;709494;60.8;17.3
FR;64;2021-05-17;26872;25392;2520819;734886;61.5;17.9
FR;64;2021-05-18;33513;28326;2554332;763212;62.3;18.6
FR;64;2021-05-19;30443;26369;2584775;789581;63.0;19.2
FR;64;2021-05-20;34998;33235;2619773;822816;63.9;20.1
FR;64;2021-05-21;30235;37370;2650008;860186;64.6;21.0
FR;64;2021-05-22;14829;17699;2664837;877885;65.0;21.4
FR;64;2021-05-23;5115;2827;2669952;880712;65.1;21.5
FR;64;2021-05-24;10759;6491;2680711;887203;65.3;21.6
FR;64;2021-05-25;22683;34335;2703394;921538;65.9;22.5
FR;64;2021-05-26;21428;34948;2724822;956486;66.4;23.3
FR;64;2021-05-27;25963;42964;2750785;999450;67.1;24.4
FR;64;2021-05-28;24462;55730;2775247;1055180;67.7;25.7
FR;64;2021-05-29;11926;33507;2787173;1088687;67.9;26.5
FR;64;2021-05-30;2674;7429;2789847;1096116;68.0;26.7
FR;64;2021-05-31;15829;45969;2805676;1142085;68.4;27.8
FR;64;2021-06-01;20820;56358;2826496;1198443;68.9;29.2
FR;64;2021-06-02;17016;50402;2843512;1248845;69.3;30.4
FR;64;2021-06-03;21171;55002;2864683;1303847;69.8;31.8
FR;64;2021-06-04;19779;66518;2884462;1370365;70.3;33.4
FR;64;2021-06-05;9347;43211;2893809;1413576;70.5;34.5
FR;64;2021-06-06;2661;10957;2896470;1424533;70.6;34.7
FR;64;2021-06-07;12268;60821;2908738;1485354;70.9;36.2
FR;64;2021-06-08;20456;62970;2929194;1548324;71.4;37.7
FR;64;2021-06-09;21784;51027;2950978;1599351;71.9;39.0
FR;64;2021-06-10;24272;49031;2975250;1648382;72.5;40.2
FR;64;2021-06-11;14906;69833;2990156;1718215;72.9;41.9
FR;64;2021-06-12;8012;36059;2998168;1754274;73.1;42.8
FR;64;2021-06-13;2102;9728;3000270;1764002;73.1;43.0
FR;69;2020-12-27;2;0;2;0;0.0;0.0
FR;69;2020-12-28;2;0;4;0;0.0;0.0
FR;69;2020-12-29;3;0;7;0;0.0;0.0
FR;69;2020-12-30;7;0;14;0;0.0;0.0
FR;69;2020-12-31;5;0;19;0;0.0;0.0
FR;69;2021-01-01;6;0;25;0;0.0;0.0
FR;69;2021-01-02;11;1;36;1;0.0;0.0
FR;69;2021-01-03;8;0;44;1;0.0;0.0
FR;69;2021-01-04;115;0;159;1;0.0;0.0
FR;69;2021-01-05;411;4;570;5;0.0;0.0
FR;69;2021-01-06;810;2;1380;7;0.0;0.0
FR;69;2021-01-07;1893;3;3273;10;0.1;0.0
FR;69;2021-01-08;2461;1;5734;11;0.1;0.0
FR;69;2021-01-09;1125;1;6859;12;0.2;0.0
FR;69;2021-01-10;660;1;7519;13;0.2;0.0
FR;69;2021-01-11;2741;6;10260;19;0.3;0.0
FR;69;2021-01-12;3884;1;14144;20;0.4;0.0
FR;69;2021-01-13;3802;14;17946;34;0.5;0.0
FR;69;2021-01-14;4570;47;22516;81;0.6;0.0
FR;69;2021-01-15;3853;14;26369;95;0.7;0.0
FR;69;2021-01-16;1344;12;27713;107;0.7;0.0
FR;69;2021-01-17;634;3;28347;110;0.7;0.0
FR;69;2021-01-18;3260;18;31607;128;0.8;0.0
FR;69;2021-01-19;4797;22;36404;150;0.9;0.0
FR;69;2021-01-20;4767;17;41171;167;1.1;0.0
FR;69;2021-01-21;5549;20;46720;187;1.2;0.0
FR;69;2021-01-22;4375;20;51095;207;1.3;0.0
FR;69;2021-01-23;1363;5;52458;212;1.3;0.0
FR;69;2021-01-24;448;6;52906;218;1.4;0.0
FR;69;2021-01-25;2729;82;55635;300;1.4;0.0
FR;69;2021-01-26;3363;183;58998;483;1.5;0.0
FR;69;2021-01-27;3670;415;62668;898;1.6;0.0
FR;69;2021-01-28;4333;895;67001;1793;1.7;0.0
FR;69;2021-01-29;3490;1237;70491;3030;1.8;0.1
FR;69;2021-01-30;939;403;71430;3433;1.8;0.1
FR;69;2021-01-31;180;162;71610;3595;1.8;0.1
FR;69;2021-02-01;1830;1522;73440;5117;1.9;0.1
FR;69;2021-02-02;2430;2202;75870;7319;1.9;0.2
FR;69;2021-02-03;2423;2272;78293;9591;2.0;0.2
FR;69;2021-02-04;2993;2926;81286;12517;2.1;0.3
FR;69;2021-02-05;2512;2540;83798;15057;2.1;0.4
FR;69;2021-02-06;727;808;84525;15865;2.2;0.4
FR;69;2021-02-07;162;391;84687;16256;2.2;0.4
FR;69;2021-02-08;1611;2411;86298;18667;2.2;0.5
FR;69;2021-02-09;2428;3417;88726;22084;2.3;0.6
FR;69;2021-02-10;2570;3406;91296;25490;2.3;0.7
FR;69;2021-02-11;3532;4867;94828;30357;2.4;0.8
FR;69;2021-02-12;3165;3424;97993;33781;2.5;0.9
FR;69;2021-02-13;870;1034;98863;34815;2.5;0.9
FR;69;2021-02-14;217;414;99080;35229;2.5;0.9
FR;69;2021-02-15;1337;2779;100417;38008;2.6;1.0
FR;69;2021-02-16;1874;3985;102291;41993;2.6;1.1
FR;69;2021-02-17;2010;3664;104301;45657;2.7;1.2
FR;69;2021-02-18;3009;4564;107310;50221;2.8;1.3
FR;69;2021-02-19;2886;3516;110196;53737;2.8;1.4
FR;69;2021-02-20;760;1027;110956;54764;2.8;1.4
FR;69;2021-02-21;150;235;111106;54999;2.8;1.4
FR;69;2021-02-22;1619;2577;112725;57576;2.9;1.5
FR;69;2021-02-23;2289;2823;115014;60399;2.9;1.5
FR;69;2021-02-24;2669;2912;117683;63311;3.0;1.6
FR;69;2021-02-25;3898;3588;121581;66899;3.1;1.7
FR;69;2021-02-26;4285;2635;125866;69534;3.2;1.8
FR;69;2021-02-27;1820;707;127686;70241;3.3;1.8
FR;69;2021-02-28;312;181;127998;70422;3.3;1.8
FR;69;2021-03-01;2812;1942;130810;72364;3.4;1.9
FR;69;2021-03-02;4728;2450;135538;74814;3.5;1.9
FR;69;2021-03-03;6730;2482;142268;77296;3.6;2.0
FR;69;2021-03-04;11828;3045;154096;80341;3.9;2.1
FR;69;2021-03-05;17546;2731;171642;83072;4.4;2.1
FR;69;2021-03-06;23275;837;194917;83909;5.0;2.2
FR;69;2021-03-07;14809;481;209726;84390;5.4;2.2
FR;69;2021-03-08;9802;2071;219528;86461;5.6;2.2
FR;69;2021-03-09;17537;2527;237065;88988;6.1;2.3
FR;69;2021-03-10;18887;2589;255952;91577;6.6;2.3
FR;69;2021-03-11;29271;3285;285223;94862;7.3;2.4
FR;69;2021-03-12;40011;3041;325234;97903;8.3;2.5
FR;69;2021-03-13;36140;1062;361374;98965;9.3;2.5
FR;69;2021-03-14;8215;272;369589;99237;9.5;2.5
FR;69;2021-03-15;16719;1839;386308;101076;9.9;2.6
FR;69;2021-03-16;10728;2197;397036;103273;10.2;2.6
FR;69;2021-03-17;11750;2203;408786;105476;10.5;2.7
FR;69;2021-03-18;13138;2621;421924;108097;10.8;2.8
FR;69;2021-03-19;28884;2468;450808;110565;11.6;2.8
FR;69;2021-03-20;26986;917;477794;111482;12.2;2.9
FR;69;2021-03-21;7129;284;484923;111766;12.4;2.9
FR;69;2021-03-22;21235;2199;506158;113965;13.0;2.9
FR;69;2021-03-23;36235;2832;542393;116797;13.9;3.0
FR;69;2021-03-24;37528;2875;579921;119672;14.9;3.1
FR;69;2021-03-25;55057;3170;634978;122842;16.3;3.1
FR;69;2021-03-26;59206;3052;694184;125894;17.8;3.2
FR;69;2021-03-27;30193;1410;724377;127304;18.6;3.3
FR;69;2021-03-28;7610;400;731987;127704;18.8;3.3
FR;69;2021-03-29;27703;3487;759690;131191;19.5;3.4
FR;69;2021-03-30;42274;4417;801964;135608;20.6;3.5
FR;69;2021-03-31;35381;4437;837345;140045;21.5;3.6
FR;69;2021-04-01;43292;5817;880637;145862;22.6;3.7
FR;69;2021-04-02;41358;5960;921995;151822;23.6;3.9
FR;69;2021-04-03;21664;3947;943659;155769;24.2;4.0
FR;69;2021-04-04;5810;1310;949469;157079;24.3;4.0
FR;69;2021-04-05;7615;1070;957084;158149;24.5;4.1
FR;69;2021-04-06;27900;7222;984984;165371;25.2;4.2
FR;69;2021-04-07;32424;7780;1017408;173151;26.1;4.4
FR;69;2021-04-08;48552;8903;1065960;182054;27.3;4.7
FR;69;2021-04-09;70600;9110;1136560;191164;29.1;4.9
FR;69;2021-04-10;36661;7884;1173221;199048;30.1;5.1
FR;69;2021-04-11;7980;4292;1181201;203340;30.3;5.2
FR;69;2021-04-12;38580;8866;1219781;212206;31.3;5.4
FR;69;2021-04-13;53506;11999;1273287;224205;32.6;5.7
FR;69;2021-04-14;49300;11687;1322587;235892;33.9;6.0
FR;69;2021-04-15;61813;13579;1384400;249471;35.5;6.4
FR;69;2021-04-16;72602;14104;1457002;263575;37.3;6.8
FR;69;2021-04-17;39648;10717;1496650;274292;38.4;7.0
FR;69;2021-04-18;10021;5036;1506671;279328;38.6;7.2
FR;69;2021-04-19;45895;13915;1552566;293243;39.8;7.5
FR;69;2021-04-20;57158;16848;1609724;310091;41.3;7.9
FR;69;2021-04-21;53485;16586;1663209;326677;42.6;8.4
FR;69;2021-04-22;60240;18767;1723449;345444;44.2;8.9
FR;69;2021-04-23;59393;18803;1782842;364247;45.7;9.3
FR;69;2021-04-24;37320;13180;1820162;377427;46.6;9.7
FR;69;2021-04-25;13273;5014;1833435;382441;47.0;9.8
FR;69;2021-04-26;49697;18399;1883132;400840;48.3;10.3
FR;69;2021-04-27;61791;23241;1944923;424081;49.8;10.9
FR;69;2021-04-28;59851;22119;2004774;446200;51.4;11.4
FR;69;2021-04-29;70141;24896;2074915;471096;53.2;12.1
FR;69;2021-04-30;66950;23960;2141865;495056;54.9;12.7
FR;69;2021-05-01;23890;7635;2165755;502691;55.5;12.9
FR;69;2021-05-02;11194;5165;2176949;507856;55.8;13.0
FR;69;2021-05-03;47400;21367;2224349;529223;57.0;13.6
FR;69;2021-05-04;47894;27737;2272243;556960;58.2;14.3
FR;69;2021-05-05;42619;27158;2314862;584118;59.3;15.0
FR;69;2021-05-06;50777;30234;2365639;614352;60.6;15.7
FR;69;2021-05-07;42294;34326;2407933;648678;61.7;16.6
FR;69;2021-05-08;15356;9379;2423289;658057;62.1;16.9
FR;69;2021-05-09;7282;6567;2430571;664624;62.3;17.0
FR;69;2021-05-10;29609;34710;2460180;699334;63.1;17.9
FR;69;2021-05-11;38189;43760;2498369;743094;64.0;19.0
FR;69;2021-05-12;33005;39218;2531374;782312;64.9;20.0
FR;69;2021-05-13;17477;11509;2548851;793821;65.3;20.3
FR;69;2021-05-14;30054;34171;2578905;827992;66.1;21.2
FR;69;2021-05-15;15254;18531;2594159;846523;66.5;21.7
FR;69;2021-05-16;5431;4316;2599590;850839;66.6;21.8
FR;69;2021-05-17;21823;28795;2621413;879634;67.2;22.5
FR;69;2021-05-18;27963;29625;2649376;909259;67.9;23.3
FR;69;2021-05-19;24360;25226;2673736;934485;68.5;23.9
FR;69;2021-05-20;28390;27826;2702126;962311;69.3;24.7
FR;69;2021-05-21;22996;30740;2725122;993051;69.8;25.5
FR;69;2021-05-22;9672;14373;2734794;1007424;70.1;25.8
FR;69;2021-05-23;3188;2378;2737982;1009802;70.2;25.9
FR;69;2021-05-24;8108;7130;2746090;1016932;70.4;26.1
FR;69;2021-05-25;17874;36207;2763964;1053139;70.8;27.0
FR;69;2021-05-26;16360;34464;2780324;1087603;71.3;27.9
FR;69;2021-05-27;20599;42261;2800923;1129864;71.8;29.0
FR;69;2021-05-28;18286;53858;2819209;1183722;72.3;30.3
FR;69;2021-05-29;7656;31253;2826865;1214975;72.4;31.1
FR;69;2021-05-30;1699;6901;2828564;1221876;72.5;31.3
FR;69;2021-05-31;12335;47504;2840899;1269380;72.8;32.5
FR;69;2021-06-01;16188;57646;2857087;1327026;73.2;34.0
FR;69;2021-06-02;12947;49990;2870034;1377016;73.6;35.3
FR;69;2021-06-03;16342;57658;2886376;1434674;74.0;36.8
FR;69;2021-06-04;14549;67082;2900925;1501756;74.3;38.5
FR;69;2021-06-05;6060;39503;2906985;1541259;74.5;39.5
FR;69;2021-06-06;1565;9070;2908550;1550329;74.5;39.7
FR;69;2021-06-07;9695;59494;2918245;1609823;74.8;41.3
FR;69;2021-06-08;18963;61690;2937208;1671513;75.3;42.8
FR;69;2021-06-09;19642;46567;2956850;1718080;75.8;44.0
FR;69;2021-06-10;23119;48455;2979969;1766535;76.4;45.3
FR;69;2021-06-11;11956;69227;2991925;1835762;76.7;47.0
FR;69;2021-06-12;5533;32188;2997458;1867950;76.8;47.9
FR;69;2021-06-13;1299;7811;2998757;1875761;76.9;48.1
FR;74;2020-12-27;1;0;1;0;0.0;0.0
FR;74;2020-12-28;7;0;8;0;0.0;0.0
FR;74;2020-12-29;5;0;13;0;0.0;0.0
FR;74;2020-12-30;11;0;24;0;0.0;0.0
FR;74;2020-12-31;7;0;31;0;0.0;0.0
FR;74;2021-01-01;5;0;36;0;0.0;0.0
FR;74;2021-01-02;3;0;39;0;0.0;0.0
FR;74;2021-01-03;13;0;52;0;0.0;0.0
FR;74;2021-01-04;89;1;141;1;0.0;0.0
FR;74;2021-01-05;298;0;439;1;0.0;0.0
FR;74;2021-01-06;555;1;994;2;0.0;0.0
FR;74;2021-01-07;1465;0;2459;2;0.1;0.0
FR;74;2021-01-08;1805;4;4264;6;0.1;0.0
FR;74;2021-01-09;799;0;5063;6;0.1;0.0
FR;74;2021-01-10;538;0;5601;6;0.2;0.0
FR;74;2021-01-11;2135;2;7736;8;0.2;0.0
FR;74;2021-01-12;3157;6;10893;14;0.3;0.0
FR;74;2021-01-13;3217;7;14110;21;0.4;0.0
FR;74;2021-01-14;3959;41;18069;62;0.5;0.0
FR;74;2021-01-15;3546;11;21615;73;0.6;0.0
FR;74;2021-01-16;1339;5;22954;78;0.7;0.0
FR;74;2021-01-17;766;4;23720;82;0.7;0.0
FR;74;2021-01-18;4724;13;28444;95;0.8;0.0
FR;74;2021-01-19;6832;14;35276;109;1.0;0.0
FR;74;2021-01-20;7119;12;42395;121;1.2;0.0
FR;74;2021-01-21;8215;26;50610;147;1.5;0.0
FR;74;2021-01-22;6562;22;57172;169;1.6;0.0
FR;74;2021-01-23;2262;4;59434;173;1.7;0.0
FR;74;2021-01-24;612;2;60046;175;1.7;0.0
FR;74;2021-01-25;4549;56;64595;231;1.9;0.0
FR;74;2021-01-26;5639;152;70234;383;2.0;0.0
FR;74;2021-01-27;5988;272;76222;655;2.2;0.0
FR;74;2021-01-28;6988;750;83210;1405;2.4;0.0
FR;74;2021-01-29;5741;900;88951;2305;2.6;0.1
FR;74;2021-01-30;1770;262;90721;2567;2.6;0.1
FR;74;2021-01-31;296;114;91017;2681;2.6;0.1
FR;74;2021-02-01;3300;1064;94317;3745;2.7;0.1
FR;74;2021-02-02;4313;1785;98630;5530;2.8;0.2
FR;74;2021-02-03;4321;1807;102951;7337;3.0;0.2
FR;74;2021-02-04;5188;2469;108139;9806;3.1;0.3
FR;74;2021-02-05;4397;2180;112536;11986;3.2;0.3
FR;74;2021-02-06;1413;695;113949;12681;3.3;0.4
FR;74;2021-02-07;243;351;114192;13032;3.3;0.4
FR;74;2021-02-08;3085;2508;117277;15540;3.4;0.4
FR;74;2021-02-09;4126;3726;121403;19266;3.5;0.6
FR;74;2021-02-10;4428;3816;125831;23082;3.6;0.7
FR;74;2021-02-11;5648;5476;131479;28558;3.8;0.8
FR;74;2021-02-12;5281;3821;136760;32379;3.9;0.9
FR;74;2021-02-13;1658;1219;138418;33598;4.0;1.0
FR;74;2021-02-14;408;471;138826;34069;4.0;1.0
FR;74;2021-02-15;2408;4183;141234;38252;4.1;1.1
FR;74;2021-02-16;3276;5634;144510;43886;4.2;1.3
FR;74;2021-02-17;3394;5455;147904;49341;4.3;1.4
FR;74;2021-02-18;4950;6817;152854;56158;4.4;1.6
FR;74;2021-02-19;4889;5418;157743;61576;4.5;1.8
FR;74;2021-02-20;1558;1738;159301;63314;4.6;1.8
FR;74;2021-02-21;233;415;159534;63729;4.6;1.8
FR;74;2021-02-22;2881;4293;162415;68022;4.7;2.0
FR;74;2021-02-23;4157;4899;166572;72921;4.8;2.1
FR;74;2021-02-24;4538;4848;171110;77769;4.9;2.2
FR;74;2021-02-25;5540;5708;176650;83477;5.1;2.4
FR;74;2021-02-26;5494;4483;182144;87960;5.2;2.5
FR;74;2021-02-27;2033;1368;184177;89328;5.3;2.6
FR;74;2021-02-28;529;294;184706;89622;5.3;2.6
FR;74;2021-03-01;5088;3375;189794;92997;5.5;2.7
FR;74;2021-03-02;7483;4292;197277;97289;5.7;2.8
FR;74;2021-03-03;9738;4275;207015;101564;6.0;2.9
FR;74;2021-03-04;15142;4852;222157;106416;6.4;3.1
FR;74;2021-03-05;21757;4650;243914;111066;7.0;3.2
FR;74;2021-03-06;31354;1472;275268;112538;7.9;3.2
FR;74;2021-03-07;21008;600;296276;113138;8.5;3.3
FR;74;2021-03-08;14283;3708;310559;116846;8.9;3.4
FR;74;2021-03-09;24124;4278;334683;121124;9.6;3.5
FR;74;2021-03-10;26382;4479;361065;125603;10.4;3.6
FR;74;2021-03-11;38441;5417;399506;131020;11.5;3.8
FR;74;2021-03-12;50761;4838;450267;135858;12.9;3.9
FR;74;2021-03-13;48002;1676;498269;137534;14.3;4.0
FR;74;2021-03-14;11992;459;510261;137993;14.7;4.0
FR;74;2021-03-15;25580;3201;535841;141194;15.4;4.1
FR;74;2021-03-16;20042;3879;555883;145073;16.0;4.2
FR;74;2021-03-17;21812;3916;577695;148989;16.6;4.3
FR;74;2021-03-18;24447;4567;602142;153556;17.3;4.4
FR;74;2021-03-19;41440;4061;643582;157617;18.5;4.5
FR;74;2021-03-20;35462;1631;679044;159248;19.5;4.6
FR;74;2021-03-21;9475;423;688519;159671;19.8;4.6
FR;74;2021-03-22;31531;3955;720050;163626;20.7;4.7
FR;74;2021-03-23;50200;4897;770250;168523;22.1;4.8
FR;74;2021-03-24;52169;5267;822419;173790;23.6;5.0
FR;74;2021-03-25;74832;5674;897251;179464;25.8;5.2
FR;74;2021-03-26;80840;5349;978091;184813;28.1;5.3
FR;74;2021-03-27;51081;2472;1029172;187285;29.6;5.4
FR;74;2021-03-28;17811;767;1046983;188052;30.1;5.4
FR;74;2021-03-29;56091;6970;1103074;195022;31.7;5.6
FR;74;2021-03-30;76551;8849;1179625;203871;33.9;5.9
FR;74;2021-03-31;67936;9400;1247561;213271;35.9;6.1
FR;74;2021-04-01;78370;11793;1325931;225064;38.1;6.5
FR;74;2021-04-02;69985;12360;1395916;237424;40.1;6.8
FR;74;2021-04-03;37163;8478;1433079;245902;41.2;7.1
FR;74;2021-04-04;12499;2796;1445578;248698;41.6;7.1
FR;74;2021-04-05;19203;1891;1464781;250589;42.1;7.2
FR;74;2021-04-06;64399;15156;1529180;265745;44.0;7.6
FR;74;2021-04-07;72638;16030;1601818;281775;46.1;8.1
FR;74;2021-04-08;87601;17962;1689419;299737;48.6;8.6
FR;74;2021-04-09;97265;17778;1786684;317515;51.4;9.1
FR;74;2021-04-10;48588;14058;1835272;331573;52.8;9.5
FR;74;2021-04-11;12706;6827;1847978;338400;53.1;9.7
FR;74;2021-04-12;60891;17742;1908869;356142;54.9;10.2
FR;74;2021-04-13;68709;22222;1977578;378364;56.9;10.9
FR;74;2021-04-14;60096;21791;2037674;400155;58.6;11.5
FR;74;2021-04-15;61943;23749;2099617;423904;60.4;12.2
FR;74;2021-04-16;52255;24326;2151872;448230;61.9;12.9
FR;74;2021-04-17;25719;16811;2177591;465041;62.6;13.4
FR;74;2021-04-18;5743;6964;2183334;472005;62.8;13.6
FR;74;2021-04-19;31743;24302;2215077;496307;63.7;14.3
FR;74;2021-04-20;36306;29591;2251383;525898;64.7;15.1
FR;74;2021-04-21;33379;30214;2284762;556112;65.7;16.0
FR;74;2021-04-22;38096;35175;2322858;591287;66.8;17.0
FR;74;2021-04-23;34826;38782;2357684;630069;67.8;18.1
FR;74;2021-04-24;18648;30725;2376332;660794;68.3;19.0
FR;74;2021-04-25;6144;12560;2382476;673354;68.5;19.4
FR;74;2021-04-26;26751;46850;2409227;720204;69.3;20.7
FR;74;2021-04-27;33072;56028;2442299;776232;70.2;22.3
FR;74;2021-04-28;32636;52805;2474935;829037;71.2;23.8
FR;74;2021-04-29;38744;53939;2513679;882976;72.3;25.4
FR;74;2021-04-30;35056;49127;2548735;932103;73.3;26.8
FR;74;2021-05-01;11100;15143;2559835;947246;73.6;27.2
FR;74;2021-05-02;5178;11392;2565013;958638;73.7;27.6
FR;74;2021-05-03;24163;52097;2589176;1010735;74.4;29.1
FR;74;2021-05-04;25058;69203;2614234;1079938;75.2;31.0
FR;74;2021-05-05;22628;64897;2636862;1144835;75.8;32.9
FR;74;2021-05-06;27298;63249;2664160;1208084;76.6;34.7
FR;74;2021-05-07;23234;65981;2687394;1274065;77.3;36.6
FR;74;2021-05-08;7960;14300;2695354;1288365;77.5;37.0
FR;74;2021-05-09;3661;10472;2699015;1298837;77.6;37.3
FR;74;2021-05-10;15995;63043;2715010;1361880;78.1;39.2
FR;74;2021-05-11;20952;64086;2735962;1425966;78.7;41.0
FR;74;2021-05-12;18368;53150;2754330;1479116;79.2;42.5
FR;74;2021-05-13;9062;12078;2763392;1491194;79.4;42.9
FR;74;2021-05-14;16942;37746;2780334;1528940;79.9;44.0
FR;74;2021-05-15;8372;17564;2788706;1546504;80.2;44.5
FR;74;2021-05-16;2980;3500;2791686;1550004;80.3;44.6
FR;74;2021-05-17;12216;30787;2803902;1580791;80.6;45.4
FR;74;2021-05-18;15434;30478;2819336;1611269;81.1;46.3
FR;74;2021-05-19;14019;25387;2833355;1636656;81.5;47.1
FR;74;2021-05-20;16008;27674;2849363;1664330;81.9;47.8
FR;74;2021-05-21;13370;30682;2862733;1695012;82.3;48.7
FR;74;2021-05-22;5769;14218;2868502;1709230;82.5;49.1
FR;74;2021-05-23;1852;2381;2870354;1711611;82.5;49.2
FR;74;2021-05-24;4632;5723;2874986;1717334;82.7;49.4
FR;74;2021-05-25;10570;35182;2885556;1752516;83.0;50.4
FR;74;2021-05-26;10008;32938;2895564;1785454;83.2;51.3
FR;74;2021-05-27;11832;39425;2907396;1824879;83.6;52.5
FR;74;2021-05-28;11235;45032;2918631;1869911;83.9;53.8
FR;74;2021-05-29;4750;24301;2923381;1894212;84.0;54.5
FR;74;2021-05-30;1042;4238;2924423;1898450;84.1;54.6
FR;74;2021-05-31;7561;29824;2931984;1928274;84.3;55.4
FR;74;2021-06-01;10265;40143;2942249;1968417;84.6;56.6
FR;74;2021-06-02;8442;34068;2950691;2002485;84.8;57.6
FR;74;2021-06-03;10510;42306;2961201;2044791;85.1;58.8
FR;74;2021-06-04;9661;48022;2970862;2092813;85.4;60.2
FR;74;2021-06-05;4037;25140;2974899;2117953;85.5;60.9
FR;74;2021-06-06;933;4682;2975832;2122635;85.6;61.0
FR;74;2021-06-07;6107;31612;2981939;2154247;85.7;61.9
FR;74;2021-06-08;12680;34642;2994619;2188889;86.1;62.9
FR;74;2021-06-09;13662;26212;3008281;2215101;86.5;63.7
FR;74;2021-06-10;16421;30300;3024702;2245401;87.0;64.6
FR;74;2021-06-11;8098;46517;3032800;2291918;87.2;65.9
FR;74;2021-06-12;3576;20512;3036376;2312430;87.3;66.5
FR;74;2021-06-13;837;4143;3037213;2316573;87.3;66.6
FR;79;2020-12-27;1;0;1;0;0.0;0.0
FR;79;2020-12-28;6;0;7;0;0.0;0.0
FR;79;2020-12-29;16;0;23;0;0.0;0.0
FR;79;2020-12-30;12;0;35;0;0.0;0.0
FR;79;2020-12-31;6;0;41;0;0.0;0.0
FR;79;2021-01-01;6;0;47;0;0.0;0.0
FR;79;2021-01-02;4;0;51;0;0.0;0.0
FR;79;2021-01-03;2;0;53;0;0.0;0.0
FR;79;2021-01-04;50;0;103;0;0.0;0.0
FR;79;2021-01-05;172;0;275;0;0.0;0.0
FR;79;2021-01-06;341;1;616;1;0.0;0.0
FR;79;2021-01-07;905;0;1521;1;0.1;0.0
FR;79;2021-01-08;1086;1;2607;2;0.1;0.0
FR;79;2021-01-09;364;0;2971;2;0.1;0.0
FR;79;2021-01-10;192;0;3163;2;0.1;0.0
FR;79;2021-01-11;1160;3;4323;5;0.2;0.0
FR;79;2021-01-12;2211;2;6534;7;0.3;0.0
FR;79;2021-01-13;2759;2;9293;9;0.4;0.0
FR;79;2021-01-14;4441;35;13734;44;0.6;0.0
FR;79;2021-01-15;5276;18;19010;62;0.9;0.0
FR;79;2021-01-16;2828;12;21838;74;1.0;0.0
FR;79;2021-01-17;1309;3;23147;77;1.0;0.0
FR;79;2021-01-18;19684;40;42831;117;1.9;0.0
FR;79;2021-01-19;26072;40;68903;157;3.1;0.0
FR;79;2021-01-20;28083;34;96986;191;4.4;0.0
FR;79;2021-01-21;30111;40;127097;231;5.7;0.0
FR;79;2021-01-22;27964;33;155061;264;7.0;0.0
FR;79;2021-01-23;11684;12;166745;276;7.5;0.0
FR;79;2021-01-24;2173;3;168918;279;7.6;0.0
FR;79;2021-01-25;22583;50;191501;329;8.6;0.0
FR;79;2021-01-26;25764;123;217265;452;9.8;0.0
FR;79;2021-01-27;25039;201;242304;653;10.9;0.0
FR;79;2021-01-28;25238;567;267542;1220;12.1;0.1
FR;79;2021-01-29;22559;566;290101;1786;13.1;0.1
FR;79;2021-01-30;8789;138;298890;1924;13.5;0.1
FR;79;2021-01-31;1233;55;300123;1979;13.5;0.1
FR;79;2021-02-01;16188;649;316311;2628;14.3;0.1
FR;79;2021-02-02;19315;1277;335626;3905;15.1;0.2
FR;79;2021-02-03;18323;1588;353949;5493;16.0;0.2
FR;79;2021-02-04;19217;2538;373166;8031;16.8;0.4
FR;79;2021-02-05;18066;2690;391232;10721;17.6;0.5
FR;79;2021-02-06;6460;1008;397692;11729;17.9;0.5
FR;79;2021-02-07;870;391;398562;12120;18.0;0.5
FR;79;2021-02-08;13116;5816;411678;17936;18.6;0.8
FR;79;2021-02-09;15601;7679;427279;25615;19.3;1.2
FR;79;2021-02-10;15467;8060;442746;33675;20.0;1.5
FR;79;2021-02-11;16549;9615;459295;43290;20.7;2.0
FR;79;2021-02-12;15695;9422;474990;52712;21.4;2.4
FR;79;2021-02-13;5015;4126;480005;56838;21.6;2.6
FR;79;2021-02-14;905;1044;480910;57882;21.7;2.6
FR;79;2021-02-15;7137;19833;488047;77715;22.0;3.5
FR;79;2021-02-16;8356;23636;496403;101351;22.4;4.6
FR;79;2021-02-17;8256;24032;504659;125383;22.8;5.7
FR;79;2021-02-18;10325;24433;514984;149816;23.2;6.8
FR;79;2021-02-19;10345;20773;525329;170589;23.7;7.7
FR;79;2021-02-20;3783;8315;529112;178904;23.9;8.1
FR;79;2021-02-21;549;1557;529661;180461;23.9;8.1
FR;79;2021-02-22;7002;21892;536663;202353;24.2;9.1
FR;79;2021-02-23;9663;23574;546326;225927;24.6;10.2
FR;79;2021-02-24;10066;22215;556392;248142;25.1;11.2
FR;79;2021-02-25;11719;22104;568111;270246;25.6;12.2
FR;79;2021-02-26;12086;19132;580197;289378;26.2;13.1
FR;79;2021-02-27;4431;6741;584628;296119;26.4;13.4
FR;79;2021-02-28;876;1038;585504;297157;26.4;13.4
FR;79;2021-03-01;12141;16471;597645;313628;27.0;14.1
FR;79;2021-03-02;16344;19283;613989;332911;27.7;15.0
FR;79;2021-03-03;17767;18562;631756;351473;28.5;15.9
FR;79;2021-03-04;20970;17703;652726;369176;29.4;16.6
FR;79;2021-03-05;22501;16513;675227;385689;30.5;17.4
FR;79;2021-03-06;29087;5436;704314;391125;31.8;17.6
FR;79;2021-03-07;21095;1084;725409;392209;32.7;17.7
FR;79;2021-03-08;17399;15357;742808;407566;33.5;18.4
FR;79;2021-03-09;25777;16473;768585;424039;34.7;19.1
FR;79;2021-03-10;26905;15648;795490;439687;35.9;19.8
FR;79;2021-03-11;31892;15160;827382;454847;37.3;20.5
FR;79;2021-03-12;33412;13000;860794;467847;38.8;21.1
FR;79;2021-03-13;25390;4276;886184;472123;40.0;21.3
FR;79;2021-03-14;9486;786;895670;472909;40.4;21.3
FR;79;2021-03-15;28489;8739;924159;481648;41.7;21.7
FR;79;2021-03-16;32812;9334;956971;490982;43.2;22.1
FR;79;2021-03-17;33804;9301;990775;500283;44.7;22.6
FR;79;2021-03-18;36701;9795;1027476;510078;46.3;23.0
FR;79;2021-03-19;36734;8910;1064210;518988;48.0;23.4
FR;79;2021-03-20;20678;3314;1084888;522302;48.9;23.6
FR;79;2021-03-21;5876;609;1090764;522911;49.2;23.6
FR;79;2021-03-22;28601;9222;1119365;532133;50.5;24.0
FR;79;2021-03-23;37052;10823;1156417;542956;52.2;24.5
FR;79;2021-03-24;35548;11380;1191965;554336;53.8;25.0
FR;79;2021-03-25;41910;11150;1233875;565486;55.6;25.5
FR;79;2021-03-26;39385;10472;1273260;575958;57.4;26.0
FR;79;2021-03-27;17649;4422;1290909;580380;58.2;26.2
FR;79;2021-03-28;4797;909;1295706;581289;58.4;26.2
FR;79;2021-03-29;22279;15017;1317985;596306;59.4;26.9
FR;79;2021-03-30;28020;18924;1346005;615230;60.7;27.7
FR;79;2021-03-31;24680;19756;1370685;634986;61.8;28.6
FR;79;2021-04-01;27172;23204;1397857;658190;63.0;29.7
FR;79;2021-04-02;23061;24456;1420918;682646;64.1;30.8
FR;79;2021-04-03;10009;17372;1430927;700018;64.5;31.6
FR;79;2021-04-04;2800;5064;1433727;705082;64.7;31.8
FR;79;2021-04-05;4186;2753;1437913;707835;64.8;31.9
FR;79;2021-04-06;18990;28970;1456903;736805;65.7;33.2
FR;79;2021-04-07;21047;29859;1477950;766664;66.7;34.6
FR;79;2021-04-08;24976;29924;1502926;796588;67.8;35.9
FR;79;2021-04-09;26815;28106;1529741;824694;69.0;37.2
FR;79;2021-04-10;13573;18930;1543314;843624;69.6;38.0
FR;79;2021-04-11;3487;6449;1546801;850073;69.8;38.3
FR;79;2021-04-12;16734;28899;1563535;878972;70.5;39.6
FR;79;2021-04-13;19097;35006;1582632;913978;71.4;41.2
FR;79;2021-04-14;18155;33145;1600787;947123;72.2;42.7
FR;79;2021-04-15;19086;33332;1619873;980455;73.1;44.2
FR;79;2021-04-16;16220;31040;1636093;1011495;73.8;45.6
FR;79;2021-04-17;8147;16696;1644240;1028191;74.2;46.4
FR;79;2021-04-18;1766;4834;1646006;1033025;74.2;46.6
FR;79;2021-04-19;9840;29165;1655846;1062190;74.7;47.9
FR;79;2021-04-20;11697;34435;1667543;1096625;75.2;49.5
FR;79;2021-04-21;11285;31204;1678828;1127829;75.7;50.9
FR;79;2021-04-22;12841;31088;1691669;1158917;76.3;52.3
FR;79;2021-04-23;11898;27679;1703567;1186596;76.8;53.5
FR;79;2021-04-24;6157;13716;1709724;1200312;77.1;54.1
FR;79;2021-04-25;1913;3424;1711637;1203736;77.2;54.3
FR;79;2021-04-26;8939;20598;1720576;1224334;77.6;55.2
FR;79;2021-04-27;11069;23663;1731645;1247997;78.1;56.3
FR;79;2021-04-28;11594;20901;1743239;1268898;78.6;57.2
FR;79;2021-04-29;13655;20667;1756894;1289565;79.2;58.2
FR;79;2021-04-30;12818;17605;1769712;1307170;79.8;59.0
FR;79;2021-05-01;3818;3914;1773530;1311084;80.0;59.1
FR;79;2021-05-02;1744;2615;1775274;1313699;80.1;59.2
FR;79;2021-05-03;8578;15096;1783852;1328795;80.5;59.9
FR;79;2021-05-04;8903;20132;1792755;1348927;80.9;60.8
FR;79;2021-05-05;8369;18962;1801124;1367889;81.2;61.7
FR;79;2021-05-06;10208;18765;1811332;1386654;81.7;62.5
FR;79;2021-05-07;8939;19431;1820271;1406085;82.1;63.4
FR;79;2021-05-08;2971;4284;1823242;1410369;82.2;63.6
FR;79;2021-05-09;1379;2987;1824621;1413356;82.3;63.7
FR;79;2021-05-10;6112;17459;1830733;1430815;82.6;64.5
FR;79;2021-05-11;7957;18534;1838690;1449349;82.9;65.4
FR;79;2021-05-12;7223;15768;1845913;1465117;83.3;66.1
FR;79;2021-05-13;3487;3780;1849400;1468897;83.4;66.2
FR;79;2021-05-14;6754;11365;1856154;1480262;83.7;66.8
FR;79;2021-05-15;3290;5089;1859444;1485351;83.9;67.0
FR;79;2021-05-16;1138;1151;1860582;1486502;83.9;67.0
FR;79;2021-05-17;4903;8978;1865485;1495480;84.1;67.4
FR;79;2021-05-18;6070;9125;1871555;1504605;84.4;67.9
FR;79;2021-05-19;5689;7945;1877244;1512550;84.7;68.2
FR;79;2021-05-20;6562;8082;1883806;1520632;85.0;68.6
FR;79;2021-05-21;5588;8722;1889394;1529354;85.2;69.0
FR;79;2021-05-22;2399;3798;1891793;1533152;85.3;69.1
FR;79;2021-05-23;727;787;1892520;1533939;85.4;69.2
FR;79;2021-05-24;1830;1599;1894350;1535538;85.4;69.3
FR;79;2021-05-25;4338;10177;1898688;1545715;85.6;69.7
FR;79;2021-05-26;4270;9494;1902958;1555209;85.8;70.1
FR;79;2021-05-27;5177;10936;1908135;1566145;86.1;70.6
FR;79;2021-05-28;4691;12358;1912826;1578503;86.3;71.2
FR;79;2021-05-29;2039;6655;1914865;1585158;86.4;71.5
FR;79;2021-05-30;434;1252;1915299;1586410;86.4;71.5
FR;79;2021-05-31;3173;9017;1918472;1595427;86.5;72.0
FR;79;2021-06-01;4392;11082;1922864;1606509;86.7;72.5
FR;79;2021-06-02;3817;9692;1926681;1616201;86.9;72.9
FR;79;2021-06-03;4732;11213;1931413;1627414;87.1;73.4
FR;79;2021-06-04;4249;12668;1935662;1640082;87.3;74.0
FR;79;2021-06-05;1911;6445;1937573;1646527;87.4;74.3
FR;79;2021-06-06;430;1437;1938003;1647964;87.4;74.3
FR;79;2021-06-07;2656;10018;1940659;1657982;87.5;74.8
FR;79;2021-06-08;5075;10593;1945734;1668575;87.8;75.3
FR;79;2021-06-09;5291;7971;1951025;1676546;88.0;75.6
FR;79;2021-06-10;6054;8827;1957079;1685373;88.3;76.0
FR;79;2021-06-11;3586;13160;1960665;1698533;88.4;76.6
FR;79;2021-06-12;1624;5598;1962289;1704131;88.5;76.9
FR;79;2021-06-13;306;1313;1962595;1705444;88.5;76.9
FR;80;2020-12-27;10;2;10;2;0.0;0.0
FR;80;2020-12-28;41;0;51;2;0.0;0.0
FR;80;2020-12-29;78;0;129;2;0.0;0.0
FR;80;2020-12-30;69;0;198;2;0.0;0.0
FR;80;2020-12-31;49;0;247;2;0.0;0.0
FR;80;2021-01-01;9;0;256;2;0.0;0.0
FR;80;2021-01-02;9;0;265;2;0.0;0.0
FR;80;2021-01-03;2;0;267;2;0.0;0.0
FR;80;2021-01-04;297;1;564;3;0.0;0.0
FR;80;2021-01-05;909;2;1473;5;0.0;0.0
FR;80;2021-01-06;1675;2;3148;7;0.1;0.0
FR;80;2021-01-07;6294;4;9442;11;0.2;0.0
FR;80;2021-01-08;5772;11;15214;22;0.4;0.0
FR;80;2021-01-09;979;0;16193;22;0.4;0.0
FR;80;2021-01-10;310;0;16503;22;0.4;0.0
FR;80;2021-01-11;4465;8;20968;30;0.5;0.0
FR;80;2021-01-12;12738;18;33706;48;0.8;0.0
FR;80;2021-01-13;12480;19;46186;67;1.1;0.0
FR;80;2021-01-14;18267;112;64453;179;1.6;0.0
FR;80;2021-01-15;12176;34;76629;213;1.8;0.0
FR;80;2021-01-16;4047;28;80676;241;1.9;0.0
FR;80;2021-01-17;3746;20;84422;261;2.0;0.0
FR;80;2021-01-18;28773;73;113195;334;2.7;0.0
FR;80;2021-01-19;53813;111;167008;445;4.0;0.0
FR;80;2021-01-20;59546;117;226554;562;5.4;0.0
FR;80;2021-01-21;70026;90;296580;652;7.1;0.0
FR;80;2021-01-22;48396;75;344976;727;8.3;0.0
FR;80;2021-01-23;16247;11;361223;738;8.7;0.0
FR;80;2021-01-24;4315;2;365538;740;8.8;0.0
FR;80;2021-01-25;32461;152;397999;892;9.6;0.0
FR;80;2021-01-26;45153;539;443152;1431;10.7;0.0
FR;80;2021-01-27;50907;897;494059;2328;11.9;0.1
FR;80;2021-01-28;60058;3950;554117;6278;13.3;0.2
FR;80;2021-01-29;39359;3283;593476;9561;14.3;0.2
FR;80;2021-01-30;13224;592;606700;10153;14.6;0.2
FR;80;2021-01-31;2333;288;609033;10441;14.6;0.3
FR;80;2021-02-01;23032;2790;632065;13231;15.2;0.3
FR;80;2021-02-02;33547;7434;665612;20665;16.0;0.5
FR;80;2021-02-03;34443;7879;700055;28544;16.8;0.7
FR;80;2021-02-04;38108;12590;738163;41134;17.8;1.0
FR;80;2021-02-05;29815;9539;767978;50673;18.5;1.2
FR;80;2021-02-06;9711;2126;777689;52799;18.7;1.3
FR;80;2021-02-07;1450;1867;779139;54666;18.7;1.3
FR;80;2021-02-08;19371;11145;798510;65811;19.2;1.6
FR;80;2021-02-09;25934;25612;824444;91423;19.8;2.2
FR;80;2021-02-10;26333;28930;850777;120353;20.5;2.9
FR;80;2021-02-11;30545;38130;881322;158483;21.2;3.8
FR;80;2021-02-12;26749;24682;908071;183165;21.8;4.4
FR;80;2021-02-13;7942;6529;916013;189694;22.0;4.6
FR;80;2021-02-14;1508;3101;917521;192795;22.1;4.6
FR;80;2021-02-15;11141;28314;928662;221109;22.3;5.3
FR;80;2021-02-16;15563;38940;944225;260049;22.7;6.3
FR;80;2021-02-17;15938;44494;960163;304543;23.1;7.3
FR;80;2021-02-18;21561;52523;981724;357066;23.6;8.6
FR;80;2021-02-19;19066;37504;1000790;394570;24.1;9.5
FR;80;2021-02-20;6314;12326;1007104;406896;24.2;9.8
FR;80;2021-02-21;913;2970;1008017;409866;24.2;9.9
FR;80;2021-02-22;11186;30700;1019203;440566;24.5;10.6
FR;80;2021-02-23;17117;37274;1036320;477840;24.9;11.5
FR;80;2021-02-24;18006;37091;1054326;514931;25.4;12.4
FR;80;2021-02-25;22322;40877;1076648;555808;25.9;13.4
FR;80;2021-02-26;20550;30925;1097198;586733;26.4;14.1
FR;80;2021-02-27;7185;10286;1104383;597019;26.6;14.4
FR;80;2021-02-28;1261;2121;1105644;599140;26.6;14.4
FR;80;2021-03-01;18797;23217;1124441;622357;27.0;15.0
FR;80;2021-03-02;26915;29121;1151356;651478;27.7;15.7
FR;80;2021-03-03;28742;29257;1180098;680735;28.4;16.4
FR;80;2021-03-04;34980;29722;1215078;710457;29.2;17.1
FR;80;2021-03-05;35908;27506;1250986;737963;30.1;17.7
FR;80;2021-03-06;41403;8380;1292389;746343;31.1;18.0
FR;80;2021-03-07;29717;2060;1322106;748403;31.8;18.0
FR;80;2021-03-08;27196;22511;1349302;770914;32.5;18.5
FR;80;2021-03-09;40756;24688;1390058;795602;33.4;19.1
FR;80;2021-03-10;43140;25403;1433198;821005;34.5;19.7
FR;80;2021-03-11;51683;26909;1484881;847914;35.7;20.4
FR;80;2021-03-12;52152;22998;1537033;870912;37.0;20.9
FR;80;2021-03-13;37530;7037;1574563;877949;37.9;21.1
FR;80;2021-03-14;13905;1531;1588468;879480;38.2;21.2
FR;80;2021-03-15;44066;13958;1632534;893438;39.3;21.5
FR;80;2021-03-16;51805;17059;1684339;910497;40.5;21.9
FR;80;2021-03-17;54655;16574;1738994;927071;41.8;22.3
FR;80;2021-03-18;58515;18858;1797509;945929;43.2;22.8
FR;80;2021-03-19;57383;15759;1854892;961688;44.6;23.1
FR;80;2021-03-20;31009;5355;1885901;967043;45.4;23.3
FR;80;2021-03-21;8686;1098;1894587;968141;45.6;23.3
FR;80;2021-03-22;42875;14567;1937462;982708;46.6;23.6
FR;80;2021-03-23;55602;18054;1993064;1000762;47.9;24.1
FR;80;2021-03-24;54443;19085;2047507;1019847;49.2;24.5
FR;80;2021-03-25;63995;19615;2111502;1039462;50.8;25.0
FR;80;2021-03-26;60164;18281;2171666;1057743;52.2;25.4
FR;80;2021-03-27;26579;7361;2198245;1065104;52.9;25.6
FR;80;2021-03-28;6925;1453;2205170;1066557;53.0;25.7
FR;80;2021-03-29;32851;23402;2238021;1089959;53.8;26.2
FR;80;2021-03-30;43207;30750;2281228;1120709;54.9;27.0
FR;80;2021-03-31;40494;32101;2321722;1152810;55.8;27.7
FR;80;2021-04-01;46103;37742;2367825;1190552;56.9;28.6
FR;80;2021-04-02;37084;39730;2404909;1230282;57.8;29.6
FR;80;2021-04-03;14496;26094;2419405;1256376;58.2;30.2
FR;80;2021-04-04;3869;7570;2423274;1263946;58.3;30.4
FR;80;2021-04-05;5616;4083;2428890;1268029;58.4;30.5
FR;80;2021-04-06;27635;44948;2456525;1312977;59.1;31.6
FR;80;2021-04-07;33458;48385;2489983;1361362;59.9;32.7
FR;80;2021-04-08;40038;49524;2530021;1410886;60.8;33.9
FR;80;2021-04-09;43466;46330;2573487;1457216;61.9;35.0
FR;80;2021-04-10;19772;28880;2593259;1486096;62.4;35.7
FR;80;2021-04-11;4812;9362;2598071;1495458;62.5;36.0
FR;80;2021-04-12;23488;45146;2621559;1540604;63.1;37.1
FR;80;2021-04-13;30166;54615;2651725;1595219;63.8;38.4
FR;80;2021-04-14;28992;52141;2680717;1647360;64.5;39.6
FR;80;2021-04-15;31370;52640;2712087;1700000;65.2;40.9
FR;80;2021-04-16;26404;48967;2738491;1748967;65.9;42.1
FR;80;2021-04-17;12342;25597;2750833;1774564;66.2;42.7
FR;80;2021-04-18;2530;7619;2753363;1782183;66.2;42.9
FR;80;2021-04-19;14246;43661;2767609;1825844;66.6;43.9
FR;80;2021-04-20;17914;53031;2785523;1878875;67.0;45.2
FR;80;2021-04-21;17937;49767;2803460;1928642;67.4;46.4
FR;80;2021-04-22;20658;51192;2824118;1979834;67.9;47.6
FR;80;2021-04-23;19058;44586;2843176;2024420;68.4;48.7
FR;80;2021-04-24;9406;21196;2852582;2045616;68.6;49.2
FR;80;2021-04-25;2684;5150;2855266;2050766;68.7;49.3
FR;80;2021-04-26;12369;30572;2867635;2081338;69.0;50.1
FR;80;2021-04-27;16758;36401;2884393;2117739;69.4;50.9
FR;80;2021-04-28;17978;34575;2902371;2152314;69.8;51.8
FR;80;2021-04-29;21752;35632;2924123;2187946;70.3;52.6
FR;80;2021-04-30;20381;29559;2944504;2217505;70.8;53.3
FR;80;2021-05-01;5810;5818;2950314;2223323;71.0;53.5
FR;80;2021-05-02;2605;3857;2952919;2227180;71.0;53.6
FR;80;2021-05-03;12460;21369;2965379;2248549;71.3;54.1
FR;80;2021-05-04;13843;29943;2979222;2278492;71.7;54.8
FR;80;2021-05-05;13536;29288;2992758;2307780;72.0;55.5
FR;80;2021-05-06;15883;29498;3008641;2337278;72.4;56.2
FR;80;2021-05-07;14569;29748;3023210;2367026;72.7;56.9
FR;80;2021-05-08;4517;6038;3027727;2373064;72.8;57.1
FR;80;2021-05-09;1914;4143;3029641;2377207;72.9;57.2
FR;80;2021-05-10;9177;24342;3038818;2401549;73.1;57.8
FR;80;2021-05-11;12571;27175;3051389;2428724;73.4;58.4
FR;80;2021-05-12;11493;23562;3062882;2452286;73.7;59.0
FR;80;2021-05-13;4884;5398;3067766;2457684;73.8;59.1
FR;80;2021-05-14;10407;16360;3078173;2474044;74.0;59.5
FR;80;2021-05-15;4832;7332;3083005;2481376;74.1;59.7
FR;80;2021-05-16;1536;1526;3084541;2482902;74.2;59.7
FR;80;2021-05-17;7055;13098;3091596;2496000;74.4;60.0
FR;80;2021-05-18;9532;13476;3101128;2509476;74.6;60.4
FR;80;2021-05-19;8928;12071;3110056;2521547;74.8;60.6
FR;80;2021-05-20;10672;12662;3120728;2534209;75.1;60.9
FR;80;2021-05-21;8819;13052;3129547;2547261;75.3;61.3
FR;80;2021-05-22;3842;5191;3133389;2552452;75.4;61.4
FR;80;2021-05-23;1008;1132;3134397;2553584;75.4;61.4
FR;80;2021-05-24;2574;2223;3136971;2555807;75.4;61.5
FR;80;2021-05-25;6575;14201;3143546;2570008;75.6;61.8
FR;80;2021-05-26;6741;14199;3150287;2584207;75.8;62.2
FR;80;2021-05-27;8610;16783;3158897;2600990;76.0;62.6
FR;80;2021-05-28;8233;18043;3167130;2619033;76.2;63.0
FR;80;2021-05-29;3429;8808;3170559;2627841;76.3;63.2
FR;80;2021-05-30;638;1595;3171197;2629436;76.3;63.2
FR;80;2021-05-31;4955;12679;3176152;2642115;76.4;63.5
FR;80;2021-06-01;7232;16594;3183384;2658709;76.6;63.9
FR;80;2021-06-02;6311;14835;3189695;2673544;76.7;64.3
FR;80;2021-06-03;8313;16893;3198008;2690437;76.9;64.7
FR;80;2021-06-04;7483;18874;3205491;2709311;77.1;65.2
FR;80;2021-06-05;3323;9201;3208814;2718512;77.2;65.4
FR;80;2021-06-06;630;2037;3209444;2720549;77.2;65.4
FR;80;2021-06-07;4220;14068;3213664;2734617;77.3;65.8
FR;80;2021-06-08;8450;15447;3222114;2750064;77.5;66.1
FR;80;2021-06-09;8854;11989;3230968;2762053;77.7;66.4
FR;80;2021-06-10;10427;13319;3241395;2775372;78.0;66.7
FR;80;2021-06-11;6186;19673;3247581;2795045;78.1;67.2
FR;80;2021-06-12;2637;8220;3250218;2803265;78.2;67.4
FR;80;2021-06-13;462;2016;3250680;2805281;78.2;67.5
FR;0;2020-12-27;20;2;20;2;0.0;0.0
FR;0;2020-12-28;70;0;90;2;0.0;0.0
FR;0;2020-12-29;108;0;198;2;0.0;0.0
FR;0;2020-12-30;122;0;320;2;0.0;0.0
FR;0;2020-12-31;85;0;405;2;0.0;0.0
FR;0;2021-01-01;73;1;478;3;0.0;0.0
FR;0;2021-01-02;88;2;566;5;0.0;0.0
FR;0;2021-01-03;92;0;658;5;0.0;0.0
FR;0;2021-01-04;1479;7;2137;12;0.0;0.0
FR;0;2021-01-05;5400;20;7537;32;0.0;0.0
FR;0;2021-01-06;11316;31;18853;63;0.0;0.0
FR;0;2021-01-07;28572;66;47425;129;0.1;0.0
FR;0;2021-01-08;36276;81;83701;210;0.1;0.0
FR;0;2021-01-09;10928;15;94629;225;0.1;0.0
FR;0;2021-01-10;5625;9;100254;234;0.1;0.0
FR;0;2021-01-11;39075;100;139329;334;0.2;0.0
FR;0;2021-01-12;60951;160;200280;494;0.3;0.0
FR;0;2021-01-13;63886;191;264166;685;0.4;0.0
FR;0;2021-01-14;79939;730;344105;1415;0.5;0.0
FR;0;2021-01-15;67556;299;411661;1714;0.6;0.0
FR;0;2021-01-16;19741;125;431402;1839;0.6;0.0
FR;0;2021-01-17;10472;65;441874;1904;0.7;0.0
FR;0;2021-01-18;84436;342;526310;2246;0.8;0.0
FR;0;2021-01-19;128528;375;654838;2621;1.0;0.0
FR;0;2021-01-20;135318;368;790156;2989;1.2;0.0
FR;0;2021-01-21;155515;365;945671;3354;1.4;0.0
FR;0;2021-01-22;118719;385;1064390;3739;1.6;0.0
FR;0;2021-01-23;37848;82;1102238;3821;1.6;0.0
FR;0;2021-01-24;9370;41;1111608;3862;1.7;0.0
FR;0;2021-01-25;76882;1340;1188490;5202;1.8;0.0
FR;0;2021-01-26;98891;3266;1287381;8468;1.9;0.0
FR;0;2021-01-27;105694;5773;1393075;14241;2.1;0.0
FR;0;2021-01-28;122410;14631;1515485;28872;2.3;0.0
FR;0;2021-01-29;90923;17499;1606408;46371;2.4;0.1
FR;0;2021-01-30;28653;4272;1635061;50643;2.4;0.1
FR;0;2021-01-31;4871;1688;1639932;52331;2.4;0.1
FR;0;2021-02-01;51612;21221;1691544;73552;2.5;0.1
FR;0;2021-02-02;70735;34745;1762279;108297;2.6;0.2
FR;0;2021-02-03;71014;37161;1833293;145458;2.7;0.2
FR;0;2021-02-04;80663;50304;1913956;195762;2.9;0.3
FR;0;2021-02-05;67171;45544;1981127;241306;3.0;0.4
FR;0;2021-02-06;21345;10446;2002472;251752;3.0;0.4
FR;0;2021-02-07;4826;5086;2007298;256838;3.0;0.4
FR;0;2021-02-08;45905;46235;2053203;303073;3.1;0.5
FR;0;2021-02-09;64881;72937;2118084;376010;3.2;0.6
FR;0;2021-02-10;69314;77352;2187398;453362;3.3;0.7
FR;0;2021-02-11;85690;100137;2273088;553499;3.4;0.8
FR;0;2021-02-12;77804;75170;2350892;628669;3.5;0.9
FR;0;2021-02-13;21711;19641;2372603;648310;3.5;1.0
FR;0;2021-02-14;4593;7236;2377196;655546;3.5;1.0
FR;0;2021-02-15;37070;77049;2414266;732595;3.6;1.1
FR;0;2021-02-16;49227;101435;2463493;834030;3.7;1.2
FR;0;2021-02-17;49305;103683;2512798;937713;3.7;1.4
FR;0;2021-02-18;68027;119676;2580825;1057389;3.8;1.6
FR;0;2021-02-19;63850;91752;2644675;1149141;3.9;1.7
FR;0;2021-02-20;18007;28613;2662682;1177754;4.0;1.8
FR;0;2021-02-21;2860;6413;2665542;1184167;4.0;1.8
FR;0;2021-02-22;36541;73717;2702083;1257884;4.0;1.9
FR;0;2021-02-23;52683;84823;2754766;1342707;4.1;2.0
FR;0;2021-02-24;58133;81885;2812899;1424592;4.2;2.1
FR;0;2021-02-25;98735;93016;2911634;1517608;4.3;2.3
FR;0;2021-02-26;111780;72591;3023414;1590199;4.5;2.4
FR;0;2021-02-27;51223;22542;3074637;1612741;4.6;2.4
FR;0;2021-02-28;5679;4499;3080316;1617240;4.6;2.4
FR;0;2021-03-01;63665;53631;3143981;1670871;4.7;2.5
FR;0;2021-03-02;99416;67640;3243397;1738511;4.8;2.6
FR;0;2021-03-03;113779;67199;3357176;1805710;5.0;2.7
FR;0;2021-03-04;160612;71475;3517788;1877185;5.2;2.8
FR;0;2021-03-05;198111;66567;3715899;1943752;5.5;2.9
FR;0;2021-03-06;205103;20039;3921002;1963791;5.8;2.9
FR;0;2021-03-07;119817;6780;4040819;1970571;6.0;2.9
FR;0;2021-03-08;104959;52303;4145778;2022874;6.2;3.0
FR;0;2021-03-09;169840;59177;4315618;2082051;6.4;3.1
FR;0;2021-03-10;175852;59639;4491470;2141690;6.7;3.2
FR;0;2021-03-11;239705;66730;4731175;2208420;7.0;3.3
FR;0;2021-03-12;291215;57709;5022390;2266129;7.5;3.4
FR;0;2021-03-13;228689;17787;5251079;2283916;7.8;3.4
FR;0;2021-03-14;62269;4255;5313348;2288171;7.9;3.4
FR;0;2021-03-15;155917;35060;5469265;2323231;8.1;3.5
FR;0;2021-03-16;139288;41682;5608553;2364913;8.4;3.5
FR;0;2021-03-17;148062;41281;5756615;2406194;8.6;3.6
FR;0;2021-03-18;165150;47975;5921765;2454169;8.8;3.7
FR;0;2021-03-19;226886;41782;6148651;2495951;9.2;3.7
FR;0;2021-03-20;164719;14332;6313370;2510283;9.4;3.7
FR;0;2021-03-21;48759;3589;6362129;2513872;9.5;3.7
FR;0;2021-03-22;167266;37629;6529395;2551501;9.7;3.8
FR;0;2021-03-23;246895;47125;6776290;2598626;10.1;3.9
FR;0;2021-03-24;253503;48729;7029793;2647355;10.5;3.9
FR;0;2021-03-25;337830;51438;7367623;2698793;11.0;4.0
FR;0;2021-03-26;355033;49168;7722656;2747961;11.5;4.1
FR;0;2021-03-27;193145;20558;7915801;2768519;11.8;4.1
FR;0;2021-03-28;58349;4948;7974150;2773467;11.9;4.1
FR;0;2021-03-29;200544;58588;8174694;2832055;12.2;4.2
FR;0;2021-03-30;282091;76275;8456785;2908330;12.6;4.3
FR;0;2021-03-31;259676;79536;8716461;2987866;13.0;4.5
FR;0;2021-04-01;310240;96665;9026701;3084531;13.4;4.6
FR;0;2021-04-02;277881;99719;9304582;3184250;13.9;4.7
FR;0;2021-04-03;139180;65364;9443762;3249614;14.1;4.8
FR;0;2021-04-04;44881;20023;9488643;3269637;14.1;4.9
FR;0;2021-04-05;58776;12848;9547419;3282485;14.2;4.9
FR;0;2021-04-06;213520;113766;9760939;3396251;14.5;5.1
FR;0;2021-04-07;256376;123224;10017315;3519475;14.9;5.2
FR;0;2021-04-08;332886;132342;10350201;3651817;15.4;5.4
FR;0;2021-04-09;405049;128229;10755250;3780046;16.0;5.6
FR;0;2021-04-10;210070;88586;10965320;3868632;16.3;5.8
FR;0;2021-04-11;54890;36441;11020210;3905073;16.4;5.8
FR;0;2021-04-12;233876;121990;11254086;4027063;16.8;6.0
FR;0;2021-04-13;305213;154117;11559299;4181180;17.2;6.2
FR;0;2021-04-14;289594;148980;11848893;4330160;17.7;6.5
FR;0;2021-04-15;331740;159055;12180633;4489215;18.1;6.7
FR;0;2021-04-16;335103;156283;12515736;4645498;18.6;6.9
FR;0;2021-04-17;186298;95921;12702034;4741419;18.9;7.1
FR;0;2021-04-18;50435;37305;12752469;4778724;19.0;7.1
FR;0;2021-04-19;202797;145385;12955266;4924109;19.3;7.3
FR;0;2021-04-20;250877;179688;13206143;5103797;19.7;7.6
FR;0;2021-04-21;249291;178001;13455434;5281798;20.0;7.9
FR;0;2021-04-22;283342;199271;13738776;5481069;20.5;8.2
FR;0;2021-04-23;290690;195428;14029466;5676497;20.9;8.5
FR;0;2021-04-24;188137;120043;14217603;5796540;21.2;8.6
FR;0;2021-04-25;68395;41906;14285998;5838446;21.3;8.7
FR;0;2021-04-26;217938;167253;14503936;6005699;21.6;8.9
FR;0;2021-04-27;281006;207896;14784942;6213595;22.0;9.3
FR;0;2021-04-28;295872;205122;15080814;6418717;22.5;9.6
FR;0;2021-04-29;352972;227299;15433786;6646016;23.0;9.9
FR;0;2021-04-30;367996;220461;15801782;6866477;23.5;10.2
FR;0;2021-05-01;163980;62043;15965762;6928520;23.8;10.3
FR;0;2021-05-02;90148;42662;16055910;6971182;23.9;10.4
FR;0;2021-05-03;283318;187660;16339228;7158842;24.3;10.7
FR;0;2021-05-04;309781;247483;16649009;7406325;24.8;11.0
FR;0;2021-05-05;319190;246775;16968199;7653100;25.3;11.4
FR;0;2021-05-06;372455;269814;17340654;7922914;25.8;11.8
FR;0;2021-05-07;366596;295355;17707250;8218269;26.4;12.2
FR;0;2021-05-08;210351;79693;17917601;8297962;26.7;12.4
FR;0;2021-05-09;127596;54370;18045197;8352332;26.9;12.4
FR;0;2021-05-10;304210;252132;18349407;8604464;27.3;12.8
FR;0;2021-05-11;396556;293444;18745963;8897908;27.9;13.3
FR;0;2021-05-12;422775;265959;19168738;9163867;28.6;13.7
FR;0;2021-05-13;331478;76281;19500216;9240148;29.1;13.8
FR;0;2021-05-14;445903;200072;19946119;9440220;29.7;14.1
FR;0;2021-05-15;367412;118034;20313531;9558254;30.3;14.2
FR;0;2021-05-16;199385;33076;20512916;9591330;30.6;14.3
FR;0;2021-05-17;368774;176414;20881690;9767744;31.1;14.6
FR;0;2021-05-18;447341;188800;21329031;9956544;31.8;14.8
FR;0;2021-05-19;457952;179272;21786983;10135816;32.5;15.1
FR;0;2021-05-20;496395;200779;22283378;10336595;33.2;15.4
FR;0;2021-05-21;479857;217869;22763235;10554464;33.9;15.7
FR;0;2021-05-22;341768;106387;23105003;10660851;34.4;15.9
FR;0;2021-05-23;158902;25904;23263905;10686755;34.7;15.9
FR;0;2021-05-24;257241;51722;23521146;10738477;35.0;16.0
FR;0;2021-05-25;391211;223339;23912357;10961816;35.6;16.3
FR;0;2021-05-26;400775;223158;24313132;11184974;36.2;16.7
FR;0;2021-05-27;440718;263091;24753850;11448065;36.9;17.1
FR;0;2021-05-28;421017;314993;25174867;11763058;37.5;17.5
FR;0;2021-05-29;294480;180597;25469347;11943655;37.9;17.8
FR;0;2021-05-30;104745;41529;25574092;11985184;38.1;17.9
FR;0;2021-05-31;351516;239697;25925608;12224881;38.6;18.2
FR;0;2021-06-01;412504;300167;26338112;12525048;39.2;18.7
FR;0;2021-06-02;400080;274888;26738192;12799936;39.8;19.1
FR;0;2021-06-03;450076;310403;27188268;13110339;40.5;19.5
FR;0;2021-06-04;440660;359142;27628928;13469481;41.2;20.1
FR;0;2021-06-05;297312;220410;27926240;13689891;41.6;20.4
FR;0;2021-06-06;128898;60370;28055138;13750261;41.8;20.5
FR;0;2021-06-07;326711;297131;28381849;14047392;42.3;20.9
FR;0;2021-06-08;405312;315304;28787161;14362696;42.9;21.4
FR;0;2021-06-09;411118;276577;29198279;14639273;43.5;21.8
FR;0;2021-06-10;429170;287998;29627449;14927271;44.1;22.2
FR;0;2021-06-11;371990;404430;29999439;15331701;44.7;22.8
FR;0;2021-06-12;274103;240896;30273542;15572597;45.1;23.2
FR;0;2021-06-13;100931;84031;30374473;15656628;45.3;23.3
