dep;jour;n_dose1;n_complet;n_cum_dose1;n_cum_complet;couv_dose1;couv_complet
01;2020-12-27;1;0;1;0;0.0;0.0
01;2020-12-28;0;0;1;0;0.0;0.0
01;2020-12-29;0;0;1;0;0.0;0.0
01;2020-12-30;0;0;1;0;0.0;0.0
01;2020-12-31;0;0;1;0;0.0;0.0
01;2021-01-01;1;0;2;0;0.0;0.0
01;2021-01-02;0;0;2;0;0.0;0.0
01;2021-01-03;0;0;2;0;0.0;0.0
01;2021-01-04;0;0;2;0;0.0;0.0
01;2021-01-05;2;0;4;0;0.0;0.0
01;2021-01-06;1;0;5;0;0.0;0.0
01;2021-01-07;67;0;72;0;0.0;0.0
01;2021-01-08;159;0;231;0;0.0;0.0
01;2021-01-09;2;1;233;1;0.0;0.0
01;2021-01-10;0;0;233;1;0.0;0.0
01;2021-01-11;147;0;380;1;0.1;0.0
01;2021-01-12;317;2;697;3;0.1;0.0
01;2021-01-13;444;1;1141;4;0.2;0.0
01;2021-01-14;528;3;1669;7;0.3;0.0
01;2021-01-15;396;3;2065;10;0.3;0.0
01;2021-01-16;202;0;2267;10;0.3;0.0
01;2021-01-17;128;0;2395;10;0.4;0.0
01;2021-01-18;378;1;2773;11;0.4;0.0
01;2021-01-19;1039;1;3812;12;0.6;0.0
01;2021-01-20;1261;2;5073;14;0.8;0.0
01;2021-01-21;1096;4;6169;18;0.9;0.0
01;2021-01-22;645;0;6814;18;1.0;0.0
01;2021-01-23;222;0;7036;18;1.1;0.0
01;2021-01-24;71;1;7107;19;1.1;0.0
01;2021-01-25;483;1;7590;20;1.2;0.0
01;2021-01-26;740;3;8330;23;1.3;0.0
01;2021-01-27;517;5;8847;28;1.3;0.0
01;2021-01-28;681;54;9528;82;1.5;0.0
01;2021-01-29;636;101;10164;183;1.5;0.0
01;2021-01-30;235;15;10399;198;1.6;0.0
01;2021-01-31;61;0;10460;198;1.6;0.0
01;2021-02-01;449;75;10909;273;1.7;0.0
01;2021-02-02;513;184;11422;457;1.7;0.1
01;2021-02-03;373;298;11795;755;1.8;0.1
01;2021-02-04;479;418;12274;1173;1.9;0.2
01;2021-02-05;437;281;12711;1454;1.9;0.2
01;2021-02-06;260;140;12971;1594;2.0;0.2
01;2021-02-07;2;113;12973;1707;2.0;0.3
01;2021-02-08;505;406;13478;2113;2.1;0.3
01;2021-02-09;771;859;14249;2972;2.2;0.5
01;2021-02-10;948;717;15197;3689;2.3;0.6
01;2021-02-11;789;779;15986;4468;2.4;0.7
01;2021-02-12;639;553;16625;5021;2.5;0.8
01;2021-02-13;159;149;16784;5170;2.6;0.8
01;2021-02-14;0;9;16784;5179;2.6;0.8
01;2021-02-15;436;445;17220;5624;2.6;0.9
01;2021-02-16;656;414;17876;6038;2.7;0.9
01;2021-02-17;518;244;18394;6282;2.8;1.0
01;2021-02-18;589;565;18983;6847;2.9;1.0
01;2021-02-19;577;245;19560;7092;3.0;1.1
01;2021-02-20;200;154;19760;7246;3.0;1.1
01;2021-02-21;0;1;19760;7247;3.0;1.1
01;2021-02-22;427;553;20187;7800;3.1;1.2
01;2021-02-23;482;522;20669;8322;3.1;1.3
01;2021-02-24;434;465;21103;8787;3.2;1.3
01;2021-02-25;819;604;21922;9391;3.3;1.4
01;2021-02-26;870;542;22792;9933;3.5;1.5
01;2021-02-27;480;116;23272;10049;3.5;1.5
01;2021-02-28;20;3;23292;10052;3.5;1.5
01;2021-03-01;629;453;23921;10505;3.6;1.6
01;2021-03-02;961;556;24882;11061;3.8;1.7
01;2021-03-03;936;664;25818;11725;3.9;1.8
01;2021-03-04;1194;634;27012;12359;4.1;1.9
01;2021-03-05;1354;491;28366;12850;4.3;2.0
01;2021-03-06;780;96;29146;12946;4.4;2.0
01;2021-03-07;43;1;29189;12947;4.4;2.0
01;2021-03-08;667;621;29856;13568;4.5;2.1
01;2021-03-09;1332;605;31188;14173;4.7;2.2
01;2021-03-10;1160;533;32348;14706;4.9;2.2
01;2021-03-11;1678;640;34026;15346;5.2;2.3
01;2021-03-12;2002;627;36028;15973;5.5;2.4
01;2021-03-13;1499;88;37527;16061;5.7;2.4
01;2021-03-14;132;57;37659;16118;5.7;2.5
01;2021-03-15;1157;398;38816;16516;5.9;2.5
01;2021-03-16;1008;558;39824;17074;6.1;2.6
01;2021-03-17;836;341;40660;17415;6.2;2.7
01;2021-03-18;1287;460;41947;17875;6.4;2.7
01;2021-03-19;1746;529;43693;18404;6.7;2.8
01;2021-03-20;1446;126;45139;18530;6.9;2.8
01;2021-03-21;97;10;45236;18540;6.9;2.8
01;2021-03-22;1574;488;46810;19028;7.1;2.9
01;2021-03-23;2196;645;49006;19673;7.5;3.0
01;2021-03-24;1613;402;50619;20075;7.7;3.1
01;2021-03-25;2907;607;53526;20682;8.1;3.1
01;2021-03-26;2867;606;56393;21288;8.6;3.2
01;2021-03-27;1307;150;57700;21438;8.8;3.3
01;2021-03-28;21;1;57721;21439;8.8;3.3
01;2021-03-29;1928;544;59649;21983;9.1;3.3
01;2021-03-30;2512;750;62161;22733;9.5;3.5
01;2021-03-31;1867;621;64028;23354;9.7;3.6
01;2021-04-01;2564;842;66592;24196;10.1;3.7
01;2021-04-02;2817;701;69409;24897;10.6;3.8
01;2021-04-03;1256;127;70665;25024;10.8;3.8
01;2021-04-04;2;0;70667;25024;10.8;3.8
01;2021-04-05;1260;56;71927;25080;10.9;3.8
01;2021-04-06;2815;784;74742;25864;11.4;3.9
01;2021-04-07;2737;701;77479;26565;11.8;4.0
01;2021-04-08;3240;988;80719;27553;12.3;4.2
01;2021-04-09;3982;1323;84701;28876;12.9;4.4
01;2021-04-10;1823;296;86524;29172;13.2;4.4
01;2021-04-11;44;22;86568;29194;13.2;4.4
01;2021-04-12;2712;1219;89280;30413;13.6;4.6
01;2021-04-13;2931;1308;92211;31721;14.0;4.8
01;2021-04-14;3116;1075;95327;32796;14.5;5.0
01;2021-04-15;3073;1470;98400;34266;15.0;5.2
01;2021-04-16;2860;1566;101260;35832;15.4;5.5
01;2021-04-17;1653;679;102913;36511;15.7;5.6
01;2021-04-18;13;0;102926;36511;15.7;5.6
01;2021-04-19;2038;1522;104964;38033;16.0;5.8
01;2021-04-20;2660;1567;107624;39600;16.4;6.0
01;2021-04-21;2685;1342;110309;40942;16.8;6.2
01;2021-04-22;2833;1522;113142;42464;17.2;6.5
01;2021-04-23;2761;1522;115903;43986;17.6;6.7
01;2021-04-24;1446;648;117349;44634;17.9;6.8
01;2021-04-25;9;0;117358;44634;17.9;6.8
01;2021-04-26;1971;1721;119329;46355;18.2;7.1
01;2021-04-27;2573;1546;121902;47901;18.6;7.3
01;2021-04-28;2498;1568;124400;49469;18.9;7.5
01;2021-04-29;2717;1768;127117;51237;19.3;7.8
01;2021-04-30;2982;2241;130099;53478;19.8;8.1
01;2021-05-01;1471;858;131570;54336;20.0;8.3
01;2021-05-02;546;73;132116;54409;20.1;8.3
01;2021-05-03;2293;2476;134409;56885;20.5;8.7
01;2021-05-04;2544;2653;136953;59538;20.8;9.1
01;2021-05-05;2530;2495;139483;62033;21.2;9.4
01;2021-05-06;2994;2517;142477;64550;21.7;9.8
01;2021-05-07;3219;2780;145696;67330;22.2;10.2
01;2021-05-08;1646;922;147342;68252;22.4;10.4
01;2021-05-09;1023;158;148365;68410;22.6;10.4
01;2021-05-10;2500;3068;150865;71478;23.0;10.9
01;2021-05-11;3580;3056;154445;74534;23.5;11.3
01;2021-05-12;3650;2996;158095;77530;24.1;11.8
01;2021-05-13;4086;1494;162181;79024;24.7;12.0
01;2021-05-14;4271;2342;166452;81366;25.3;12.4
01;2021-05-15;3157;1432;169609;82798;25.8;12.6
01;2021-05-16;1410;150;171019;82948;26.0;12.6
01;2021-05-17;3434;2465;174453;85413;26.6;13.0
01;2021-05-18;4071;1959;178524;87372;27.2;13.3
01;2021-05-19;3972;1900;182496;89272;27.8;13.6
01;2021-05-20;4528;2013;187024;91285;28.5;13.9
01;2021-05-21;4613;2194;191637;93479;29.2;14.2
01;2021-05-22;3367;950;195004;94429;29.7;14.4
01;2021-05-23;831;81;195835;94510;29.8;14.4
01;2021-05-24;2765;499;198600;95009;30.2;14.5
01;2021-05-25;3555;2423;202155;97432;30.8;14.8
01;2021-05-26;3567;2245;205722;99677;31.3;15.2
01;2021-05-27;3848;2098;209570;101775;31.9;15.5
01;2021-05-28;3664;2638;213234;104413;32.5;15.9
01;2021-05-29;3059;1303;216293;105716;32.9;16.1
01;2021-05-30;613;88;216906;105804;33.0;16.1
01;2021-05-31;2403;2516;219309;108320;33.4;16.5
01;2021-06-01;2766;2577;222075;110897;33.8;16.9
01;2021-06-02;2879;2178;224954;113075;34.2;17.2
01;2021-06-03;3362;2427;228316;115502;34.8;17.6
01;2021-06-04;4501;3350;232817;118852;35.4;18.1
01;2021-06-05;3250;1719;236067;120571;35.9;18.4
01;2021-06-06;669;78;236736;120649;36.0;18.4
01;2021-06-07;3386;2871;240122;123520;36.6;18.8
01;2021-06-08;3647;2706;243769;126226;37.1;19.2
01;2021-06-09;2945;2629;246714;128855;37.6;19.6
01;2021-06-10;2759;2040;249473;130895;38.0;19.9
01;2021-06-11;3066;3365;252539;134260;38.4;20.4
01;2021-06-12;2403;2197;254942;136457;38.8;20.8
01;2021-06-13;200;478;255142;136935;38.8;20.8
01;2021-06-14;2122;3163;257264;140098;39.2;21.3
01;2021-06-15;2004;3359;259268;143457;39.5;21.8
01;2021-06-16;2179;3285;261447;146742;39.8;22.3
01;2021-06-17;1958;3168;263405;149910;40.1;22.8
01;2021-06-18;2595;4157;266000;154067;40.5;23.5
01;2021-06-19;1725;2553;267725;156620;40.8;23.8
01;2021-06-20;159;497;267884;157117;40.8;23.9
01;2021-06-21;1800;3705;269684;160822;41.1;24.5
01;2021-06-22;1547;3996;271231;164818;41.3;25.1
01;2021-06-23;1584;3755;272815;168573;41.5;25.7
01;2021-06-24;1471;3564;274286;172137;41.8;26.2
01;2021-06-25;1884;4567;276170;176704;42.0;26.9
01;2021-06-26;1209;2945;277379;179649;42.2;27.3
01;2021-06-27;170;339;277549;179988;42.2;27.4
01;2021-06-28;1381;4022;278930;184010;42.5;28.0
01;2021-06-29;1404;3850;280334;187860;42.7;28.6
01;2021-06-30;1374;4153;281708;192013;42.9;29.2
01;2021-07-01;1390;4087;283098;196100;43.1;29.8
01;2021-07-02;1583;4989;284681;201089;43.3;30.6
01;2021-07-03;858;3374;285539;204463;43.5;31.1
01;2021-07-04;104;498;285643;204961;43.5;31.2
01;2021-07-05;1477;4083;287120;209044;43.7;31.8
01;2021-07-06;1102;4280;288222;213324;43.9;32.5
01;2021-07-07;1645;3703;289867;217027;44.1;33.0
01;2021-07-08;1463;3675;291330;220702;44.3;33.6
01;2021-07-09;1881;4365;293211;225067;44.6;34.3
01;2021-07-10;1114;3443;294325;228510;44.8;34.8
01;2021-07-11;104;418;294429;228928;44.8;34.8
01;2021-07-12;1410;3847;295839;232775;45.0;35.4
01;2021-07-13;2049;4120;297888;236895;45.3;36.1
01;2021-07-14;140;180;298028;237075;45.4;36.1
01;2021-07-15;3079;4187;301107;241262;45.8;36.7
01;2021-07-16;3730;4838;304837;246100;46.4;37.5
01;2021-07-17;2176;3038;307013;249138;46.7;37.9
01;2021-07-18;286;553;307299;249691;46.8;38.0
01;2021-07-19;2901;3855;310200;253546;47.2;38.6
01;2021-07-20;3272;3684;313472;257230;47.7;39.2
01;2021-07-21;3914;3555;317386;260785;48.3;39.7
01;2021-07-22;4169;3477;321555;264262;48.9;40.2
01;2021-07-23;3913;4203;325468;268465;49.5;40.9
01;2021-07-24;2714;2708;328182;271173;50.0;41.3
01;2021-07-25;58;57;328240;271230;50.0;41.3
01;2021-07-26;3324;3238;331564;274468;50.5;41.8
01;2021-07-27;4081;2768;335645;277236;51.1;42.2
01;2021-07-28;3961;2632;339606;279868;51.7;42.6
01;2021-07-29;4669;2425;344275;282293;52.4;43.0
01;2021-07-30;4436;3419;348711;285712;53.1;43.5
01;2021-07-31;3612;1760;352323;287472;53.6;43.8
01;2021-08-01;380;67;352703;287539;53.7;43.8
01;2021-08-02;3037;2430;355740;289969;54.1;44.1
01;2021-08-03;3044;2441;358784;292410;54.6;44.5
01;2021-08-04;2529;1714;361313;294124;55.0;44.8
01;2021-08-05;2214;2337;363527;296461;55.3;45.1
02;2020-12-27;0;0;0;0;0.0;0.0
02;2020-12-28;0;0;0;0;0.0;0.0
02;2020-12-29;0;0;0;0;0.0;0.0
02;2020-12-30;0;0;0;0;0.0;0.0
02;2020-12-31;0;0;0;0;0.0;0.0
02;2021-01-01;0;0;0;0;0.0;0.0
02;2021-01-02;0;0;0;0;0.0;0.0
02;2021-01-03;0;0;0;0;0.0;0.0
02;2021-01-04;0;0;0;0;0.0;0.0
02;2021-01-05;0;0;0;0;0.0;0.0
02;2021-01-06;22;0;22;0;0.0;0.0
02;2021-01-07;261;1;283;1;0.1;0.0
02;2021-01-08;489;3;772;4;0.1;0.0
02;2021-01-09;74;0;846;4;0.2;0.0
02;2021-01-10;49;0;895;4;0.2;0.0
02;2021-01-11;267;0;1162;4;0.2;0.0
02;2021-01-12;355;1;1517;5;0.3;0.0
02;2021-01-13;468;4;1985;9;0.4;0.0
02;2021-01-14;651;11;2636;20;0.5;0.0
02;2021-01-15;630;7;3266;27;0.6;0.0
02;2021-01-16;333;4;3599;31;0.7;0.0
02;2021-01-17;62;0;3661;31;0.7;0.0
02;2021-01-18;810;5;4471;36;0.8;0.0
02;2021-01-19;942;5;5413;41;1.0;0.0
02;2021-01-20;1429;5;6842;46;1.3;0.0
02;2021-01-21;2597;4;9439;50;1.8;0.0
02;2021-01-22;1419;3;10858;53;2.1;0.0
02;2021-01-23;291;1;11149;54;2.1;0.0
02;2021-01-24;67;0;11216;54;2.1;0.0
02;2021-01-25;432;10;11648;64;2.2;0.0
02;2021-01-26;704;16;12352;80;2.3;0.0
02;2021-01-27;159;2;12511;82;2.4;0.0
02;2021-01-28;69;247;12580;329;2.4;0.1
02;2021-01-29;119;421;12699;750;2.4;0.1
02;2021-01-30;4;14;12703;764;2.4;0.1
02;2021-01-31;0;10;12703;774;2.4;0.1
02;2021-02-01;11;212;12714;986;2.4;0.2
02;2021-02-02;45;331;12759;1317;2.4;0.3
02;2021-02-03;124;339;12883;1656;2.4;0.3
02;2021-02-04;226;359;13109;2015;2.5;0.4
02;2021-02-05;178;417;13287;2432;2.5;0.5
02;2021-02-06;65;175;13352;2607;2.5;0.5
02;2021-02-07;9;0;13361;2607;2.5;0.5
02;2021-02-08;305;436;13666;3043;2.6;0.6
02;2021-02-09;322;681;13988;3724;2.7;0.7
02;2021-02-10;485;1046;14473;4770;2.8;0.9
02;2021-02-11;941;1908;15414;6678;2.9;1.3
02;2021-02-12;885;1121;16299;7799;3.1;1.5
02;2021-02-13;290;130;16589;7929;3.2;1.5
02;2021-02-14;1;5;16590;7934;3.2;1.5
02;2021-02-15;344;681;16934;8615;3.2;1.6
02;2021-02-16;413;571;17347;9186;3.3;1.7
02;2021-02-17;498;636;17845;9822;3.4;1.9
02;2021-02-18;507;444;18352;10266;3.5;2.0
02;2021-02-19;444;571;18796;10837;3.6;2.1
02;2021-02-20;372;233;19168;11070;3.6;2.1
02;2021-02-21;39;17;19207;11087;3.7;2.1
02;2021-02-22;377;317;19584;11404;3.7;2.2
02;2021-02-23;432;362;20016;11766;3.8;2.2
02;2021-02-24;600;146;20616;11912;3.9;2.3
02;2021-02-25;870;136;21486;12048;4.1;2.3
02;2021-02-26;808;71;22294;12119;4.2;2.3
02;2021-02-27;444;12;22738;12131;4.3;2.3
02;2021-02-28;55;2;22793;12133;4.3;2.3
02;2021-03-01;637;24;23430;12157;4.5;2.3
02;2021-03-02;1032;104;24462;12261;4.7;2.3
02;2021-03-03;752;204;25214;12465;4.8;2.4
02;2021-03-04;1160;669;26374;13134;5.0;2.5
02;2021-03-05;1048;507;27422;13641;5.2;2.6
02;2021-03-06;2138;94;29560;13735;5.6;2.6
02;2021-03-07;1503;40;31063;13775;5.9;2.6
02;2021-03-08;570;366;31633;14141;6.0;2.7
02;2021-03-09;998;400;32631;14541;6.2;2.8
02;2021-03-10;894;468;33525;15009;6.4;2.9
02;2021-03-11;1294;387;34819;15396;6.6;2.9
02;2021-03-12;1705;409;36524;15805;6.9;3.0
02;2021-03-13;2591;228;39115;16033;7.4;3.0
02;2021-03-14;1455;36;40570;16069;7.7;3.1
02;2021-03-15;612;449;41182;16518;7.8;3.1
02;2021-03-16;863;397;42045;16915;8.0;3.2
02;2021-03-17;759;450;42804;17365;8.1;3.3
02;2021-03-18;607;620;43411;17985;8.3;3.4
02;2021-03-19;1172;299;44583;18284;8.5;3.5
02;2021-03-20;2429;151;47012;18435;8.9;3.5
02;2021-03-21;1488;71;48500;18506;9.2;3.5
02;2021-03-22;761;501;49261;19007;9.4;3.6
02;2021-03-23;1194;545;50455;19552;9.6;3.7
02;2021-03-24;1581;493;52036;20045;9.9;3.8
02;2021-03-25;1693;596;53729;20641;10.2;3.9
02;2021-03-26;2411;482;56140;21123;10.7;4.0
02;2021-03-27;2495;124;58635;21247;11.1;4.0
02;2021-03-28;637;13;59272;21260;11.3;4.0
02;2021-03-29;1037;861;60309;22121;11.5;4.2
02;2021-03-30;1554;839;61863;22960;11.8;4.4
02;2021-03-31;1299;719;63162;23679;12.0;4.5
02;2021-04-01;1290;849;64452;24528;12.3;4.7
02;2021-04-02;1182;1228;65634;25756;12.5;4.9
02;2021-04-03;2647;848;68281;26604;13.0;5.1
02;2021-04-04;727;237;69008;26841;13.1;5.1
02;2021-04-05;1508;130;70516;26971;13.4;5.1
02;2021-04-06;1541;852;72057;27823;13.7;5.3
02;2021-04-07;1866;773;73923;28596;14.1;5.4
02;2021-04-08;1919;1103;75842;29699;14.4;5.6
02;2021-04-09;2433;1080;78275;30779;14.9;5.9
02;2021-04-10;2430;1201;80705;31980;15.3;6.1
02;2021-04-11;476;416;81181;32396;15.4;6.2
02;2021-04-12;1824;626;83005;33022;15.8;6.3
02;2021-04-13;1599;921;84604;33943;16.1;6.5
02;2021-04-14;2584;958;87188;34901;16.6;6.6
02;2021-04-15;2495;765;89683;35666;17.0;6.8
02;2021-04-16;2439;1122;92122;36788;17.5;7.0
02;2021-04-17;1890;2142;94012;38930;17.9;7.4
02;2021-04-18;270;814;94282;39744;17.9;7.6
02;2021-04-19;1159;633;95441;40377;18.1;7.7
02;2021-04-20;1676;759;97117;41136;18.5;7.8
02;2021-04-21;1549;986;98666;42122;18.8;8.0
02;2021-04-22;1749;700;100415;42822;19.1;8.1
02;2021-04-23;1929;1410;102344;44232;19.5;8.4
02;2021-04-24;1713;1637;104057;45869;19.8;8.7
02;2021-04-25;462;235;104519;46104;19.9;8.8
02;2021-04-26;1340;557;105859;46661;20.1;8.9
02;2021-04-27;1627;1092;107486;47753;20.4;9.1
02;2021-04-28;1593;1435;109079;49188;20.7;9.4
02;2021-04-29;1884;1174;110963;50362;21.1;9.6
02;2021-04-30;2716;1653;113679;52015;21.6;9.9
02;2021-05-01;1990;1223;115669;53238;22.0;10.1
02;2021-05-02;1983;408;117652;53646;22.4;10.2
02;2021-05-03;2223;982;119875;54628;22.8;10.4
02;2021-05-04;1525;1316;121400;55944;23.1;10.6
02;2021-05-05;2330;1835;123730;57779;23.5;11.0
02;2021-05-06;2123;1731;125853;59510;23.9;11.3
02;2021-05-07;2358;2173;128211;61683;24.4;11.7
02;2021-05-08;2919;939;131130;62622;24.9;11.9
02;2021-05-09;1822;421;132952;63043;25.3;12.0
02;2021-05-10;2375;1480;135327;64523;25.7;12.3
02;2021-05-11;2877;1566;138204;66089;26.3;12.6
02;2021-05-12;2673;1621;140877;67710;26.8;12.9
02;2021-05-13;2989;1038;143866;68748;27.3;13.1
02;2021-05-14;3379;1205;147245;69953;28.0;13.3
02;2021-05-15;4375;1083;151620;71036;28.8;13.5
02;2021-05-16;2797;209;154417;71245;29.4;13.5
02;2021-05-17;2146;658;156563;71903;29.8;13.7
02;2021-05-18;2633;968;159196;72871;30.3;13.9
02;2021-05-19;2852;990;162048;73861;30.8;14.0
02;2021-05-20;3552;1226;165600;75087;31.5;14.3
02;2021-05-21;3817;1062;169417;76149;32.2;14.5
02;2021-05-22;5848;963;175265;77112;33.3;14.7
02;2021-05-23;2659;238;177924;77350;33.8;14.7
02;2021-05-24;3541;539;181465;77889;34.5;14.8
02;2021-05-25;2261;1160;183726;79049;34.9;15.0
02;2021-05-26;3080;1495;186806;80544;35.5;15.3
02;2021-05-27;3651;1486;190457;82030;36.2;15.6
02;2021-05-28;3514;1582;193971;83612;36.9;15.9
02;2021-05-29;4081;1572;198052;85184;37.6;16.2
02;2021-05-30;1449;185;199501;85369;37.9;16.2
02;2021-05-31;2578;1194;202079;86563;38.4;16.5
02;2021-06-01;2866;1870;204945;88433;39.0;16.8
02;2021-06-02;3161;1646;208106;90079;39.6;17.1
02;2021-06-03;2856;1833;210962;91912;40.1;17.5
02;2021-06-04;3141;2055;214103;93967;40.7;17.9
02;2021-06-05;3437;1728;217540;95695;41.4;18.2
02;2021-06-06;1734;258;219274;95953;41.7;18.2
02;2021-06-07;1613;1500;220887;97453;42.0;18.5
02;2021-06-08;2062;1845;222949;99298;42.4;18.9
02;2021-06-09;2054;1649;225003;100947;42.8;19.2
02;2021-06-10;2010;1833;227013;102780;43.2;19.5
02;2021-06-11;2196;3070;229209;105850;43.6;20.1
02;2021-06-12;2312;2591;231521;108441;44.0;20.6
02;2021-06-13;683;1387;232204;109828;44.1;20.9
02;2021-06-14;1048;2393;233252;112221;44.3;21.3
02;2021-06-15;1518;2463;234770;114684;44.6;21.8
02;2021-06-16;1534;2747;236304;117431;44.9;22.3
02;2021-06-17;1780;2856;238084;120287;45.3;22.9
02;2021-06-18;2311;3565;240395;123852;45.7;23.5
02;2021-06-19;1840;3820;242235;127672;46.0;24.3
02;2021-06-20;644;1521;242879;129193;46.2;24.6
02;2021-06-21;806;3195;243685;132388;46.3;25.2
02;2021-06-22;1153;3667;244838;136055;46.5;25.9
02;2021-06-23;1216;3588;246054;139643;46.8;26.5
02;2021-06-24;1324;3150;247378;142793;47.0;27.1
02;2021-06-25;1395;4549;248773;147342;47.3;28.0
02;2021-06-26;1347;4226;250120;151568;47.5;28.8
02;2021-06-27;600;2333;250720;153901;47.7;29.3
02;2021-06-28;876;3021;251596;156922;47.8;29.8
02;2021-06-29;910;2927;252506;159849;48.0;30.4
02;2021-06-30;1442;3162;253948;163011;48.3;31.0
02;2021-07-01;1191;3587;255139;166598;48.5;31.7
02;2021-07-02;1315;5134;256454;171732;48.8;32.6
02;2021-07-03;994;5984;257448;177716;48.9;33.8
02;2021-07-04;508;2369;257956;180085;49.0;34.2
02;2021-07-05;656;3946;258612;184031;49.2;35.0
02;2021-07-06;667;3047;259279;187078;49.3;35.6
02;2021-07-07;1316;3729;260595;190807;49.5;36.3
02;2021-07-08;1389;3876;261984;194683;49.8;37.0
02;2021-07-09;1278;4219;263262;198902;50.0;37.8
02;2021-07-10;1330;4613;264592;203515;50.3;38.7
02;2021-07-11;478;1965;265070;205480;50.4;39.1
02;2021-07-12;1404;3727;266474;209207;50.7;39.8
02;2021-07-13;2060;3657;268534;212864;51.0;40.5
02;2021-07-14;1753;1595;270287;214459;51.4;40.8
02;2021-07-15;2714;3549;273001;218008;51.9;41.4
02;2021-07-16;3141;4220;276142;222228;52.5;42.2
02;2021-07-17;3548;4214;279690;226442;53.2;43.0
02;2021-07-18;2035;1608;281725;228050;53.6;43.4
02;2021-07-19;3424;3024;285149;231074;54.2;43.9
02;2021-07-20;3487;3293;288636;234367;54.9;44.6
02;2021-07-21;3898;2936;292534;237303;55.6;45.1
02;2021-07-22;3304;2800;295838;240103;56.2;45.6
02;2021-07-23;3170;3551;299008;243654;56.8;46.3
02;2021-07-24;4432;3708;303440;247362;57.7;47.0
02;2021-07-25;2180;1080;305620;248442;58.1;47.2
02;2021-07-26;3864;2235;309484;250677;58.8;47.7
02;2021-07-27;3623;2139;313107;252816;59.5;48.1
02;2021-07-28;3270;2090;316377;254906;60.1;48.5
02;2021-07-29;2568;2206;318945;257112;60.6;48.9
02;2021-07-30;3299;2300;322244;259412;61.3;49.3
02;2021-07-31;4162;2254;326406;261666;62.0;49.7
02;2021-08-01;1463;685;327869;262351;62.3;49.9
02;2021-08-02;2032;1595;329901;263946;62.7;50.2
02;2021-08-03;2514;1897;332415;265843;63.2;50.5
02;2021-08-04;2532;1675;334947;267518;63.7;50.9
02;2021-08-05;1809;2247;336756;269765;64.0;51.3
03;2020-12-27;0;0;0;0;0.0;0.0
03;2020-12-28;0;0;0;0;0.0;0.0
03;2020-12-29;0;0;0;0;0.0;0.0
03;2020-12-30;0;0;0;0;0.0;0.0
03;2020-12-31;0;0;0;0;0.0;0.0
03;2021-01-01;0;0;0;0;0.0;0.0
03;2021-01-02;0;0;0;0;0.0;0.0
03;2021-01-03;0;0;0;0;0.0;0.0
03;2021-01-04;0;0;0;0;0.0;0.0
03;2021-01-05;0;0;0;0;0.0;0.0
03;2021-01-06;10;0;10;0;0.0;0.0
03;2021-01-07;61;0;71;0;0.0;0.0
03;2021-01-08;146;1;217;1;0.1;0.0
03;2021-01-09;122;0;339;1;0.1;0.0
03;2021-01-10;6;0;345;1;0.1;0.0
03;2021-01-11;412;1;757;2;0.2;0.0
03;2021-01-12;631;0;1388;2;0.4;0.0
03;2021-01-13;669;2;2057;4;0.6;0.0
03;2021-01-14;860;5;2917;9;0.9;0.0
03;2021-01-15;388;3;3305;12;1.0;0.0
03;2021-01-16;278;0;3583;12;1.1;0.0
03;2021-01-17;42;0;3625;12;1.1;0.0
03;2021-01-18;879;0;4504;12;1.4;0.0
03;2021-01-19;1149;1;5653;13;1.7;0.0
03;2021-01-20;1289;2;6942;15;2.1;0.0
03;2021-01-21;1199;5;8141;20;2.5;0.0
03;2021-01-22;1117;4;9258;24;2.8;0.0
03;2021-01-23;466;0;9724;24;2.9;0.0
03;2021-01-24;0;0;9724;24;2.9;0.0
03;2021-01-25;187;0;9911;24;3.0;0.0
03;2021-01-26;678;14;10589;38;3.2;0.0
03;2021-01-27;695;11;11284;49;3.4;0.0
03;2021-01-28;1018;45;12302;94;3.7;0.0
03;2021-01-29;856;81;13158;175;4.0;0.1
03;2021-01-30;600;2;13758;177;4.2;0.1
03;2021-01-31;0;0;13758;177;4.2;0.1
03;2021-02-01;160;76;13918;253;4.2;0.1
03;2021-02-02;767;269;14685;522;4.4;0.2
03;2021-02-03;1055;493;15740;1015;4.8;0.3
03;2021-02-04;1546;632;17286;1647;5.2;0.5
03;2021-02-05;946;317;18232;1964;5.5;0.6
03;2021-02-06;152;13;18384;1977;5.5;0.6
03;2021-02-07;5;0;18389;1977;5.6;0.6
03;2021-02-08;128;56;18517;2033;5.6;0.6
03;2021-02-09;612;444;19129;2477;5.8;0.7
03;2021-02-10;484;340;19613;2817;5.9;0.9
03;2021-02-11;1025;580;20638;3397;6.2;1.0
03;2021-02-12;1075;549;21713;3946;6.6;1.2
03;2021-02-13;126;168;21839;4114;6.6;1.2
03;2021-02-14;0;1;21839;4115;6.6;1.2
03;2021-02-15;308;862;22147;4977;6.7;1.5
03;2021-02-16;547;1172;22694;6149;6.8;1.9
03;2021-02-17;453;1365;23147;7514;7.0;2.3
03;2021-02-18;367;1273;23514;8787;7.1;2.7
03;2021-02-19;496;799;24010;9586;7.2;2.9
03;2021-02-20;128;184;24138;9770;7.3;2.9
03;2021-02-21;2;1;24140;9771;7.3;2.9
03;2021-02-22;159;205;24299;9976;7.3;3.0
03;2021-02-23;721;951;25020;10927;7.6;3.3
03;2021-02-24;609;1021;25629;11948;7.7;3.6
03;2021-02-25;1089;1837;26718;13785;8.1;4.2
03;2021-02-26;820;1375;27538;15160;8.3;4.6
03;2021-02-27;96;258;27634;15418;8.3;4.7
03;2021-02-28;0;15;27634;15433;8.3;4.7
03;2021-03-01;178;240;27812;15673;8.4;4.7
03;2021-03-02;818;663;28630;16336;8.6;4.9
03;2021-03-03;893;448;29523;16784;8.9;5.1
03;2021-03-04;1529;586;31052;17370;9.4;5.2
03;2021-03-05;1120;722;32172;18092;9.7;5.5
03;2021-03-06;915;112;33087;18204;10.0;5.5
03;2021-03-07;2;0;33089;18204;10.0;5.5
03;2021-03-08;239;245;33328;18449;10.1;5.6
03;2021-03-09;1016;436;34344;18885;10.4;5.7
03;2021-03-10;941;549;35285;19434;10.6;5.9
03;2021-03-11;1676;647;36961;20081;11.2;6.1
03;2021-03-12;1302;865;38263;20946;11.5;6.3
03;2021-03-13;861;108;39124;21054;11.8;6.4
03;2021-03-14;2;9;39126;21063;11.8;6.4
03;2021-03-15;249;200;39375;21263;11.9;6.4
03;2021-03-16;650;402;40025;21665;12.1;6.5
03;2021-03-17;1300;443;41325;22108;12.5;6.7
03;2021-03-18;1719;391;43044;22499;13.0;6.8
03;2021-03-19;1728;357;44772;22856;13.5;6.9
03;2021-03-20;301;24;45073;22880;13.6;6.9
03;2021-03-21;0;0;45073;22880;13.6;6.9
03;2021-03-22;222;396;45295;23276;13.7;7.0
03;2021-03-23;1354;353;46649;23629;14.1;7.1
03;2021-03-24;1822;348;48471;23977;14.6;7.2
03;2021-03-25;2366;561;50837;24538;15.3;7.4
03;2021-03-26;2233;441;53070;24979;16.0;7.5
03;2021-03-27;817;20;53887;24999;16.3;7.5
03;2021-03-28;1;39;53888;25038;16.3;7.6
03;2021-03-29;657;176;54545;25214;16.5;7.6
03;2021-03-30;1908;448;56453;25662;17.0;7.7
03;2021-03-31;1011;985;57464;26647;17.3;8.0
03;2021-04-01;1332;1091;58796;27738;17.7;8.4
03;2021-04-02;1707;609;60503;28347;18.3;8.6
03;2021-04-03;366;95;60869;28442;18.4;8.6
03;2021-04-04;2;0;60871;28442;18.4;8.6
03;2021-04-05;18;14;60889;28456;18.4;8.6
03;2021-04-06;1072;407;61961;28863;18.7;8.7
03;2021-04-07;1562;512;63523;29375;19.2;8.9
03;2021-04-08;2121;476;65644;29851;19.8;9.0
03;2021-04-09;2059;1157;67703;31008;20.4;9.4
03;2021-04-10;1012;73;68715;31081;20.7;9.4
03;2021-04-11;478;9;69193;31090;20.9;9.4
03;2021-04-12;985;223;70178;31313;21.2;9.5
03;2021-04-13;1871;970;72049;32283;21.7;9.7
03;2021-04-14;2336;1210;74385;33493;22.5;10.1
03;2021-04-15;2621;1394;77006;34887;23.2;10.5
03;2021-04-16;2833;1165;79839;36052;24.1;10.9
03;2021-04-17;1082;433;80921;36485;24.4;11.0
03;2021-04-18;0;0;80921;36485;24.4;11.0
03;2021-04-19;1191;587;82112;37072;24.8;11.2
03;2021-04-20;1749;1270;83861;38342;25.3;11.6
03;2021-04-21;1122;1289;84983;39631;25.7;12.0
03;2021-04-22;1673;989;86656;40620;26.2;12.3
03;2021-04-23;2475;1252;89131;41872;26.9;12.6
03;2021-04-24;1301;911;90432;42783;27.3;12.9
03;2021-04-25;350;15;90782;42798;27.4;12.9
03;2021-04-26;1331;459;92113;43257;27.8;13.1
03;2021-04-27;1765;1514;93878;44771;28.3;13.5
03;2021-04-28;1929;1112;95807;45883;28.9;13.8
03;2021-04-29;2371;1236;98178;47119;29.6;14.2
03;2021-04-30;1931;799;100109;47918;30.2;14.5
03;2021-05-01;437;489;100546;48407;30.3;14.6
03;2021-05-02;1;1;100547;48408;30.3;14.6
03;2021-05-03;1910;770;102457;49178;30.9;14.8
03;2021-05-04;2842;1621;105299;50799;31.8;15.3
03;2021-05-05;2603;1315;107902;52114;32.6;15.7
03;2021-05-06;3095;2006;110997;54120;33.5;16.3
03;2021-05-07;4726;1781;115723;55901;34.9;16.9
03;2021-05-08;661;379;116384;56280;35.1;17.0
03;2021-05-09;49;512;116433;56792;35.1;17.1
03;2021-05-10;1891;1462;118324;58254;35.7;17.6
03;2021-05-11;3901;1830;122225;60084;36.9;18.1
03;2021-05-12;2970;1519;125195;61603;37.8;18.6
03;2021-05-13;4378;398;129573;62001;39.1;18.7
03;2021-05-14;3654;1689;133227;63690;40.2;19.2
03;2021-05-15;1942;487;135169;64177;40.8;19.4
03;2021-05-16;517;56;135686;64233;41.0;19.4
03;2021-05-17;1276;861;136962;65094;41.3;19.6
03;2021-05-18;3070;1496;140032;66590;42.3;20.1
03;2021-05-19;2618;961;142650;67551;43.1;20.4
03;2021-05-20;3331;1132;145981;68683;44.1;20.7
03;2021-05-21;4192;1278;150173;69961;45.3;21.1
03;2021-05-22;2012;358;152185;70319;45.9;21.2
03;2021-05-23;641;73;152826;70392;46.1;21.2
03;2021-05-24;2654;213;155480;70605;46.9;21.3
03;2021-05-25;3071;1685;158551;72290;47.9;21.8
03;2021-05-26;2338;1042;160889;73332;48.6;22.1
03;2021-05-27;2944;1123;163833;74455;49.4;22.5
03;2021-05-28;3843;2273;167676;76728;50.6;23.2
03;2021-05-29;1746;598;169422;77326;51.1;23.3
03;2021-05-30;242;23;169664;77349;51.2;23.3
03;2021-05-31;694;572;170358;77921;51.4;23.5
03;2021-06-01;2302;2342;172660;80263;52.1;24.2
03;2021-06-02;1532;1747;174192;82010;52.6;24.8
03;2021-06-03;2057;2753;176249;84763;53.2;25.6
03;2021-06-04;1699;2504;177948;87267;53.7;26.3
03;2021-06-05;1076;1141;179024;88408;54.0;26.7
03;2021-06-06;59;7;179083;88415;54.1;26.7
03;2021-06-07;783;1812;179866;90227;54.3;27.2
03;2021-06-08;1455;2550;181321;92777;54.7;28.0
03;2021-06-09;1267;1872;182588;94649;55.1;28.6
03;2021-06-10;1377;2120;183965;96769;55.5;29.2
03;2021-06-11;1503;3449;185468;100218;56.0;30.2
03;2021-06-12;831;823;186299;101041;56.2;30.5
03;2021-06-13;20;10;186319;101051;56.2;30.5
03;2021-06-14;381;2178;186700;103229;56.4;31.2
03;2021-06-15;1316;3835;188016;107064;56.7;32.3
03;2021-06-16;788;2887;188804;109951;57.0;33.2
03;2021-06-17;1083;3332;189887;113283;57.3;34.2
03;2021-06-18;1111;3976;190998;117259;57.6;35.4
03;2021-06-19;640;1615;191638;118874;57.8;35.9
03;2021-06-20;20;8;191658;118882;57.8;35.9
03;2021-06-21;457;2637;192115;121519;58.0;36.7
03;2021-06-22;1024;4001;193139;125520;58.3;37.9
03;2021-06-23;701;3283;193840;128803;58.5;38.9
03;2021-06-24;975;3862;194815;132665;58.8;40.0
03;2021-06-25;1003;3891;195818;136556;59.1;41.2
03;2021-06-26;511;2040;196329;138596;59.3;41.8
03;2021-06-27;66;486;196395;139082;59.3;42.0
03;2021-06-28;636;2097;197031;141179;59.5;42.6
03;2021-06-29;1016;3330;198047;144509;59.8;43.6
03;2021-06-30;831;3116;198878;147625;60.0;44.6
03;2021-07-01;980;2938;199858;150563;60.3;45.4
03;2021-07-02;917;4093;200775;154656;60.6;46.7
03;2021-07-03;486;1882;201261;156538;60.7;47.2
03;2021-07-04;19;332;201280;156870;60.8;47.3
03;2021-07-05;807;2377;202087;159247;61.0;48.1
03;2021-07-06;1098;3456;203185;162703;61.3;49.1
03;2021-07-07;800;2614;203985;165317;61.6;49.9
03;2021-07-08;1050;3035;205035;168352;61.9;50.8
03;2021-07-09;1426;3627;206461;171979;62.3;51.9
03;2021-07-10;489;1925;206950;173904;62.5;52.5
03;2021-07-11;59;493;207009;174397;62.5;52.6
03;2021-07-12;924;1149;207933;175546;62.8;53.0
03;2021-07-13;2518;3150;210451;178696;63.5;53.9
03;2021-07-14;194;23;210645;178719;63.6;53.9
03;2021-07-15;2560;2453;213205;181172;64.4;54.7
03;2021-07-16;2693;2270;215898;183442;65.2;55.4
03;2021-07-17;1023;1626;216921;185068;65.5;55.9
03;2021-07-18;31;6;216952;185074;65.5;55.9
03;2021-07-19;2377;1269;219329;186343;66.2;56.2
03;2021-07-20;3062;3035;222391;189378;67.1;57.2
03;2021-07-21;3201;1436;225592;190814;68.1;57.6
03;2021-07-22;2842;1872;228434;192686;68.9;58.2
03;2021-07-23;3185;1289;231619;193975;69.9;58.5
03;2021-07-24;586;578;232205;194553;70.1;58.7
03;2021-07-25;17;5;232222;194558;70.1;58.7
03;2021-07-26;2034;1577;234256;196135;70.7;59.2
03;2021-07-27;3302;2216;237558;198351;71.7;59.9
03;2021-07-28;2702;1111;240260;199462;72.5;60.2
03;2021-07-29;2484;1657;242744;201119;73.3;60.7
03;2021-07-30;2116;1442;244860;202561;73.9;61.1
03;2021-07-31;960;887;245820;203448;74.2;61.4
03;2021-08-01;13;20;245833;203468;74.2;61.4
03;2021-08-02;1661;1601;247494;205069;74.7;61.9
03;2021-08-03;2212;2773;249706;207842;75.4;62.7
03;2021-08-04;2184;869;251890;208711;76.0;63.0
03;2021-08-05;1250;1922;253140;210633;76.4;63.6
04;2020-12-27;0;0;0;0;0.0;0.0
04;2020-12-28;1;0;1;0;0.0;0.0
04;2020-12-29;0;0;1;0;0.0;0.0
04;2020-12-30;0;0;1;0;0.0;0.0
04;2020-12-31;0;0;1;0;0.0;0.0
04;2021-01-01;0;0;1;0;0.0;0.0
04;2021-01-02;0;0;1;0;0.0;0.0
04;2021-01-03;0;0;1;0;0.0;0.0
04;2021-01-04;0;0;1;0;0.0;0.0
04;2021-01-05;4;0;5;0;0.0;0.0
04;2021-01-06;0;0;5;0;0.0;0.0
04;2021-01-07;61;0;66;0;0.0;0.0
04;2021-01-08;88;0;154;0;0.1;0.0
04;2021-01-09;57;0;211;0;0.1;0.0
04;2021-01-10;0;0;211;0;0.1;0.0
04;2021-01-11;76;0;287;0;0.2;0.0
04;2021-01-12;418;1;705;1;0.4;0.0
04;2021-01-13;245;1;950;2;0.6;0.0
04;2021-01-14;90;2;1040;4;0.6;0.0
04;2021-01-15;165;4;1205;8;0.7;0.0
04;2021-01-16;105;2;1310;10;0.8;0.0
04;2021-01-17;14;0;1324;10;0.8;0.0
04;2021-01-18;235;9;1559;19;0.9;0.0
04;2021-01-19;466;4;2025;23;1.2;0.0
04;2021-01-20;572;6;2597;29;1.6;0.0
04;2021-01-21;612;6;3209;35;1.9;0.0
04;2021-01-22;638;1;3847;36;2.3;0.0
04;2021-01-23;109;0;3956;36;2.4;0.0
04;2021-01-24;0;0;3956;36;2.4;0.0
04;2021-01-25;239;0;4195;36;2.5;0.0
04;2021-01-26;656;0;4851;36;2.9;0.0
04;2021-01-27;480;0;5331;36;3.2;0.0
04;2021-01-28;665;22;5996;58;3.6;0.0
04;2021-01-29;367;41;6363;99;3.9;0.1
04;2021-01-30;65;41;6428;140;3.9;0.1
04;2021-01-31;1;5;6429;145;3.9;0.1
04;2021-02-01;239;149;6668;294;4.0;0.2
04;2021-02-02;552;224;7220;518;4.4;0.3
04;2021-02-03;368;162;7588;680;4.6;0.4
04;2021-02-04;355;53;7943;733;4.8;0.4
04;2021-02-05;379;223;8322;956;5.0;0.6
04;2021-02-06;50;95;8372;1051;5.1;0.6
04;2021-02-07;2;22;8374;1073;5.1;0.6
04;2021-02-08;163;71;8537;1144;5.2;0.7
04;2021-02-09;193;144;8730;1288;5.3;0.8
04;2021-02-10;252;171;8982;1459;5.4;0.9
04;2021-02-11;364;291;9346;1750;5.7;1.1
04;2021-02-12;293;318;9639;2068;5.8;1.3
04;2021-02-13;26;94;9665;2162;5.9;1.3
04;2021-02-14;0;0;9665;2162;5.9;1.3
04;2021-02-15;31;165;9696;2327;5.9;1.4
04;2021-02-16;80;522;9776;2849;5.9;1.7
04;2021-02-17;67;434;9843;3283;6.0;2.0
04;2021-02-18;45;612;9888;3895;6.0;2.4
04;2021-02-19;51;377;9939;4272;6.0;2.6
04;2021-02-20;5;71;9944;4343;6.0;2.6
04;2021-02-21;0;0;9944;4343;6.0;2.6
04;2021-02-22;7;298;9951;4641;6.0;2.8
04;2021-02-23;19;595;9970;5236;6.0;3.2
04;2021-02-24;38;429;10008;5665;6.1;3.4
04;2021-02-25;70;378;10078;6043;6.1;3.7
04;2021-02-26;215;332;10293;6375;6.2;3.9
04;2021-02-27;179;75;10472;6450;6.3;3.9
04;2021-02-28;1;0;10473;6450;6.3;3.9
04;2021-03-01;18;74;10491;6524;6.4;3.9
04;2021-03-02;135;41;10626;6565;6.4;4.0
04;2021-03-03;375;644;11001;7209;6.7;4.4
04;2021-03-04;208;491;11209;7700;6.8;4.7
04;2021-03-05;236;359;11445;8059;6.9;4.9
04;2021-03-06;912;69;12357;8128;7.5;4.9
04;2021-03-07;498;24;12855;8152;7.8;4.9
04;2021-03-08;44;83;12899;8235;7.8;5.0
04;2021-03-09;215;257;13114;8492;7.9;5.1
04;2021-03-10;400;372;13514;8864;8.2;5.4
04;2021-03-11;495;341;14009;9205;8.5;5.6
04;2021-03-12;699;205;14708;9410;8.9;5.7
04;2021-03-13;1087;61;15795;9471;9.6;5.7
04;2021-03-14;459;3;16254;9474;9.8;5.7
04;2021-03-15;93;13;16347;9487;9.9;5.7
04;2021-03-16;74;9;16421;9496;9.9;5.7
04;2021-03-17;531;75;16952;9571;10.3;5.8
04;2021-03-18;815;22;17767;9593;10.8;5.8
04;2021-03-19;723;31;18490;9624;11.2;5.8
04;2021-03-20;159;3;18649;9627;11.3;5.8
04;2021-03-21;0;0;18649;9627;11.3;5.8
04;2021-03-22;105;12;18754;9639;11.4;5.8
04;2021-03-23;244;6;18998;9645;11.5;5.8
04;2021-03-24;1023;51;20021;9696;12.1;5.9
04;2021-03-25;1326;45;21347;9741;12.9;5.9
04;2021-03-26;1448;66;22795;9807;13.8;5.9
04;2021-03-27;264;19;23059;9826;14.0;5.9
04;2021-03-28;2;0;23061;9826;14.0;5.9
04;2021-03-29;679;12;23740;9838;14.4;6.0
04;2021-03-30;1085;147;24825;9985;15.0;6.0
04;2021-03-31;1327;100;26152;10085;15.8;6.1
04;2021-04-01;1132;121;27284;10206;16.5;6.2
04;2021-04-02;1184;109;28468;10315;17.2;6.2
04;2021-04-03;250;20;28718;10335;17.4;6.3
04;2021-04-04;1;0;28719;10335;17.4;6.3
04;2021-04-05;35;1;28754;10336;17.4;6.3
04;2021-04-06;927;143;29681;10479;18.0;6.3
04;2021-04-07;882;433;30563;10912;18.5;6.6
04;2021-04-08;926;697;31489;11609;19.1;7.0
04;2021-04-09;677;415;32166;12024;19.5;7.3
04;2021-04-10;231;192;32397;12216;19.6;7.4
04;2021-04-11;153;65;32550;12281;19.7;7.4
04;2021-04-12;594;98;33144;12379;20.1;7.5
04;2021-04-13;1190;237;34334;12616;20.8;7.6
04;2021-04-14;992;499;35326;13115;21.4;7.9
04;2021-04-15;921;666;36247;13781;21.9;8.3
04;2021-04-16;819;457;37066;14238;22.4;8.6
04;2021-04-17;211;69;37277;14307;22.6;8.7
04;2021-04-18;0;13;37277;14320;22.6;8.7
04;2021-04-19;338;290;37615;14610;22.8;8.8
04;2021-04-20;1005;444;38620;15054;23.4;9.1
04;2021-04-21;654;747;39274;15801;23.8;9.6
04;2021-04-22;759;854;40033;16655;24.2;10.1
04;2021-04-23;695;535;40728;17190;24.7;10.4
04;2021-04-24;165;65;40893;17255;24.8;10.4
04;2021-04-25;0;0;40893;17255;24.8;10.4
04;2021-04-26;172;612;41065;17867;24.9;10.8
04;2021-04-27;394;967;41459;18834;25.1;11.4
04;2021-04-28;431;1088;41890;19922;25.4;12.1
04;2021-04-29;687;1127;42577;21049;25.8;12.7
04;2021-04-30;435;849;43012;21898;26.0;13.3
04;2021-05-01;104;22;43116;21920;26.1;13.3
04;2021-05-02;8;132;43124;22052;26.1;13.3
04;2021-05-03;151;552;43275;22604;26.2;13.7
04;2021-05-04;564;838;43839;23442;26.5;14.2
04;2021-05-05;514;929;44353;24371;26.8;14.8
04;2021-05-06;1160;589;45513;24960;27.6;15.1
04;2021-05-07;658;761;46171;25721;27.9;15.6
04;2021-05-08;48;98;46219;25819;28.0;15.6
04;2021-05-09;0;0;46219;25819;28.0;15.6
04;2021-05-10;466;295;46685;26114;28.3;15.8
04;2021-05-11;1202;907;47887;27021;29.0;16.4
04;2021-05-12;1389;738;49276;27759;29.8;16.8
04;2021-05-13;378;130;49654;27889;30.1;16.9
04;2021-05-14;441;296;50095;28185;30.3;17.1
04;2021-05-15;99;163;50194;28348;30.4;17.2
04;2021-05-16;4;6;50198;28354;30.4;17.2
04;2021-05-17;155;298;50353;28652;30.5;17.3
04;2021-05-18;392;975;50745;29627;30.7;17.9
04;2021-05-19;773;688;51518;30315;31.2;18.4
04;2021-05-20;1258;553;52776;30868;31.9;18.7
04;2021-05-21;849;786;53625;31654;32.5;19.2
04;2021-05-22;105;146;53730;31800;32.5;19.2
04;2021-05-23;1;1;53731;31801;32.5;19.3
04;2021-05-24;1;36;53732;31837;32.5;19.3
04;2021-05-25;868;595;54600;32432;33.1;19.6
04;2021-05-26;1047;787;55647;33219;33.7;20.1
04;2021-05-27;1357;631;57004;33850;34.5;20.5
04;2021-05-28;1120;657;58124;34507;35.2;20.9
04;2021-05-29;89;397;58213;34904;35.2;21.1
04;2021-05-30;3;1;58216;34905;35.2;21.1
04;2021-05-31;421;418;58637;35323;35.5;21.4
04;2021-06-01;641;636;59278;35959;35.9;21.8
04;2021-06-02;870;1062;60148;37021;36.4;22.4
04;2021-06-03;1195;853;61343;37874;37.1;22.9
04;2021-06-04;977;779;62320;38653;37.7;23.4
04;2021-06-05;142;201;62462;38854;37.8;23.5
04;2021-06-06;6;13;62468;38867;37.8;23.5
04;2021-06-07;564;318;63032;39185;38.2;23.7
04;2021-06-08;843;597;63875;39782;38.7;24.1
04;2021-06-09;1149;687;65024;40469;39.4;24.5
04;2021-06-10;1146;584;66170;41053;40.1;24.9
04;2021-06-11;945;610;67115;41663;40.6;25.2
04;2021-06-12;211;148;67326;41811;40.8;25.3
04;2021-06-13;1;1;67327;41812;40.8;25.3
04;2021-06-14;478;304;67805;42116;41.0;25.5
04;2021-06-15;642;1000;68447;43116;41.4;26.1
04;2021-06-16;1021;784;69468;43900;42.1;26.6
04;2021-06-17;1000;959;70468;44859;42.7;27.2
04;2021-06-18;765;885;71233;45744;43.1;27.7
04;2021-06-19;39;85;71272;45829;43.1;27.7
04;2021-06-20;7;9;71279;45838;43.1;27.7
04;2021-06-21;306;613;71585;46451;43.3;28.1
04;2021-06-22;361;1307;71946;47758;43.6;28.9
04;2021-06-23;474;1313;72420;49071;43.8;29.7
04;2021-06-24;850;818;73270;49889;44.4;30.2
04;2021-06-25;461;637;73731;50526;44.6;30.6
04;2021-06-26;56;129;73787;50655;44.7;30.7
04;2021-06-27;4;4;73791;50659;44.7;30.7
04;2021-06-28;159;340;73950;50999;44.8;30.9
04;2021-06-29;370;834;74320;51833;45.0;31.4
04;2021-06-30;541;1120;74861;52953;45.3;32.1
04;2021-07-01;576;1214;75437;54167;45.7;32.8
04;2021-07-02;556;1086;75993;55253;46.0;33.4
04;2021-07-03;65;162;76058;55415;46.0;33.5
04;2021-07-04;6;6;76064;55421;46.0;33.5
04;2021-07-05;105;295;76169;55716;46.1;33.7
04;2021-07-06;505;1383;76674;57099;46.4;34.6
04;2021-07-07;488;1343;77162;58442;46.7;35.4
04;2021-07-08;724;1355;77886;59797;47.1;36.2
04;2021-07-09;581;1063;78467;60860;47.5;36.8
04;2021-07-10;91;175;78558;61035;47.6;36.9
04;2021-07-11;0;21;78558;61056;47.6;37.0
04;2021-07-12;126;654;78684;61710;47.6;37.4
04;2021-07-13;875;1542;79559;63252;48.2;38.3
04;2021-07-14;24;43;79583;63295;48.2;38.3
04;2021-07-15;1214;1731;80797;65026;48.9;39.4
04;2021-07-16;1076;1113;81873;66139;49.6;40.0
04;2021-07-17;443;232;82316;66371;49.8;40.2
04;2021-07-18;112;18;82428;66389;49.9;40.2
04;2021-07-19;483;652;82911;67041;50.2;40.6
04;2021-07-20;1308;1455;84219;68496;51.0;41.5
04;2021-07-21;1119;1165;85338;69661;51.7;42.2
04;2021-07-22;1495;1363;86833;71024;52.6;43.0
04;2021-07-23;1149;1140;87982;72164;53.3;43.7
04;2021-07-24;681;213;88663;72377;53.7;43.8
04;2021-07-25;42;20;88705;72397;53.7;43.8
04;2021-07-26;439;638;89144;73035;54.0;44.2
04;2021-07-27;1360;1043;90504;74078;54.8;44.8
04;2021-07-28;1069;1036;91573;75114;55.4;45.5
04;2021-07-29;1547;1299;93120;76413;56.4;46.3
04;2021-07-30;1245;919;94365;77332;57.1;46.8
04;2021-07-31;251;175;94616;77507;57.3;46.9
04;2021-08-01;48;18;94664;77525;57.3;46.9
04;2021-08-02;133;109;94797;77634;57.4;47.0
04;2021-08-03;1330;1101;96127;78735;58.2;47.7
04;2021-08-04;1170;857;97297;79592;58.9;48.2
04;2021-08-05;1186;734;98483;80326;59.6;48.6
05;2020-12-27;0;0;0;0;0.0;0.0
05;2020-12-28;1;0;1;0;0.0;0.0
05;2020-12-29;1;0;2;0;0.0;0.0
05;2020-12-30;0;0;2;0;0.0;0.0
05;2020-12-31;0;0;2;0;0.0;0.0
05;2021-01-01;2;0;4;0;0.0;0.0
05;2021-01-02;2;0;6;0;0.0;0.0
05;2021-01-03;1;0;7;0;0.0;0.0
05;2021-01-04;2;0;9;0;0.0;0.0
05;2021-01-05;0;0;9;0;0.0;0.0
05;2021-01-06;21;0;30;0;0.0;0.0
05;2021-01-07;128;0;158;0;0.1;0.0
05;2021-01-08;146;0;304;0;0.2;0.0
05;2021-01-09;11;0;315;0;0.2;0.0
05;2021-01-10;0;0;315;0;0.2;0.0
05;2021-01-11;44;0;359;0;0.3;0.0
05;2021-01-12;105;0;464;0;0.3;0.0
05;2021-01-13;140;0;604;0;0.4;0.0
05;2021-01-14;166;0;770;0;0.5;0.0
05;2021-01-15;128;1;898;1;0.6;0.0
05;2021-01-16;13;0;911;1;0.6;0.0
05;2021-01-17;0;0;911;1;0.6;0.0
05;2021-01-18;225;1;1136;2;0.8;0.0
05;2021-01-19;227;0;1363;2;1.0;0.0
05;2021-01-20;213;0;1576;2;1.1;0.0
05;2021-01-21;255;0;1831;2;1.3;0.0
05;2021-01-22;194;1;2025;3;1.4;0.0
05;2021-01-23;112;0;2137;3;1.5;0.0
05;2021-01-24;0;0;2137;3;1.5;0.0
05;2021-01-25;315;0;2452;3;1.7;0.0
05;2021-01-26;485;0;2937;3;2.1;0.0
05;2021-01-27;389;4;3326;7;2.3;0.0
05;2021-01-28;363;55;3689;62;2.6;0.0
05;2021-01-29;363;113;4052;175;2.9;0.1
05;2021-01-30;97;9;4149;184;2.9;0.1
05;2021-01-31;4;0;4153;184;2.9;0.1
05;2021-02-01;176;21;4329;205;3.1;0.1
05;2021-02-02;186;121;4515;326;3.2;0.2
05;2021-02-03;206;65;4721;391;3.3;0.3
05;2021-02-04;197;127;4918;518;3.5;0.4
05;2021-02-05;183;111;5101;629;3.6;0.4
05;2021-02-06;75;24;5176;653;3.7;0.5
05;2021-02-07;0;5;5176;658;3.7;0.5
05;2021-02-08;84;125;5260;783;3.7;0.6
05;2021-02-09;97;118;5357;901;3.8;0.6
05;2021-02-10;81;178;5438;1079;3.8;0.8
05;2021-02-11;87;138;5525;1217;3.9;0.9
05;2021-02-12;84;150;5609;1367;4.0;1.0
05;2021-02-13;75;32;5684;1399;4.0;1.0
05;2021-02-14;0;0;5684;1399;4.0;1.0
05;2021-02-15;97;191;5781;1590;4.1;1.1
05;2021-02-16;111;286;5892;1876;4.2;1.3
05;2021-02-17;136;233;6028;2109;4.3;1.5
05;2021-02-18;154;299;6182;2408;4.4;1.7
05;2021-02-19;158;323;6340;2731;4.5;1.9
05;2021-02-20;31;87;6371;2818;4.5;2.0
05;2021-02-21;0;0;6371;2818;4.5;2.0
05;2021-02-22;70;245;6441;3063;4.5;2.2
05;2021-02-23;18;239;6459;3302;4.6;2.3
05;2021-02-24;21;196;6480;3498;4.6;2.5
05;2021-02-25;56;177;6536;3675;4.6;2.6
05;2021-02-26;145;213;6681;3888;4.7;2.7
05;2021-02-27;65;171;6746;4059;4.8;2.9
05;2021-02-28;10;0;6756;4059;4.8;2.9
05;2021-03-01;90;170;6846;4229;4.8;3.0
05;2021-03-02;92;198;6938;4427;4.9;3.1
05;2021-03-03;111;232;7049;4659;5.0;3.3
05;2021-03-04;242;166;7291;4825;5.1;3.4
05;2021-03-05;578;192;7869;5017;5.6;3.5
05;2021-03-06;668;58;8537;5075;6.0;3.6
05;2021-03-07;515;18;9052;5093;6.4;3.6
05;2021-03-08;556;136;9608;5229;6.8;3.7
05;2021-03-09;518;160;10126;5389;7.1;3.8
05;2021-03-10;497;142;10623;5531;7.5;3.9
05;2021-03-11;374;137;10997;5668;7.8;4.0
05;2021-03-12;435;87;11432;5755;8.1;4.1
05;2021-03-13;794;87;12226;5842;8.6;4.1
05;2021-03-14;668;8;12894;5850;9.1;4.1
05;2021-03-15;353;125;13247;5975;9.3;4.2
05;2021-03-16;148;140;13395;6115;9.4;4.3
05;2021-03-17;262;120;13657;6235;9.6;4.4
05;2021-03-18;364;34;14021;6269;9.9;4.4
05;2021-03-19;449;59;14470;6328;10.2;4.5
05;2021-03-20;167;31;14637;6359;10.3;4.5
05;2021-03-21;0;0;14637;6359;10.3;4.5
05;2021-03-22;715;30;15352;6389;10.8;4.5
05;2021-03-23;804;12;16156;6401;11.4;4.5
05;2021-03-24;786;74;16942;6475;12.0;4.6
05;2021-03-25;899;57;17841;6532;12.6;4.6
05;2021-03-26;1023;42;18864;6574;13.3;4.6
05;2021-03-27;466;34;19330;6608;13.6;4.7
05;2021-03-28;10;0;19340;6608;13.6;4.7
05;2021-03-29;905;62;20245;6670;14.3;4.7
05;2021-03-30;1141;69;21386;6739;15.1;4.8
05;2021-03-31;823;253;22209;6992;15.7;4.9
05;2021-04-01;899;237;23108;7229;16.3;5.1
05;2021-04-02;665;375;23773;7604;16.8;5.4
05;2021-04-03;550;182;24323;7786;17.2;5.5
05;2021-04-04;350;63;24673;7849;17.4;5.5
05;2021-04-05;158;11;24831;7860;17.5;5.5
05;2021-04-06;646;269;25477;8129;18.0;5.7
05;2021-04-07;773;324;26250;8453;18.5;6.0
05;2021-04-08;734;334;26984;8787;19.0;6.2
05;2021-04-09;882;399;27866;9186;19.7;6.5
05;2021-04-10;712;385;28578;9571;20.2;6.8
05;2021-04-11;190;174;28768;9745;20.3;6.9
05;2021-04-12;732;258;29500;10003;20.8;7.1
05;2021-04-13;921;227;30421;10230;21.5;7.2
05;2021-04-14;665;326;31086;10556;21.9;7.4
05;2021-04-15;766;397;31852;10953;22.5;7.7
05;2021-04-16;730;411;32582;11364;23.0;8.0
05;2021-04-17;669;236;33251;11600;23.5;8.2
05;2021-04-18;305;23;33556;11623;23.7;8.2
05;2021-04-19;363;537;33919;12160;23.9;8.6
05;2021-04-20;482;630;34401;12790;24.3;9.0
05;2021-04-21;494;629;34895;13419;24.6;9.5
05;2021-04-22;385;546;35280;13965;24.9;9.9
05;2021-04-23;522;649;35802;14614;25.3;10.3
05;2021-04-24;346;383;36148;14997;25.5;10.6
05;2021-04-25;288;23;36436;15020;25.7;10.6
05;2021-04-26;365;706;36801;15726;26.0;11.1
05;2021-04-27;657;750;37458;16476;26.4;11.6
05;2021-04-28;468;719;37926;17195;26.8;12.1
05;2021-04-29;703;749;38629;17944;27.3;12.7
05;2021-04-30;508;752;39137;18696;27.6;13.2
05;2021-05-01;138;110;39275;18806;27.7;13.3
05;2021-05-02;266;115;39541;18921;27.9;13.3
05;2021-05-03;457;495;39998;19416;28.2;13.7
05;2021-05-04;384;502;40382;19918;28.5;14.1
05;2021-05-05;462;670;40844;20588;28.8;14.5
05;2021-05-06;647;718;41491;21306;29.3;15.0
05;2021-05-07;595;802;42086;22108;29.7;15.6
05;2021-05-08;481;174;42567;22282;30.0;15.7
05;2021-05-09;208;57;42775;22339;30.2;15.8
05;2021-05-10;498;693;43273;23032;30.5;16.2
05;2021-05-11;669;912;43942;23944;31.0;16.9
05;2021-05-12;647;734;44589;24678;31.5;17.4
05;2021-05-13;959;114;45548;24792;32.1;17.5
05;2021-05-14;826;491;46374;25283;32.7;17.8
05;2021-05-15;1043;354;47417;25637;33.4;18.1
05;2021-05-16;235;52;47652;25689;33.6;18.1
05;2021-05-17;484;431;48136;26120;34.0;18.4
05;2021-05-18;516;419;48652;26539;34.3;18.7
05;2021-05-19;724;457;49376;26996;34.8;19.0
05;2021-05-20;747;434;50123;27430;35.4;19.4
05;2021-05-21;705;511;50828;27941;35.9;19.7
05;2021-05-22;606;238;51434;28179;36.3;19.9
05;2021-05-23;277;59;51711;28238;36.5;19.9
05;2021-05-24;508;157;52219;28395;36.8;20.0
05;2021-05-25;514;482;52733;28877;37.2;20.4
05;2021-05-26;694;360;53427;29237;37.7;20.6
05;2021-05-27;799;571;54226;29808;38.3;21.0
05;2021-05-28;664;646;54890;30454;38.7;21.5
05;2021-05-29;566;546;55456;31000;39.1;21.9
05;2021-05-30;212;82;55668;31082;39.3;21.9
05;2021-05-31;575;496;56243;31578;39.7;22.3
05;2021-06-01;589;584;56832;32162;40.1;22.7
05;2021-06-02;684;703;57516;32865;40.6;23.2
05;2021-06-03;714;650;58230;33515;41.1;23.6
05;2021-06-04;1017;816;59247;34331;41.8;24.2
05;2021-06-05;807;505;60054;34836;42.4;24.6
05;2021-06-06;200;88;60254;34924;42.5;24.6
05;2021-06-07;605;834;60859;35758;42.9;25.2
05;2021-06-08;697;656;61556;36414;43.4;25.7
05;2021-06-09;649;783;62205;37197;43.9;26.2
05;2021-06-10;543;718;62748;37915;44.3;26.7
05;2021-06-11;763;721;63511;38636;44.8;27.3
05;2021-06-12;589;485;64100;39121;45.2;27.6
05;2021-06-13;112;91;64212;39212;45.3;27.7
05;2021-06-14;401;668;64613;39880;45.6;28.1
05;2021-06-15;543;912;65156;40792;46.0;28.8
05;2021-06-16;433;672;65589;41464;46.3;29.3
05;2021-06-17;359;802;65948;42266;46.5;29.8
05;2021-06-18;396;724;66344;42990;46.8;30.3
05;2021-06-19;421;572;66765;43562;47.1;30.7
05;2021-06-20;62;77;66827;43639;47.1;30.8
05;2021-06-21;319;642;67146;44281;47.4;31.2
05;2021-06-22;355;829;67501;45110;47.6;31.8
05;2021-06-23;354;761;67855;45871;47.9;32.4
05;2021-06-24;386;1019;68241;46890;48.1;33.1
05;2021-06-25;227;894;68468;47784;48.3;33.7
05;2021-06-26;291;1074;68759;48858;48.5;34.5
05;2021-06-27;128;170;68887;49028;48.6;34.6
05;2021-06-28;253;792;69140;49820;48.8;35.1
05;2021-06-29;250;785;69390;50605;49.0;35.7
05;2021-06-30;327;789;69717;51394;49.2;36.3
05;2021-07-01;381;791;70098;52185;49.4;36.8
05;2021-07-02;369;870;70467;53055;49.7;37.4
05;2021-07-03;302;740;70769;53795;49.9;37.9
05;2021-07-04;178;176;70947;53971;50.0;38.1
05;2021-07-05;264;782;71211;54753;50.2;38.6
05;2021-07-06;333;859;71544;55612;50.5;39.2
05;2021-07-07;395;782;71939;56394;50.7;39.8
05;2021-07-08;430;850;72369;57244;51.1;40.4
05;2021-07-09;421;999;72790;58243;51.3;41.1
05;2021-07-10;312;728;73102;58971;51.6;41.6
05;2021-07-11;174;119;73276;59090;51.7;41.7
05;2021-07-12;413;1013;73689;60103;52.0;42.4
05;2021-07-13;479;873;74168;60976;52.3;43.0
05;2021-07-14;837;299;75005;61275;52.9;43.2
05;2021-07-15;707;994;75712;62269;53.4;43.9
05;2021-07-16;1020;1449;76732;63718;54.1;44.9
05;2021-07-17;671;1301;77403;65019;54.6;45.9
05;2021-07-18;284;126;77687;65145;54.8;46.0
05;2021-07-19;566;794;78253;65939;55.2;46.5
05;2021-07-20;753;802;79006;66741;55.7;47.1
05;2021-07-21;878;843;79884;67584;56.4;47.7
05;2021-07-22;805;867;80689;68451;56.9;48.3
05;2021-07-23;1442;1230;82131;69681;57.9;49.2
05;2021-07-24;855;829;82986;70510;58.5;49.7
05;2021-07-25;305;159;83291;70669;58.8;49.9
05;2021-07-26;771;558;84062;71227;59.3;50.2
05;2021-07-27;1253;745;85315;71972;60.2;50.8
05;2021-07-28;1513;710;86828;72682;61.3;51.3
05;2021-07-29;1344;717;88172;73399;62.2;51.8
05;2021-07-30;956;592;89128;73991;62.9;52.2
05;2021-07-31;779;518;89907;74509;63.4;52.6
05;2021-08-01;192;175;90099;74684;63.6;52.7
05;2021-08-02;827;542;90926;75226;64.1;53.1
05;2021-08-03;825;598;91751;75824;64.7;53.5
05;2021-08-04;983;749;92734;76573;65.4;54.0
05;2021-08-05;977;713;93711;77286;66.1;54.5
06;2020-12-27;3;0;3;0;0.0;0.0
06;2020-12-28;3;0;6;0;0.0;0.0
06;2020-12-29;3;0;9;0;0.0;0.0
06;2020-12-30;6;0;15;0;0.0;0.0
06;2020-12-31;22;0;37;0;0.0;0.0
06;2021-01-01;14;0;51;0;0.0;0.0
06;2021-01-02;4;0;55;0;0.0;0.0
06;2021-01-03;3;0;58;0;0.0;0.0
06;2021-01-04;140;1;198;1;0.0;0.0
06;2021-01-05;177;1;375;2;0.0;0.0
06;2021-01-06;218;0;593;2;0.1;0.0
06;2021-01-07;500;0;1093;2;0.1;0.0
06;2021-01-08;666;2;1759;4;0.2;0.0
06;2021-01-09;391;2;2150;6;0.2;0.0
06;2021-01-10;74;0;2224;6;0.2;0.0
06;2021-01-11;1132;0;3356;6;0.3;0.0
06;2021-01-12;2208;4;5564;10;0.5;0.0
06;2021-01-13;1733;6;7297;16;0.7;0.0
06;2021-01-14;2080;16;9377;32;0.9;0.0
06;2021-01-15;1864;5;11241;37;1.0;0.0
06;2021-01-16;973;4;12214;41;1.1;0.0
06;2021-01-17;232;0;12446;41;1.2;0.0
06;2021-01-18;2459;7;14905;48;1.4;0.0
06;2021-01-19;2739;8;17644;56;1.6;0.0
06;2021-01-20;3330;7;20974;63;1.9;0.0
06;2021-01-21;3012;26;23986;89;2.2;0.0
06;2021-01-22;2862;14;26848;103;2.5;0.0
06;2021-01-23;1297;3;28145;106;2.6;0.0
06;2021-01-24;29;0;28174;106;2.6;0.0
06;2021-01-25;2057;15;30231;121;2.8;0.0
06;2021-01-26;3379;38;33610;159;3.1;0.0
06;2021-01-27;2540;101;36150;260;3.3;0.0
06;2021-01-28;2800;201;38950;461;3.6;0.0
06;2021-01-29;2491;311;41441;772;3.8;0.1
06;2021-01-30;666;43;42107;815;3.9;0.1
06;2021-01-31;2;0;42109;815;3.9;0.1
06;2021-02-01;1024;481;43133;1296;4.0;0.1
06;2021-02-02;1497;414;44630;1710;4.1;0.2
06;2021-02-03;330;136;44960;1846;4.2;0.2
06;2021-02-04;711;896;45671;2742;4.2;0.3
06;2021-02-05;1011;1117;46682;3859;4.3;0.4
06;2021-02-06;152;462;46834;4321;4.3;0.4
06;2021-02-07;6;49;46840;4370;4.3;0.4
06;2021-02-08;526;1089;47366;5459;4.4;0.5
06;2021-02-09;309;739;47675;6198;4.4;0.6
06;2021-02-10;368;666;48043;6864;4.5;0.6
06;2021-02-11;468;1073;48511;7937;4.5;0.7
06;2021-02-12;652;1314;49163;9251;4.6;0.9
06;2021-02-13;206;525;49369;9776;4.6;0.9
06;2021-02-14;5;2;49374;9778;4.6;0.9
06;2021-02-15;462;1283;49836;11061;4.6;1.0
06;2021-02-16;864;2032;50700;13093;4.7;1.2
06;2021-02-17;823;2155;51523;15248;4.8;1.4
06;2021-02-18;1797;2711;53320;17959;4.9;1.7
06;2021-02-19;1760;2152;55080;20111;5.1;1.9
06;2021-02-20;276;528;55356;20639;5.1;1.9
06;2021-02-21;21;55;55377;20694;5.1;1.9
06;2021-02-22;1077;1628;56454;22322;5.2;2.1
06;2021-02-23;1745;1562;58199;23884;5.4;2.2
06;2021-02-24;2103;1299;60302;25183;5.6;2.3
06;2021-02-25;3831;1717;64133;26900;5.9;2.5
06;2021-02-26;3389;1609;67522;28509;6.3;2.6
06;2021-02-27;1422;329;68944;28838;6.4;2.7
06;2021-02-28;84;23;69028;28861;6.4;2.7
06;2021-03-01;2397;816;71425;29677;6.6;2.7
06;2021-03-02;2449;987;73874;30664;6.8;2.8
06;2021-03-03;2836;565;76710;31229;7.1;2.9
06;2021-03-04;4598;606;81308;31835;7.5;2.9
06;2021-03-05;3889;1020;85197;32855;7.9;3.0
06;2021-03-06;11889;338;97086;33193;9.0;3.1
06;2021-03-07;10162;285;107248;33478;9.9;3.1
06;2021-03-08;4135;1190;111383;34668;10.3;3.2
06;2021-03-09;4949;918;116332;35586;10.8;3.3
06;2021-03-10;4675;829;121007;36415;11.2;3.4
06;2021-03-11;6704;881;127711;37296;11.8;3.5
06;2021-03-12;6846;991;134557;38287;12.5;3.5
06;2021-03-13;11193;329;145750;38616;13.5;3.6
06;2021-03-14;497;48;146247;38664;13.5;3.6
06;2021-03-15;4814;758;151061;39422;14.0;3.7
06;2021-03-16;3732;1044;154793;40466;14.3;3.7
06;2021-03-17;6188;1874;160981;42340;14.9;3.9
06;2021-03-18;5104;1816;166085;44156;15.4;4.1
06;2021-03-19;6798;2008;172883;46164;16.0;4.3
06;2021-03-20;2364;559;175247;46723;16.2;4.3
06;2021-03-21;404;23;175651;46746;16.3;4.3
06;2021-03-22;3949;686;179600;47432;16.6;4.4
06;2021-03-23;5964;1198;185564;48630;17.2;4.5
06;2021-03-24;4203;3325;189767;51955;17.6;4.8
06;2021-03-25;5836;3228;195603;55183;18.1;5.1
06;2021-03-26;6336;1989;201939;57172;18.7;5.3
06;2021-03-27;2031;366;203970;57538;18.9;5.3
06;2021-03-28;205;3;204175;57541;18.9;5.3
06;2021-03-29;3188;2082;207363;59623;19.2;5.5
06;2021-03-30;5179;2528;212542;62151;19.7;5.8
06;2021-03-31;8007;1628;220549;63779;20.4;5.9
06;2021-04-01;7615;2439;228164;66218;21.1;6.1
06;2021-04-02;7205;2689;235369;68907;21.8;6.4
06;2021-04-03;2712;1365;238081;70272;22.1;6.5
06;2021-04-04;297;548;238378;70820;22.1;6.6
06;2021-04-05;1390;690;239768;71510;22.2;6.6
06;2021-04-06;6632;3297;246400;74807;22.8;6.9
06;2021-04-07;6204;3875;252604;78682;23.4;7.3
06;2021-04-08;5721;5631;258325;84313;23.9;7.8
06;2021-04-09;9319;5813;267644;90126;24.8;8.3
06;2021-04-10;2390;2784;270034;92910;25.0;8.6
06;2021-04-11;178;56;270212;92966;25.0;8.6
06;2021-04-12;4364;3520;274576;96486;25.4;8.9
06;2021-04-13;6321;5105;280897;101591;26.0;9.4
06;2021-04-14;5441;4472;286338;106063;26.5;9.8
06;2021-04-15;5529;4369;291867;110432;27.0;10.2
06;2021-04-16;7049;5169;298916;115601;27.7;10.7
06;2021-04-17;2774;3051;301690;118652;27.9;11.0
06;2021-04-18;260;223;301950;118875;28.0;11.0
06;2021-04-19;5466;4037;307416;122912;28.5;11.4
06;2021-04-20;5624;4836;313040;127748;29.0;11.8
06;2021-04-21;8287;4137;321327;131885;29.8;12.2
06;2021-04-22;8547;4160;329874;136045;30.6;12.6
06;2021-04-23;8731;4173;338605;140218;31.4;13.0
06;2021-04-24;2334;1476;340939;141694;31.6;13.1
06;2021-04-25;119;28;341058;141722;31.6;13.1
06;2021-04-26;4132;2297;345190;144019;32.0;13.3
06;2021-04-27;4562;4002;349752;148021;32.4;13.7
06;2021-04-28;4128;4551;353880;152572;32.8;14.1
06;2021-04-29;6056;5433;359936;158005;33.3;14.6
06;2021-04-30;6743;5143;366679;163148;34.0;15.1
06;2021-05-01;4138;803;370817;163951;34.4;15.2
06;2021-05-02;487;157;371304;164108;34.4;15.2
06;2021-05-03;6872;3507;378176;167615;35.0;15.5
06;2021-05-04;5727;5356;383903;172971;35.6;16.0
06;2021-05-05;4520;3900;388423;176871;36.0;16.4
06;2021-05-06;5204;4702;393627;181573;36.5;16.8
06;2021-05-07;5642;5651;399269;187224;37.0;17.3
06;2021-05-08;4840;1295;404109;188519;37.4;17.5
06;2021-05-09;192;307;404301;188826;37.5;17.5
06;2021-05-10;4802;5033;409103;193859;37.9;18.0
06;2021-05-11;4909;5537;414012;199396;38.4;18.5
06;2021-05-12;9044;4834;423056;204230;39.2;18.9
06;2021-05-13;9235;2083;432291;206313;40.0;19.1
06;2021-05-14;10813;3291;443104;209604;41.1;19.4
06;2021-05-15;9205;2183;452309;211787;41.9;19.6
06;2021-05-16;1495;285;453804;212072;42.0;19.6
06;2021-05-17;7475;3733;461279;215805;42.7;20.0
06;2021-05-18;9698;3154;470977;218959;43.6;20.3
06;2021-05-19;7662;2914;478639;221873;44.3;20.6
06;2021-05-20;7826;3633;486465;225506;45.1;20.9
06;2021-05-21;8770;3886;495235;229392;45.9;21.3
06;2021-05-22;3022;1319;498257;230711;46.2;21.4
06;2021-05-23;129;628;498386;231339;46.2;21.4
06;2021-05-24;3174;993;501560;232332;46.5;21.5
06;2021-05-25;4756;4931;506316;237263;46.9;22.0
06;2021-05-26;5646;6577;511962;243840;47.4;22.6
06;2021-05-27;5548;6259;517510;250099;47.9;23.2
06;2021-05-28;4977;7263;522487;257362;48.4;23.8
06;2021-05-29;1627;2935;524114;260297;48.6;24.1
06;2021-05-30;256;1124;524370;261421;48.6;24.2
06;2021-05-31;4391;5089;528761;266510;49.0;24.7
06;2021-06-01;5698;7379;534459;273889;49.5;25.4
06;2021-06-02;3297;8543;537756;282432;49.8;26.2
06;2021-06-03;4519;8301;542275;290733;50.2;26.9
06;2021-06-04;5467;7729;547742;298462;50.7;27.7
06;2021-06-05;2448;3344;550190;301806;51.0;28.0
06;2021-06-06;175;235;550365;302041;51.0;28.0
06;2021-06-07;4133;5586;554498;307627;51.4;28.5
06;2021-06-08;4456;5172;558954;312799;51.8;29.0
06;2021-06-09;4079;7343;563033;320142;52.2;29.7
06;2021-06-10;4696;6845;567729;326987;52.6;30.3
06;2021-06-11;3871;8355;571600;335342;53.0;31.1
06;2021-06-12;1733;3745;573333;339087;53.1;31.4
06;2021-06-13;143;437;573476;339524;53.1;31.5
06;2021-06-14;2701;8586;576177;348110;53.4;32.3
06;2021-06-15;3225;9473;579402;357583;53.7;33.1
06;2021-06-16;3485;6989;582887;364572;54.0;33.8
06;2021-06-17;3636;7165;586523;371737;54.3;34.4
06;2021-06-18;2609;5924;589132;377661;54.6;35.0
06;2021-06-19;1292;1674;590424;379335;54.7;35.1
06;2021-06-20;206;345;590630;379680;54.7;35.2
06;2021-06-21;1698;6291;592328;385971;54.9;35.8
06;2021-06-22;2338;7359;594666;393330;55.1;36.4
06;2021-06-23;2060;6539;596726;399869;55.3;37.0
06;2021-06-24;3433;8957;600159;408826;55.6;37.9
06;2021-06-25;2278;9602;602437;418428;55.8;38.8
06;2021-06-26;884;2282;603321;420710;55.9;39.0
06;2021-06-27;375;1185;603696;421895;55.9;39.1
06;2021-06-28;2457;8123;606153;430018;56.2;39.8
06;2021-06-29;2341;7712;608494;437730;56.4;40.6
06;2021-06-30;1351;7683;609845;445413;56.5;41.3
06;2021-07-01;3302;7459;613147;452872;56.8;42.0
06;2021-07-02;3969;8209;617116;461081;57.2;42.7
06;2021-07-03;1210;4306;618326;465387;57.3;43.1
06;2021-07-04;307;298;618633;465685;57.3;43.1
06;2021-07-05;3558;5118;622191;470803;57.6;43.6
06;2021-07-06;1902;5822;624093;476625;57.8;44.2
06;2021-07-07;3372;5961;627465;482586;58.1;44.7
06;2021-07-08;3421;6298;630886;488884;58.4;45.3
06;2021-07-09;3895;6215;634781;495099;58.8;45.9
06;2021-07-10;1660;2327;636441;497426;59.0;46.1
06;2021-07-11;321;323;636762;497749;59.0;46.1
06;2021-07-12;3791;7130;640553;504879;59.3;46.8
06;2021-07-13;5739;8978;646292;513857;59.9;47.6
06;2021-07-14;950;427;647242;514284;60.0;47.6
06;2021-07-15;6319;7985;653561;522269;60.5;48.4
06;2021-07-16;7248;8979;660809;531248;61.2;49.2
06;2021-07-17;3060;5450;663869;536698;61.5;49.7
06;2021-07-18;1047;5328;664916;542026;61.6;50.2
06;2021-07-19;5614;7992;670530;550018;62.1;51.0
06;2021-07-20;7097;10203;677627;560221;62.8;51.9
06;2021-07-21;7553;8646;685180;568867;63.5;52.7
06;2021-07-22;9838;7772;695018;576639;64.4;53.4
06;2021-07-23;8890;6815;703908;583454;65.2;54.1
06;2021-07-24;3189;3205;707097;586659;65.5;54.4
06;2021-07-25;972;473;708069;587132;65.6;54.4
06;2021-07-26;6964;6808;715033;593940;66.2;55.0
06;2021-07-27;8652;5474;723685;599414;67.0;55.5
06;2021-07-28;7020;5332;730705;604746;67.7;56.0
06;2021-07-29;8285;5653;738990;610399;68.5;56.6
06;2021-07-30;7720;5398;746710;615797;69.2;57.1
06;2021-07-31;3460;3047;750170;618844;69.5;57.3
06;2021-08-01;711;425;750881;619269;69.6;57.4
06;2021-08-02;5638;4518;756519;623787;70.1;57.8
06;2021-08-03;6021;5377;762540;629164;70.6;58.3
06;2021-08-04;5218;3429;767758;632593;71.1;58.6
06;2021-08-05;5597;4303;773355;636896;71.6;59.0
07;2020-12-27;0;0;0;0;0.0;0.0
07;2020-12-28;0;0;0;0;0.0;0.0
07;2020-12-29;0;0;0;0;0.0;0.0
07;2020-12-30;0;0;0;0;0.0;0.0
07;2020-12-31;0;0;0;0;0.0;0.0
07;2021-01-01;7;0;7;0;0.0;0.0
07;2021-01-02;0;0;7;0;0.0;0.0
07;2021-01-03;0;0;7;0;0.0;0.0
07;2021-01-04;0;0;7;0;0.0;0.0
07;2021-01-05;0;0;7;0;0.0;0.0
07;2021-01-06;31;0;38;0;0.0;0.0
07;2021-01-07;130;1;168;1;0.1;0.0
07;2021-01-08;45;1;213;2;0.1;0.0
07;2021-01-09;17;0;230;2;0.1;0.0
07;2021-01-10;0;0;230;2;0.1;0.0
07;2021-01-11;157;1;387;3;0.1;0.0
07;2021-01-12;308;0;695;3;0.2;0.0
07;2021-01-13;304;1;999;4;0.3;0.0
07;2021-01-14;478;0;1477;4;0.5;0.0
07;2021-01-15;187;0;1664;4;0.5;0.0
07;2021-01-16;17;0;1681;4;0.5;0.0
07;2021-01-17;2;0;1683;4;0.5;0.0
07;2021-01-18;363;1;2046;5;0.6;0.0
07;2021-01-19;830;1;2876;6;0.9;0.0
07;2021-01-20;596;1;3472;7;1.1;0.0
07;2021-01-21;451;2;3923;9;1.2;0.0
07;2021-01-22;291;0;4214;9;1.3;0.0
07;2021-01-23;107;0;4321;9;1.3;0.0
07;2021-01-24;0;0;4321;9;1.3;0.0
07;2021-01-25;164;0;4485;9;1.4;0.0
07;2021-01-26;491;1;4976;10;1.5;0.0
07;2021-01-27;553;7;5529;17;1.7;0.0
07;2021-01-28;1205;100;6734;117;2.1;0.0
07;2021-01-29;706;17;7440;134;2.3;0.0
07;2021-01-30;213;4;7653;138;2.3;0.0
07;2021-01-31;7;0;7660;138;2.3;0.0
07;2021-02-01;267;32;7927;170;2.4;0.1
07;2021-02-02;662;241;8589;411;2.6;0.1
07;2021-02-03;1044;222;9633;633;2.9;0.2
07;2021-02-04;719;262;10352;895;3.2;0.3
07;2021-02-05;483;255;10835;1150;3.3;0.4
07;2021-02-06;97;2;10932;1152;3.3;0.4
07;2021-02-07;12;1;10944;1153;3.3;0.4
07;2021-02-08;239;179;11183;1332;3.4;0.4
07;2021-02-09;485;326;11668;1658;3.6;0.5
07;2021-02-10;537;396;12205;2054;3.7;0.6
07;2021-02-11;400;284;12605;2338;3.9;0.7
07;2021-02-12;268;160;12873;2498;3.9;0.8
07;2021-02-13;69;20;12942;2518;4.0;0.8
07;2021-02-14;0;0;12942;2518;4.0;0.8
07;2021-02-15;270;131;13212;2649;4.0;0.8
07;2021-02-16;346;365;13558;3014;4.1;0.9
07;2021-02-17;466;334;14024;3348;4.3;1.0
07;2021-02-18;561;767;14585;4115;4.5;1.3
07;2021-02-19;455;505;15040;4620;4.6;1.4
07;2021-02-20;108;68;15148;4688;4.6;1.4
07;2021-02-21;15;0;15163;4688;4.6;1.4
07;2021-02-22;423;216;15586;4904;4.8;1.5
07;2021-02-23;645;617;16231;5521;5.0;1.7
07;2021-02-24;927;702;17158;6223;5.2;1.9
07;2021-02-25;709;535;17867;6758;5.5;2.1
07;2021-02-26;844;294;18711;7052;5.7;2.2
07;2021-02-27;190;144;18901;7196;5.8;2.2
07;2021-02-28;1;0;18902;7196;5.8;2.2
07;2021-03-01;436;216;19338;7412;5.9;2.3
07;2021-03-02;654;565;19992;7977;6.1;2.4
07;2021-03-03;690;534;20682;8511;6.3;2.6
07;2021-03-04;1098;357;21780;8868;6.7;2.7
07;2021-03-05;1083;369;22863;9237;7.0;2.8
07;2021-03-06;1124;91;23987;9328;7.3;2.9
07;2021-03-07;717;20;24704;9348;7.6;2.9
07;2021-03-08;349;315;25053;9663;7.7;3.0
07;2021-03-09;1087;431;26140;10094;8.0;3.1
07;2021-03-10;860;513;27000;10607;8.3;3.2
07;2021-03-11;1369;463;28369;11070;8.7;3.4
07;2021-03-12;1613;561;29982;11631;9.2;3.6
07;2021-03-13;679;100;30661;11731;9.4;3.6
07;2021-03-14;4;0;30665;11731;9.4;3.6
07;2021-03-15;526;293;31191;12024;9.5;3.7
07;2021-03-16;1204;480;32395;12504;9.9;3.8
07;2021-03-17;1187;780;33582;13284;10.3;4.1
07;2021-03-18;1219;410;34801;13694;10.6;4.2
07;2021-03-19;1269;421;36070;14115;11.0;4.3
07;2021-03-20;467;106;36537;14221;11.2;4.4
07;2021-03-21;3;2;36540;14223;11.2;4.4
07;2021-03-22;790;535;37330;14758;11.4;4.5
07;2021-03-23;1513;717;38843;15475;11.9;4.7
07;2021-03-24;1272;661;40115;16136;12.3;4.9
07;2021-03-25;1847;509;41962;16645;12.8;5.1
07;2021-03-26;1834;432;43796;17077;13.4;5.2
07;2021-03-27;384;99;44180;17176;13.5;5.3
07;2021-03-28;6;1;44186;17177;13.5;5.3
07;2021-03-29;785;353;44971;17530;13.8;5.4
07;2021-03-30;1524;510;46495;18040;14.2;5.5
07;2021-03-31;1655;497;48150;18537;14.7;5.7
07;2021-04-01;1578;656;49728;19193;15.2;5.9
07;2021-04-02;1522;428;51250;19621;15.7;6.0
07;2021-04-03;228;105;51478;19726;15.7;6.0
07;2021-04-04;1;1;51479;19727;15.7;6.0
07;2021-04-05;0;66;51479;19793;15.7;6.1
07;2021-04-06;1161;755;52640;20548;16.1;6.3
07;2021-04-07;1317;892;53957;21440;16.5;6.6
07;2021-04-08;1971;1173;55928;22613;17.1;6.9
07;2021-04-09;2423;566;58351;23179;17.9;7.1
07;2021-04-10;808;157;59159;23336;18.1;7.1
07;2021-04-11;339;13;59498;23349;18.2;7.1
07;2021-04-12;1276;586;60774;23935;18.6;7.3
07;2021-04-13;1765;1329;62539;25264;19.1;7.7
07;2021-04-14;1672;979;64211;26243;19.6;8.0
07;2021-04-15;1443;841;65654;27084;20.1;8.3
07;2021-04-16;1506;898;67160;27982;20.5;8.6
07;2021-04-17;868;212;68028;28194;20.8;8.6
07;2021-04-18;700;35;68728;28229;21.0;8.6
07;2021-04-19;1161;571;69889;28800;21.4;8.8
07;2021-04-20;1440;1317;71329;30117;21.8;9.2
07;2021-04-21;1714;914;73043;31031;22.3;9.5
07;2021-04-22;1816;960;74859;31991;22.9;9.8
07;2021-04-23;1410;970;76269;32961;23.3;10.1
07;2021-04-24;959;249;77228;33210;23.6;10.2
07;2021-04-25;716;67;77944;33277;23.8;10.2
07;2021-04-26;1138;682;79082;33959;24.2;10.4
07;2021-04-27;1394;1566;80476;35525;24.6;10.9
07;2021-04-28;1634;1749;82110;37274;25.1;11.4
07;2021-04-29;1938;1532;84048;38806;25.7;11.9
07;2021-04-30;1660;1479;85708;40285;26.2;12.3
07;2021-05-01;960;113;86668;40398;26.5;12.4
07;2021-05-02;845;154;87513;40552;26.8;12.4
07;2021-05-03;1282;432;88795;40984;27.2;12.5
07;2021-05-04;2170;1558;90965;42542;27.8;13.0
07;2021-05-05;1744;1384;92709;43926;28.4;13.4
07;2021-05-06;2104;1586;94813;45512;29.0;13.9
07;2021-05-07;1593;1553;96406;47065;29.5;14.4
07;2021-05-08;1224;406;97630;47471;29.9;14.5
07;2021-05-09;1030;327;98660;47798;30.2;14.6
07;2021-05-10;1403;1174;100063;48972;30.6;15.0
07;2021-05-11;2473;1699;102536;50671;31.4;15.5
07;2021-05-12;2163;1276;104699;51947;32.0;15.9
07;2021-05-13;1711;270;106410;52217;32.6;16.0
07;2021-05-14;1732;998;108142;53215;33.1;16.3
07;2021-05-15;1627;498;109769;53713;33.6;16.4
07;2021-05-16;1442;211;111211;53924;34.0;16.5
07;2021-05-17;1772;857;112983;54781;34.6;16.8
07;2021-05-18;2294;1304;115277;56085;35.3;17.2
07;2021-05-19;2376;995;117653;57080;36.0;17.5
07;2021-05-20;2161;1310;119814;58390;36.7;17.9
07;2021-05-21;1758;1316;121572;59706;37.2;18.3
07;2021-05-22;937;544;122509;60250;37.5;18.4
07;2021-05-23;858;156;123367;60406;37.7;18.5
07;2021-05-24;1650;341;125017;60747;38.2;18.6
07;2021-05-25;2187;1479;127204;62226;38.9;19.0
07;2021-05-26;1527;1381;128731;63607;39.4;19.5
07;2021-05-27;2020;1406;130751;65013;40.0;19.9
07;2021-05-28;1769;2081;132520;67094;40.5;20.5
07;2021-05-29;943;683;133463;67777;40.8;20.7
07;2021-05-30;623;570;134086;68347;41.0;20.9
07;2021-05-31;1132;1285;135218;69632;41.4;21.3
07;2021-06-01;2155;2005;137373;71637;42.0;21.9
07;2021-06-02;1530;1653;138903;73290;42.5;22.4
07;2021-06-03;1710;1259;140613;74549;43.0;22.8
07;2021-06-04;1675;1595;142288;76144;43.5;23.3
07;2021-06-05;988;955;143276;77099;43.8;23.6
07;2021-06-06;598;623;143874;77722;44.0;23.8
07;2021-06-07;959;1195;144833;78917;44.3;24.1
07;2021-06-08;1548;1770;146381;80687;44.8;24.7
07;2021-06-09;1030;1422;147411;82109;45.1;25.1
07;2021-06-10;789;1391;148200;83500;45.3;25.5
07;2021-06-11;1154;2036;149354;85536;45.7;26.2
07;2021-06-12;643;1218;149997;86754;45.9;26.5
07;2021-06-13;393;444;150390;87198;46.0;26.7
07;2021-06-14;566;1964;150956;89162;46.2;27.3
07;2021-06-15;933;2553;151889;91715;46.5;28.1
07;2021-06-16;1021;1852;152910;93567;46.8;28.6
07;2021-06-17;885;1950;153795;95517;47.1;29.2
07;2021-06-18;873;2285;154668;97802;47.3;29.9
07;2021-06-19;606;1456;155274;99258;47.5;30.4
07;2021-06-20;369;729;155643;99987;47.6;30.6
07;2021-06-21;517;2144;156160;102131;47.8;31.2
07;2021-06-22;654;2663;156814;104794;48.0;32.1
07;2021-06-23;677;1960;157491;106754;48.2;32.7
07;2021-06-24;646;1855;158137;108609;48.4;33.2
07;2021-06-25;701;2177;158838;110786;48.6;33.9
07;2021-06-26;359;1429;159197;112215;48.7;34.3
07;2021-06-27;284;1072;159481;113287;48.8;34.7
07;2021-06-28;503;2241;159984;115528;48.9;35.3
07;2021-06-29;540;2989;160524;118517;49.1;36.3
07;2021-06-30;822;2289;161346;120806;49.4;37.0
07;2021-07-01;772;1977;162118;122783;49.6;37.6
07;2021-07-02;879;2303;162997;125086;49.9;38.3
07;2021-07-03;420;1140;163417;126226;50.0;38.6
07;2021-07-04;210;853;163627;127079;50.1;38.9
07;2021-07-05;670;1684;164297;128763;50.3;39.4
07;2021-07-06;877;2637;165174;131400;50.5;40.2
07;2021-07-07;963;1946;166137;133346;50.8;40.8
07;2021-07-08;926;1968;167063;135314;51.1;41.4
07;2021-07-09;995;2264;168058;137578;51.4;42.1
07;2021-07-10;597;1103;168655;138681;51.6;42.4
07;2021-07-11;237;614;168892;139295;51.7;42.6
07;2021-07-12;804;1769;169696;141064;51.9;43.2
07;2021-07-13;1759;3172;171455;144236;52.5;44.1
07;2021-07-14;166;133;171621;144369;52.5;44.2
07;2021-07-15;1942;2453;173563;146822;53.1;44.9
07;2021-07-16;2049;1980;175612;148802;53.7;45.5
07;2021-07-17;1479;1244;177091;150046;54.2;45.9
07;2021-07-18;770;484;177861;150530;54.4;46.1
07;2021-07-19;1512;1707;179373;152237;54.9;46.6
07;2021-07-20;2453;2663;181826;154900;55.6;47.4
07;2021-07-21;1846;1910;183672;156810;56.2;48.0
07;2021-07-22;1909;1367;185581;158177;56.8;48.4
07;2021-07-23;2251;1683;187832;159860;57.5;48.9
07;2021-07-24;1630;1099;189462;160959;58.0;49.2
07;2021-07-25;32;21;189494;160980;58.0;49.2
07;2021-07-26;2184;1539;191678;162519;58.6;49.7
07;2021-07-27;2962;1897;194640;164416;59.5;50.3
07;2021-07-28;1624;1295;196264;165711;60.0;50.7
07;2021-07-29;2522;1264;198786;166975;60.8;51.1
07;2021-07-30;1342;1417;200128;168392;61.2;51.5
07;2021-07-31;1489;919;201617;169311;61.7;51.8
07;2021-08-01;73;26;201690;169337;61.7;51.8
07;2021-08-02;1437;1126;203127;170463;62.1;52.1
07;2021-08-03;2388;1895;205515;172358;62.9;52.7
07;2021-08-04;1927;1015;207442;173373;63.5;53.0
07;2021-08-05;1858;1277;209300;174650;64.0;53.4
08;2020-12-27;1;0;1;0;0.0;0.0
08;2020-12-28;0;0;1;0;0.0;0.0
08;2020-12-29;0;0;1;0;0.0;0.0
08;2020-12-30;0;0;1;0;0.0;0.0
08;2020-12-31;0;0;1;0;0.0;0.0
08;2021-01-01;0;0;1;0;0.0;0.0
08;2021-01-02;0;0;1;0;0.0;0.0
08;2021-01-03;2;0;3;0;0.0;0.0
08;2021-01-04;24;0;27;0;0.0;0.0
08;2021-01-05;1;0;28;0;0.0;0.0
08;2021-01-06;0;0;28;0;0.0;0.0
08;2021-01-07;188;0;216;0;0.1;0.0
08;2021-01-08;314;0;530;0;0.2;0.0
08;2021-01-09;113;0;643;0;0.2;0.0
08;2021-01-10;1;0;644;0;0.2;0.0
08;2021-01-11;67;0;711;0;0.3;0.0
08;2021-01-12;156;0;867;0;0.3;0.0
08;2021-01-13;478;1;1345;1;0.5;0.0
08;2021-01-14;534;9;1879;10;0.7;0.0
08;2021-01-15;287;2;2166;12;0.8;0.0
08;2021-01-16;106;0;2272;12;0.9;0.0
08;2021-01-17;1;0;2273;12;0.9;0.0
08;2021-01-18;370;2;2643;14;1.0;0.0
08;2021-01-19;870;1;3513;15;1.3;0.0
08;2021-01-20;910;2;4423;17;1.7;0.0
08;2021-01-21;743;1;5166;18;1.9;0.0
08;2021-01-22;678;1;5844;19;2.2;0.0
08;2021-01-23;237;0;6081;19;2.3;0.0
08;2021-01-24;0;0;6081;19;2.3;0.0
08;2021-01-25;205;0;6286;19;2.4;0.0
08;2021-01-26;302;2;6588;21;2.5;0.0
08;2021-01-27;411;0;6999;21;2.6;0.0
08;2021-01-28;565;185;7564;206;2.8;0.1
08;2021-01-29;587;182;8151;388;3.1;0.1
08;2021-01-30;222;63;8373;451;3.2;0.2
08;2021-01-31;0;0;8373;451;3.2;0.2
08;2021-02-01;80;46;8453;497;3.2;0.2
08;2021-02-02;190;174;8643;671;3.3;0.3
08;2021-02-03;140;170;8783;841;3.3;0.3
08;2021-02-04;309;287;9092;1128;3.4;0.4
08;2021-02-05;499;359;9591;1487;3.6;0.6
08;2021-02-06;148;75;9739;1562;3.7;0.6
08;2021-02-07;8;0;9747;1562;3.7;0.6
08;2021-02-08;39;174;9786;1736;3.7;0.7
08;2021-02-09;217;647;10003;2383;3.8;0.9
08;2021-02-10;334;640;10337;3023;3.9;1.1
08;2021-02-11;464;363;10801;3386;4.1;1.3
08;2021-02-12;676;388;11477;3774;4.3;1.4
08;2021-02-13;140;118;11617;3892;4.4;1.5
08;2021-02-14;3;60;11620;3952;4.4;1.5
08;2021-02-15;227;210;11847;4162;4.5;1.6
08;2021-02-16;130;377;11977;4539;4.5;1.7
08;2021-02-17;112;417;12089;4956;4.6;1.9
08;2021-02-18;215;520;12304;5476;4.6;2.1
08;2021-02-19;304;424;12608;5900;4.7;2.2
08;2021-02-20;7;208;12615;6108;4.8;2.3
08;2021-02-21;0;0;12615;6108;4.8;2.3
08;2021-02-22;132;179;12747;6287;4.8;2.4
08;2021-02-23;150;321;12897;6608;4.9;2.5
08;2021-02-24;164;390;13061;6998;4.9;2.6
08;2021-02-25;500;527;13561;7525;5.1;2.8
08;2021-02-26;603;628;14164;8153;5.3;3.1
08;2021-02-27;317;191;14481;8344;5.5;3.1
08;2021-02-28;19;1;14500;8345;5.5;3.1
08;2021-03-01;199;106;14699;8451;5.5;3.2
08;2021-03-02;654;278;15353;8729;5.8;3.3
08;2021-03-03;897;201;16250;8930;6.1;3.4
08;2021-03-04;733;330;16983;9260;6.4;3.5
08;2021-03-05;1022;539;18005;9799;6.8;3.7
08;2021-03-06;693;136;18698;9935;7.0;3.7
08;2021-03-07;75;1;18773;9936;7.1;3.7
08;2021-03-08;217;119;18990;10055;7.2;3.8
08;2021-03-09;686;136;19676;10191;7.4;3.8
08;2021-03-10;1037;117;20713;10308;7.8;3.9
08;2021-03-11;981;246;21694;10554;8.2;4.0
08;2021-03-12;1630;507;23324;11061;8.8;4.2
08;2021-03-13;794;120;24118;11181;9.1;4.2
08;2021-03-14;22;0;24140;11181;9.1;4.2
08;2021-03-15;291;72;24431;11253;9.2;4.2
08;2021-03-16;563;37;24994;11290;9.4;4.3
08;2021-03-17;802;58;25796;11348;9.7;4.3
08;2021-03-18;815;155;26611;11503;10.0;4.3
08;2021-03-19;1135;281;27746;11784;10.4;4.4
08;2021-03-20;507;17;28253;11801;10.6;4.4
08;2021-03-21;13;0;28266;11801;10.6;4.4
08;2021-03-22;367;43;28633;11844;10.8;4.5
08;2021-03-23;733;61;29366;11905;11.1;4.5
08;2021-03-24;1327;67;30693;11972;11.6;4.5
08;2021-03-25;1903;87;32596;12059;12.3;4.5
08;2021-03-26;2564;167;35160;12226;13.2;4.6
08;2021-03-27;898;121;36058;12347;13.6;4.6
08;2021-03-28;228;6;36286;12353;13.7;4.7
08;2021-03-29;260;182;36546;12535;13.8;4.7
08;2021-03-30;832;484;37378;13019;14.1;4.9
08;2021-03-31;852;529;38230;13548;14.4;5.1
08;2021-04-01;1683;446;39913;13994;15.0;5.3
08;2021-04-02;1499;516;41412;14510;15.6;5.5
08;2021-04-03;1327;196;42739;14706;16.1;5.5
08;2021-04-04;134;4;42873;14710;16.1;5.5
08;2021-04-05;17;0;42890;14710;16.2;5.5
08;2021-04-06;702;479;43592;15189;16.4;5.7
08;2021-04-07;910;702;44502;15891;16.8;6.0
08;2021-04-08;1742;518;46244;16409;17.4;6.2
08;2021-04-09;2347;716;48591;17125;18.3;6.4
08;2021-04-10;1449;218;50040;17343;18.8;6.5
08;2021-04-11;10;6;50050;17349;18.8;6.5
08;2021-04-12;671;226;50721;17575;19.1;6.6
08;2021-04-13;1307;609;52028;18184;19.6;6.8
08;2021-04-14;1281;864;53309;19048;20.1;7.2
08;2021-04-15;1607;794;54916;19842;20.7;7.5
08;2021-04-16;1873;872;56789;20714;21.4;7.8
08;2021-04-17;1112;400;57901;21114;21.8;8.0
08;2021-04-18;23;14;57924;21128;21.8;8.0
08;2021-04-19;1148;298;59072;21426;22.2;8.1
08;2021-04-20;1118;541;60190;21967;22.7;8.3
08;2021-04-21;1139;737;61329;22704;23.1;8.6
08;2021-04-22;1328;880;62657;23584;23.6;8.9
08;2021-04-23;1675;1171;64332;24755;24.2;9.3
08;2021-04-24;1323;643;65655;25398;24.7;9.6
08;2021-04-25;26;198;65681;25596;24.7;9.6
08;2021-04-26;1040;154;66721;25750;25.1;9.7
08;2021-04-27;1337;600;68058;26350;25.6;9.9
08;2021-04-28;1452;680;69510;27030;26.2;10.2
08;2021-04-29;1174;1311;70684;28341;26.6;10.7
08;2021-04-30;1769;1619;72453;29960;27.3;11.3
08;2021-05-01;1049;492;73502;30452;27.7;11.5
08;2021-05-02;626;182;74128;30634;27.9;11.5
08;2021-05-03;1169;371;75297;31005;28.4;11.7
08;2021-05-04;1328;862;76625;31867;28.9;12.0
08;2021-05-05;1567;1330;78192;33197;29.4;12.5
08;2021-05-06;1971;1654;80163;34851;30.2;13.1
08;2021-05-07;1860;2095;82023;36946;30.9;13.9
08;2021-05-08;923;765;82946;37711;31.2;14.2
08;2021-05-09;443;71;83389;37782;31.4;14.2
08;2021-05-10;1191;665;84580;38447;31.9;14.5
08;2021-05-11;1909;940;86489;39387;32.6;14.8
08;2021-05-12;1810;1236;88299;40623;33.3;15.3
08;2021-05-13;1306;619;89605;41242;33.7;15.5
08;2021-05-14;2535;1033;92140;42275;34.7;15.9
08;2021-05-15;1821;713;93961;42988;35.4;16.2
08;2021-05-16;820;102;94781;43090;35.7;16.2
08;2021-05-17;699;906;95480;43996;36.0;16.6
08;2021-05-18;1250;838;96730;44834;36.4;16.9
08;2021-05-19;1609;958;98339;45792;37.0;17.2
08;2021-05-20;2147;962;100486;46754;37.8;17.6
08;2021-05-21;2336;1276;102822;48030;38.7;18.1
08;2021-05-22;1820;761;104642;48791;39.4;18.4
08;2021-05-23;863;90;105505;48881;39.7;18.4
08;2021-05-24;714;103;106219;48984;40.0;18.4
08;2021-05-25;1455;671;107674;49655;40.6;18.7
08;2021-05-26;1514;1009;109188;50664;41.1;19.1
08;2021-05-27;2007;1147;111195;51811;41.9;19.5
08;2021-05-28;1973;1821;113168;53632;42.6;20.2
08;2021-05-29;1769;968;114937;54600;43.3;20.6
08;2021-05-30;836;102;115773;54702;43.6;20.6
08;2021-05-31;755;574;116528;55276;43.9;20.8
08;2021-06-01;1350;881;117878;56157;44.4;21.1
08;2021-06-02;1296;1196;119174;57353;44.9;21.6
08;2021-06-03;1385;1520;120559;58873;45.4;22.2
08;2021-06-04;1777;2426;122336;61299;46.1;23.1
08;2021-06-05;1177;1378;123513;62677;46.5;23.6
08;2021-06-06;907;107;124420;62784;46.9;23.6
08;2021-06-07;661;1173;125081;63957;47.1;24.1
08;2021-06-08;930;1496;126011;65453;47.5;24.6
08;2021-06-09;823;1392;126834;66845;47.8;25.2
08;2021-06-10;1717;1554;128551;68399;48.4;25.8
08;2021-06-11;1721;2210;130272;70609;49.1;26.6
08;2021-06-12;1416;1527;131688;72136;49.6;27.2
08;2021-06-13;386;598;132074;72734;49.7;27.4
08;2021-06-14;380;1303;132454;74037;49.9;27.9
08;2021-06-15;740;1554;133194;75591;50.2;28.5
08;2021-06-16;804;2056;133998;77647;50.5;29.2
08;2021-06-17;1283;1854;135281;79501;50.9;29.9
08;2021-06-18;1608;2595;136889;82096;51.6;30.9
08;2021-06-19;1324;1406;138213;83502;52.1;31.4
08;2021-06-20;117;423;138330;83925;52.1;31.6
08;2021-06-21;494;1397;138824;85322;52.3;32.1
08;2021-06-22;808;2021;139632;87343;52.6;32.9
08;2021-06-23;853;1673;140485;89016;52.9;33.5
08;2021-06-24;1038;1923;141523;90939;53.3;34.2
08;2021-06-25;1080;2734;142603;93673;53.7;35.3
08;2021-06-26;1013;1784;143616;95457;54.1;35.9
08;2021-06-27;351;644;143967;96101;54.2;36.2
08;2021-06-28;397;1320;144364;97421;54.4;36.7
08;2021-06-29;627;1470;144991;98891;54.6;37.2
08;2021-06-30;852;1688;145843;100579;54.9;37.9
08;2021-07-01;882;2196;146725;102775;55.3;38.7
08;2021-07-02;939;2644;147664;105419;55.6;39.7
08;2021-07-03;784;2142;148448;107561;55.9;40.5
08;2021-07-04;128;861;148576;108422;56.0;40.8
08;2021-07-05;103;1195;148679;109617;56.0;41.3
08;2021-07-06;424;1833;149103;111450;56.2;42.0
08;2021-07-07;365;1782;149468;113232;56.3;42.6
08;2021-07-08;714;2012;150182;115244;56.6;43.4
08;2021-07-09;732;2441;150914;117685;56.8;44.3
08;2021-07-10;651;1999;151565;119684;57.1;45.1
08;2021-07-11;238;727;151803;120411;57.2;45.3
08;2021-07-12;309;1194;152112;121605;57.3;45.8
08;2021-07-13;944;1788;153056;123393;57.6;46.5
08;2021-07-14;177;330;153233;123723;57.7;46.6
08;2021-07-15;757;2452;153990;126175;58.0;47.5
08;2021-07-16;1074;2413;155064;128588;58.4;48.4
08;2021-07-17;991;2109;156055;130697;58.8;49.2
08;2021-07-18;344;737;156399;131434;58.9;49.5
08;2021-07-19;455;923;156854;132357;59.1;49.8
08;2021-07-20;875;1439;157729;133796;59.4;50.4
08;2021-07-21;1228;1718;158957;135514;59.9;51.0
08;2021-07-22;1143;2166;160100;137680;60.3;51.9
08;2021-07-23;1583;2449;161683;140129;60.9;52.8
08;2021-07-24;1305;1922;162988;142051;61.4;53.5
08;2021-07-25;771;440;163759;142491;61.7;53.7
08;2021-07-26;1306;842;165065;143333;62.2;54.0
08;2021-07-27;2176;1399;167241;144732;63.0;54.5
08;2021-07-28;2404;1447;169645;146179;63.9;55.1
08;2021-07-29;2591;1342;172236;147521;64.9;55.6
08;2021-07-30;2589;1576;174825;149097;65.8;56.2
08;2021-07-31;1967;1058;176792;150155;66.6;56.5
08;2021-08-01;934;294;177726;150449;66.9;56.7
08;2021-08-02;1251;678;178977;151127;67.4;56.9
08;2021-08-03;1627;810;180604;151937;68.0;57.2
08;2021-08-04;1476;647;182080;152584;68.6;57.5
08;2021-08-05;1885;958;183965;153542;69.3;57.8
09;2020-12-27;0;0;0;0;0.0;0.0
09;2020-12-28;1;0;1;0;0.0;0.0
09;2020-12-29;0;0;1;0;0.0;0.0
09;2020-12-30;0;0;1;0;0.0;0.0
09;2020-12-31;0;0;1;0;0.0;0.0
09;2021-01-01;0;0;1;0;0.0;0.0
09;2021-01-02;0;0;1;0;0.0;0.0
09;2021-01-03;0;0;1;0;0.0;0.0
09;2021-01-04;2;1;3;1;0.0;0.0
09;2021-01-05;0;0;3;1;0.0;0.0
09;2021-01-06;3;0;6;1;0.0;0.0
09;2021-01-07;257;2;263;3;0.2;0.0
09;2021-01-08;228;0;491;3;0.3;0.0
09;2021-01-09;103;0;594;3;0.4;0.0
09;2021-01-10;59;0;653;3;0.4;0.0
09;2021-01-11;175;0;828;3;0.5;0.0
09;2021-01-12;304;0;1132;3;0.7;0.0
09;2021-01-13;196;0;1328;3;0.9;0.0
09;2021-01-14;432;8;1760;11;1.2;0.0
09;2021-01-15;223;1;1983;12;1.3;0.0
09;2021-01-16;194;2;2177;14;1.4;0.0
09;2021-01-17;123;0;2300;14;1.5;0.0
09;2021-01-18;267;1;2567;15;1.7;0.0
09;2021-01-19;257;0;2824;15;1.9;0.0
09;2021-01-20;346;1;3170;16;2.1;0.0
09;2021-01-21;333;1;3503;17;2.3;0.0
09;2021-01-22;330;1;3833;18;2.5;0.0
09;2021-01-23;236;0;4069;18;2.7;0.0
09;2021-01-24;85;1;4154;19;2.7;0.0
09;2021-01-25;204;12;4358;31;2.9;0.0
09;2021-01-26;633;25;4991;56;3.3;0.0
09;2021-01-27;471;41;5462;97;3.6;0.1
09;2021-01-28;285;205;5747;302;3.8;0.2
09;2021-01-29;250;129;5997;431;3.9;0.3
09;2021-01-30;143;55;6140;486;4.0;0.3
09;2021-01-31;56;10;6196;496;4.1;0.3
09;2021-02-01;81;142;6277;638;4.1;0.4
09;2021-02-02;57;295;6334;933;4.2;0.6
09;2021-02-03;87;206;6421;1139;4.2;0.7
09;2021-02-04;49;299;6470;1438;4.2;0.9
09;2021-02-05;89;157;6559;1595;4.3;1.0
09;2021-02-06;68;49;6627;1644;4.3;1.1
09;2021-02-07;6;73;6633;1717;4.4;1.1
09;2021-02-08;22;177;6655;1894;4.4;1.2
09;2021-02-09;54;289;6709;2183;4.4;1.4
09;2021-02-10;15;196;6724;2379;4.4;1.6
09;2021-02-11;6;221;6730;2600;4.4;1.7
09;2021-02-12;149;175;6879;2775;4.5;1.8
09;2021-02-13;7;144;6886;2919;4.5;1.9
09;2021-02-14;0;53;6886;2972;4.5;2.0
09;2021-02-15;75;134;6961;3106;4.6;2.0
09;2021-02-16;227;510;7188;3616;4.7;2.4
09;2021-02-17;83;388;7271;4004;4.8;2.6
09;2021-02-18;88;450;7359;4454;4.8;2.9
09;2021-02-19;65;285;7424;4739;4.9;3.1
09;2021-02-20;59;200;7483;4939;4.9;3.2
09;2021-02-21;0;51;7483;4990;4.9;3.3
09;2021-02-22;127;218;7610;5208;5.0;3.4
09;2021-02-23;161;145;7771;5353;5.1;3.5
09;2021-02-24;74;178;7845;5531;5.1;3.6
09;2021-02-25;211;169;8056;5700;5.3;3.7
09;2021-02-26;162;174;8218;5874;5.4;3.9
09;2021-02-27;65;71;8283;5945;5.4;3.9
09;2021-02-28;43;17;8326;5962;5.5;3.9
09;2021-03-01;247;97;8573;6059;5.6;4.0
09;2021-03-02;284;76;8857;6135;5.8;4.0
09;2021-03-03;252;132;9109;6267;6.0;4.1
09;2021-03-04;413;30;9522;6297;6.2;4.1
09;2021-03-05;332;64;9854;6361;6.5;4.2
09;2021-03-06;397;46;10251;6407;6.7;4.2
09;2021-03-07;124;4;10375;6411;6.8;4.2
09;2021-03-08;380;64;10755;6475;7.1;4.2
09;2021-03-09;437;140;11192;6615;7.3;4.3
09;2021-03-10;562;71;11754;6686;7.7;4.4
09;2021-03-11;695;75;12449;6761;8.2;4.4
09;2021-03-12;659;31;13108;6792;8.6;4.5
09;2021-03-13;385;3;13493;6795;8.9;4.5
09;2021-03-14;120;3;13613;6798;8.9;4.5
09;2021-03-15;467;48;14080;6846;9.2;4.5
09;2021-03-16;370;80;14450;6926;9.5;4.5
09;2021-03-17;399;72;14849;6998;9.7;4.6
09;2021-03-18;454;42;15303;7040;10.0;4.6
09;2021-03-19;524;54;15827;7094;10.4;4.7
09;2021-03-20;313;39;16140;7133;10.6;4.7
09;2021-03-21;105;0;16245;7133;10.7;4.7
09;2021-03-22;424;118;16669;7251;10.9;4.8
09;2021-03-23;565;173;17234;7424;11.3;4.9
09;2021-03-24;711;41;17945;7465;11.8;4.9
09;2021-03-25;869;138;18814;7603;12.3;5.0
09;2021-03-26;751;45;19565;7648;12.8;5.0
09;2021-03-27;622;70;20187;7718;13.2;5.1
09;2021-03-28;132;24;20319;7742;13.3;5.1
09;2021-03-29;497;278;20816;8020;13.7;5.3
09;2021-03-30;729;153;21545;8173;14.1;5.4
09;2021-03-31;801;180;22346;8353;14.7;5.5
09;2021-04-01;734;254;23080;8607;15.1;5.6
09;2021-04-02;693;266;23773;8873;15.6;5.8
09;2021-04-03;770;117;24543;8990;16.1;5.9
09;2021-04-04;122;57;24665;9047;16.2;5.9
09;2021-04-05;237;58;24902;9105;16.3;6.0
09;2021-04-06;1056;391;25958;9496;17.0;6.2
09;2021-04-07;1209;359;27167;9855;17.8;6.5
09;2021-04-08;1468;397;28635;10252;18.8;6.7
09;2021-04-09;1139;414;29774;10666;19.5;7.0
09;2021-04-10;1349;194;31123;10860;20.4;7.1
09;2021-04-11;173;102;31296;10962;20.5;7.2
09;2021-04-12;736;342;32032;11304;21.0;7.4
09;2021-04-13;1047;407;33079;11711;21.7;7.7
09;2021-04-14;1331;506;34410;12217;22.6;8.0
09;2021-04-15;1148;501;35558;12718;23.3;8.3
09;2021-04-16;1033;414;36591;13132;24.0;8.6
09;2021-04-17;1194;355;37785;13487;24.8;8.8
09;2021-04-18;102;96;37887;13583;24.9;8.9
09;2021-04-19;697;404;38584;13987;25.3;9.2
09;2021-04-20;766;533;39350;14520;25.8;9.5
09;2021-04-21;941;591;40291;15111;26.4;9.9
09;2021-04-22;667;608;40958;15719;26.9;10.3
09;2021-04-23;772;425;41730;16144;27.4;10.6
09;2021-04-24;740;669;42470;16813;27.9;11.0
09;2021-04-25;75;113;42545;16926;27.9;11.1
09;2021-04-26;382;535;42927;17461;28.2;11.5
09;2021-04-27;443;720;43370;18181;28.5;11.9
09;2021-04-28;806;795;44176;18976;29.0;12.5
09;2021-04-29;550;771;44726;19747;29.3;13.0
09;2021-04-30;622;724;45348;20471;29.8;13.4
09;2021-05-01;478;453;45826;20924;30.1;13.7
09;2021-05-02;51;100;45877;21024;30.1;13.8
09;2021-05-03;522;663;46399;21687;30.4;14.2
09;2021-05-04;556;1348;46955;23035;30.8;15.1
09;2021-05-05;822;1347;47777;24382;31.4;16.0
09;2021-05-06;849;1033;48626;25415;31.9;16.7
09;2021-05-07;978;823;49604;26238;32.5;17.2
09;2021-05-08;395;461;49999;26699;32.8;17.5
09;2021-05-09;264;84;50263;26783;33.0;17.6
09;2021-05-10;504;967;50767;27750;33.3;18.2
09;2021-05-11;741;1052;51508;28802;33.8;18.9
09;2021-05-12;1535;1403;53043;30205;34.8;19.8
09;2021-05-13;1383;425;54426;30630;35.7;20.1
09;2021-05-14;987;654;55413;31284;36.4;20.5
09;2021-05-15;1236;790;56649;32074;37.2;21.0
09;2021-05-16;296;48;56945;32122;37.4;21.1
09;2021-05-17;875;413;57820;32535;37.9;21.3
09;2021-05-18;1291;393;59111;32928;38.8;21.6
09;2021-05-19;1495;367;60606;33295;39.8;21.8
09;2021-05-20;1379;406;61985;33701;40.7;22.1
09;2021-05-21;1164;496;63149;34197;41.4;22.4
09;2021-05-22;1546;364;64695;34561;42.5;22.7
09;2021-05-23;272;25;64967;34586;42.6;22.7
09;2021-05-24;177;99;65144;34685;42.7;22.8
09;2021-05-25;997;499;66141;35184;43.4;23.1
09;2021-05-26;1286;446;67427;35630;44.2;23.4
09;2021-05-27;966;403;68393;36033;44.9;23.6
09;2021-05-28;958;512;69351;36545;45.5;24.0
09;2021-05-29;1797;597;71148;37142;46.7;24.4
09;2021-05-30;541;197;71689;37339;47.0;24.5
09;2021-05-31;717;594;72406;37933;47.5;24.9
09;2021-06-01;967;641;73373;38574;48.1;25.3
09;2021-06-02;1007;897;74380;39471;48.8;25.9
09;2021-06-03;810;682;75190;40153;49.3;26.3
09;2021-06-04;877;799;76067;40952;49.9;26.9
09;2021-06-05;1320;873;77387;41825;50.8;27.4
09;2021-06-06;304;108;77691;41933;51.0;27.5
09;2021-06-07;623;517;78314;42450;51.4;27.9
09;2021-06-08;823;489;79137;42939;51.9;28.2
09;2021-06-09;808;833;79945;43772;52.5;28.7
09;2021-06-10;640;532;80585;44304;52.9;29.1
09;2021-06-11;831;761;81416;45065;53.4;29.6
09;2021-06-12;636;807;82052;45872;53.8;30.1
09;2021-06-13;94;130;82146;46002;53.9;30.2
09;2021-06-14;628;707;82774;46709;54.3;30.6
09;2021-06-15;824;890;83598;47599;54.9;31.2
09;2021-06-16;627;1078;84225;48677;55.3;31.9
09;2021-06-17;780;855;85005;49532;55.8;32.5
09;2021-06-18;635;1152;85640;50684;56.2;33.3
09;2021-06-19;517;1578;86157;52262;56.5;34.3
09;2021-06-20;8;279;86165;52541;56.5;34.5
09;2021-06-21;474;699;86639;53240;56.9;34.9
09;2021-06-22;462;1066;87101;54306;57.2;35.6
09;2021-06-23;435;1224;87536;55530;57.4;36.4
09;2021-06-24;581;772;88117;56302;57.8;36.9
09;2021-06-25;411;1063;88528;57365;58.1;37.6
09;2021-06-26;443;1087;88971;58452;58.4;38.4
09;2021-06-27;2;275;88973;58727;58.4;38.5
09;2021-06-28;239;1048;89212;59775;58.5;39.2
09;2021-06-29;313;1230;89525;61005;58.7;40.0
09;2021-06-30;456;1490;89981;62495;59.0;41.0
09;2021-07-01;383;1431;90364;63926;59.3;41.9
09;2021-07-02;308;1162;90672;65088;59.5;42.7
09;2021-07-03;209;1619;90881;66707;59.6;43.8
09;2021-07-04;4;254;90885;66961;59.6;43.9
09;2021-07-05;188;714;91073;67675;59.8;44.4
09;2021-07-06;292;1222;91365;68897;60.0;45.2
09;2021-07-07;416;1395;91781;70292;60.2;46.1
09;2021-07-08;322;1059;92103;71351;60.4;46.8
09;2021-07-09;290;1156;92393;72507;60.6;47.6
09;2021-07-10;345;1726;92738;74233;60.9;48.7
09;2021-07-11;147;391;92885;74624;60.9;49.0
09;2021-07-12;185;1073;93070;75697;61.1;49.7
09;2021-07-13;642;1307;93712;77004;61.5;50.5
09;2021-07-14;485;220;94197;77224;61.8;50.7
09;2021-07-15;816;1169;95013;78393;62.3;51.4
09;2021-07-16;608;1193;95621;79586;62.7;52.2
09;2021-07-17;1016;1445;96637;81031;63.4;53.2
09;2021-07-18;299;220;96936;81251;63.6;53.3
09;2021-07-19;482;969;97418;82220;63.9;54.0
09;2021-07-20;828;1257;98246;83477;64.5;54.8
09;2021-07-21;1013;1167;99259;84644;65.1;55.5
09;2021-07-22;844;907;100103;85551;65.7;56.1
09;2021-07-23;723;908;100826;86459;66.2;56.7
09;2021-07-24;919;460;101745;86919;66.8;57.0
09;2021-07-25;555;133;102300;87052;67.1;57.1
09;2021-07-26;645;767;102945;87819;67.6;57.6
09;2021-07-27;1164;943;104109;88762;68.3;58.2
09;2021-07-28;1189;982;105298;89744;69.1;58.9
09;2021-07-29;1023;735;106321;90479;69.8;59.4
09;2021-07-30;775;617;107096;91096;70.3;59.8
09;2021-07-31;1374;410;108470;91506;71.2;60.0
09;2021-08-01;141;125;108611;91631;71.3;60.1
09;2021-08-02;612;476;109223;92107;71.7;60.4
09;2021-08-03;1251;762;110474;92869;72.5;60.9
09;2021-08-04;1386;644;111860;93513;73.4;61.4
09;2021-08-05;991;668;112851;94181;74.1;61.8
10;2020-12-27;0;0;0;0;0.0;0.0
10;2020-12-28;0;0;0;0;0.0;0.0
10;2020-12-29;0;0;0;0;0.0;0.0
10;2020-12-30;0;0;0;0;0.0;0.0
10;2020-12-31;0;0;0;0;0.0;0.0
10;2021-01-01;0;0;0;0;0.0;0.0
10;2021-01-02;0;0;0;0;0.0;0.0
10;2021-01-03;0;0;0;0;0.0;0.0
10;2021-01-04;0;0;0;0;0.0;0.0
10;2021-01-05;1;0;1;0;0.0;0.0
10;2021-01-06;0;0;1;0;0.0;0.0
10;2021-01-07;84;0;85;0;0.0;0.0
10;2021-01-08;255;0;340;0;0.1;0.0
10;2021-01-09;0;0;340;0;0.1;0.0
10;2021-01-10;0;0;340;0;0.1;0.0
10;2021-01-11;117;0;457;0;0.1;0.0
10;2021-01-12;191;0;648;0;0.2;0.0
10;2021-01-13;313;0;961;0;0.3;0.0
10;2021-01-14;391;7;1352;7;0.4;0.0
10;2021-01-15;359;2;1711;9;0.6;0.0
10;2021-01-16;55;0;1766;9;0.6;0.0
10;2021-01-17;0;0;1766;9;0.6;0.0
10;2021-01-18;699;1;2465;10;0.8;0.0
10;2021-01-19;1361;2;3826;12;1.2;0.0
10;2021-01-20;1070;5;4896;17;1.6;0.0
10;2021-01-21;1145;2;6041;19;1.9;0.0
10;2021-01-22;818;0;6859;19;2.2;0.0
10;2021-01-23;309;0;7168;19;2.3;0.0
10;2021-01-24;0;0;7168;19;2.3;0.0
10;2021-01-25;445;9;7613;28;2.5;0.0
10;2021-01-26;487;17;8100;45;2.6;0.0
10;2021-01-27;459;15;8559;60;2.8;0.0
10;2021-01-28;356;48;8915;108;2.9;0.0
10;2021-01-29;430;194;9345;302;3.0;0.1
10;2021-01-30;30;0;9375;302;3.0;0.1
10;2021-01-31;0;0;9375;302;3.0;0.1
10;2021-02-01;404;142;9779;444;3.2;0.1
10;2021-02-02;182;152;9961;596;3.2;0.2
10;2021-02-03;345;216;10306;812;3.3;0.3
10;2021-02-04;342;270;10648;1082;3.4;0.3
10;2021-02-05;327;321;10975;1403;3.5;0.5
10;2021-02-06;3;35;10978;1438;3.5;0.5
10;2021-02-07;0;0;10978;1438;3.5;0.5
10;2021-02-08;190;411;11168;1849;3.6;0.6
10;2021-02-09;480;585;11648;2434;3.8;0.8
10;2021-02-10;666;475;12314;2909;4.0;0.9
10;2021-02-11;768;598;13082;3507;4.2;1.1
10;2021-02-12;580;552;13662;4059;4.4;1.3
10;2021-02-13;36;120;13698;4179;4.4;1.3
10;2021-02-14;0;0;13698;4179;4.4;1.3
10;2021-02-15;142;448;13840;4627;4.5;1.5
10;2021-02-16;116;546;13956;5173;4.5;1.7
10;2021-02-17;129;607;14085;5780;4.5;1.9
10;2021-02-18;216;558;14301;6338;4.6;2.0
10;2021-02-19;187;471;14488;6809;4.7;2.2
10;2021-02-20;24;183;14512;6992;4.7;2.3
10;2021-02-21;0;0;14512;6992;4.7;2.3
10;2021-02-22;77;448;14589;7440;4.7;2.4
10;2021-02-23;76;563;14665;8003;4.7;2.6
10;2021-02-24;104;375;14769;8378;4.8;2.7
10;2021-02-25;323;375;15092;8753;4.9;2.8
10;2021-02-26;351;283;15443;9036;5.0;2.9
10;2021-02-27;275;129;15718;9165;5.1;3.0
10;2021-02-28;0;0;15718;9165;5.1;3.0
10;2021-03-01;257;334;15975;9499;5.2;3.1
10;2021-03-02;434;370;16409;9869;5.3;3.2
10;2021-03-03;453;580;16862;10449;5.4;3.4
10;2021-03-04;634;500;17496;10949;5.6;3.5
10;2021-03-05;677;254;18173;11203;5.9;3.6
10;2021-03-06;948;40;19121;11243;6.2;3.6
10;2021-03-07;769;5;19890;11248;6.4;3.6
10;2021-03-08;502;443;20392;11691;6.6;3.8
10;2021-03-09;673;436;21065;12127;6.8;3.9
10;2021-03-10;660;364;21725;12491;7.0;4.0
10;2021-03-11;1174;235;22899;12726;7.4;4.1
10;2021-03-12;1338;240;24237;12966;7.8;4.2
10;2021-03-13;892;36;25129;13002;8.1;4.2
10;2021-03-14;1381;14;26510;13016;8.6;4.2
10;2021-03-15;821;78;27331;13094;8.8;4.2
10;2021-03-16;688;61;28019;13155;9.0;4.2
10;2021-03-17;831;66;28850;13221;9.3;4.3
10;2021-03-18;885;79;29735;13300;9.6;4.3
10;2021-03-19;951;68;30686;13368;9.9;4.3
10;2021-03-20;552;16;31238;13384;10.1;4.3
10;2021-03-21;1845;36;33083;13420;10.7;4.3
10;2021-03-22;879;69;33962;13489;11.0;4.4
10;2021-03-23;1245;90;35207;13579;11.4;4.4
10;2021-03-24;1308;53;36515;13632;11.8;4.4
10;2021-03-25;1676;227;38191;13859;12.3;4.5
10;2021-03-26;1431;113;39622;13972;12.8;4.5
10;2021-03-27;762;78;40384;14050;13.0;4.5
10;2021-03-28;1221;26;41605;14076;13.4;4.5
10;2021-03-29;648;305;42253;14381;13.6;4.6
10;2021-03-30;926;374;43179;14755;13.9;4.8
10;2021-03-31;617;359;43796;15114;14.1;4.9
10;2021-04-01;883;682;44679;15796;14.4;5.1
10;2021-04-02;1068;588;45747;16384;14.8;5.3
10;2021-04-03;540;606;46287;16990;14.9;5.5
10;2021-04-04;1826;258;48113;17248;15.5;5.6
10;2021-04-05;1843;36;49956;17284;16.1;5.6
10;2021-04-06;514;649;50470;17933;16.3;5.8
10;2021-04-07;589;538;51059;18471;16.5;6.0
10;2021-04-08;1056;603;52115;19074;16.8;6.2
10;2021-04-09;1130;608;53245;19682;17.2;6.4
10;2021-04-10;1770;349;55015;20031;17.8;6.5
10;2021-04-11;55;1223;55070;21254;17.8;6.9
10;2021-04-12;1003;807;56073;22061;18.1;7.1
10;2021-04-13;1505;887;57578;22948;18.6;7.4
10;2021-04-14;820;600;58398;23548;18.8;7.6
10;2021-04-15;1432;888;59830;24436;19.3;7.9
10;2021-04-16;1108;695;60938;25131;19.7;8.1
10;2021-04-17;2391;356;63329;25487;20.4;8.2
10;2021-04-18;1421;1781;64750;27268;20.9;8.8
10;2021-04-19;838;836;65588;28104;21.2;9.1
10;2021-04-20;545;1034;66133;29138;21.3;9.4
10;2021-04-21;637;985;66770;30123;21.5;9.7
10;2021-04-22;932;972;67702;31095;21.8;10.0
10;2021-04-23;2171;775;69873;31870;22.5;10.3
10;2021-04-24;2296;371;72169;32241;23.3;10.4
10;2021-04-25;1989;1215;74158;33456;23.9;10.8
10;2021-04-26;773;619;74931;34075;24.2;11.0
10;2021-04-27;895;535;75826;34610;24.5;11.2
10;2021-04-28;873;404;76699;35014;24.7;11.3
10;2021-04-29;1433;670;78132;35684;25.2;11.5
10;2021-04-30;2173;758;80305;36442;25.9;11.8
10;2021-05-01;1988;2165;82293;38607;26.6;12.5
10;2021-05-02;1948;1893;84241;40500;27.2;13.1
10;2021-05-03;622;445;84863;40945;27.4;13.2
10;2021-05-04;1145;1248;86008;42193;27.8;13.6
10;2021-05-05;1754;1019;87762;43212;28.3;13.9
10;2021-05-06;2256;938;90018;44150;29.0;14.2
10;2021-05-07;2217;1135;92235;45285;29.8;14.6
10;2021-05-08;2270;856;94505;46141;30.5;14.9
10;2021-05-09;2004;99;96509;46240;31.1;14.9
10;2021-05-10;528;1092;97037;47332;31.3;15.3
10;2021-05-11;1051;1022;98088;48354;31.7;15.6
10;2021-05-12;2061;880;100149;49234;32.3;15.9
10;2021-05-13;2183;431;102332;49665;33.0;16.0
10;2021-05-14;2730;667;105062;50332;33.9;16.2
10;2021-05-15;2427;2038;107489;52370;34.7;16.9
10;2021-05-16;2081;1449;109570;53819;35.4;17.4
10;2021-05-17;1451;441;111021;54260;35.8;17.5
10;2021-05-18;2510;637;113531;54897;36.6;17.7
10;2021-05-19;1553;638;115084;55535;37.1;17.9
10;2021-05-20;1890;847;116974;56382;37.7;18.2
10;2021-05-21;2318;615;119292;56997;38.5;18.4
10;2021-05-22;2181;420;121473;57417;39.2;18.5
10;2021-05-23;1817;139;123290;57556;39.8;18.6
10;2021-05-24;1968;180;125258;57736;40.4;18.6
10;2021-05-25;2193;488;127451;58224;41.1;18.8
10;2021-05-26;1677;419;129128;58643;41.7;18.9
10;2021-05-27;1660;754;130788;59397;42.2;19.2
10;2021-05-28;1719;1185;132507;60582;42.8;19.5
10;2021-05-29;2170;640;134677;61222;43.5;19.8
10;2021-05-30;1029;133;135706;61355;43.8;19.8
10;2021-05-31;1039;748;136745;62103;44.1;20.0
10;2021-06-01;1133;884;137878;62987;44.5;20.3
10;2021-06-02;1032;715;138910;63702;44.8;20.6
10;2021-06-03;1473;1070;140383;64772;45.3;20.9
10;2021-06-04;1768;2601;142151;67373;45.9;21.7
10;2021-06-05;1512;2452;143663;69825;46.4;22.5
10;2021-06-06;1005;1875;144668;71700;46.7;23.1
10;2021-06-07;698;1112;145366;72812;46.9;23.5
10;2021-06-08;895;1168;146261;73980;47.2;23.9
10;2021-06-09;877;910;147138;74890;47.5;24.2
10;2021-06-10;678;1070;147816;75960;47.7;24.5
10;2021-06-11;1199;2209;149015;78169;48.1;25.2
10;2021-06-12;855;2387;149870;80556;48.4;26.0
10;2021-06-13;401;1837;150271;82393;48.5;26.6
10;2021-06-14;534;742;150805;83135;48.7;26.8
10;2021-06-15;740;2131;151545;85266;48.9;27.5
10;2021-06-16;740;1860;152285;87126;49.1;28.1
10;2021-06-17;848;2458;153133;89584;49.4;28.9
10;2021-06-18;1030;2474;154163;92058;49.7;29.7
10;2021-06-19;982;2595;155145;94653;50.1;30.5
10;2021-06-20;549;1600;155694;96253;50.2;31.1
10;2021-06-21;682;1046;156376;97299;50.5;31.4
10;2021-06-22;743;1525;157119;98824;50.7;31.9
10;2021-06-23;647;2409;157766;101233;50.9;32.7
10;2021-06-24;782;2618;158548;103851;51.2;33.5
10;2021-06-25;731;3036;159279;106887;51.4;34.5
10;2021-06-26;514;2742;159793;109629;51.6;35.4
10;2021-06-27;402;1939;160195;111568;51.7;36.0
10;2021-06-28;685;1786;160880;113354;51.9;36.6
10;2021-06-29;616;2693;161496;116047;52.1;37.4
10;2021-06-30;535;1525;162031;117572;52.3;37.9
10;2021-07-01;551;2172;162582;119744;52.5;38.6
10;2021-07-02;667;2728;163249;122472;52.7;39.5
10;2021-07-03;528;2600;163777;125072;52.8;40.4
10;2021-07-04;411;1727;164188;126799;53.0;40.9
10;2021-07-05;664;2221;164852;129020;53.2;41.6
10;2021-07-06;650;2184;165502;131204;53.4;42.3
10;2021-07-07;630;1700;166132;132904;53.6;42.9
10;2021-07-08;747;1458;166879;134362;53.8;43.4
10;2021-07-09;814;1946;167693;136308;54.1;44.0
10;2021-07-10;632;2097;168325;138405;54.3;44.7
10;2021-07-11;500;1378;168825;139783;54.5;45.1
10;2021-07-12;777;1623;169602;141406;54.7;45.6
10;2021-07-13;1124;1879;170726;143285;55.1;46.2
10;2021-07-14;1170;1055;171896;144340;55.5;46.6
10;2021-07-15;1472;1980;173368;146320;55.9;47.2
10;2021-07-16;1239;2272;174607;148592;56.3;47.9
10;2021-07-17;1284;1736;175891;150328;56.8;48.5
10;2021-07-18;941;1225;176832;151553;57.1;48.9
10;2021-07-19;1356;1618;178188;153171;57.5;49.4
10;2021-07-20;1680;1429;179868;154600;58.0;49.9
10;2021-07-21;1391;1485;181259;156085;58.5;50.4
10;2021-07-22;1932;1590;183191;157675;59.1;50.9
10;2021-07-23;1592;1540;184783;159215;59.6;51.4
10;2021-07-24;1386;1219;186169;160434;60.1;51.8
10;2021-07-25;1251;785;187420;161219;60.5;52.0
10;2021-07-26;1909;1314;189329;162533;61.1;52.4
10;2021-07-27;2116;1082;191445;163615;61.8;52.8
10;2021-07-28;2090;1006;193535;164621;62.4;53.1
10;2021-07-29;2425;1201;195960;165822;63.2;53.5
10;2021-07-30;2151;1301;198111;167123;63.9;53.9
10;2021-07-31;1672;931;199783;168054;64.5;54.2
10;2021-08-01;1234;570;201017;168624;64.9;54.4
10;2021-08-02;1331;1334;202348;169958;65.3;54.8
10;2021-08-03;1549;890;203897;170848;65.8;55.1
10;2021-08-04;1300;1061;205197;171909;66.2;55.5
10;2021-08-05;1598;1335;206795;173244;66.7;55.9
11;2020-12-27;0;0;0;0;0.0;0.0
11;2020-12-28;1;0;1;0;0.0;0.0
11;2020-12-29;1;0;2;0;0.0;0.0
11;2020-12-30;0;0;2;0;0.0;0.0
11;2020-12-31;0;0;2;0;0.0;0.0
11;2021-01-01;0;0;2;0;0.0;0.0
11;2021-01-02;5;0;7;0;0.0;0.0
11;2021-01-03;0;0;7;0;0.0;0.0
11;2021-01-04;0;0;7;0;0.0;0.0
11;2021-01-05;94;0;101;0;0.0;0.0
11;2021-01-06;25;0;126;0;0.0;0.0
11;2021-01-07;119;0;245;0;0.1;0.0
11;2021-01-08;90;1;335;1;0.1;0.0
11;2021-01-09;86;0;421;1;0.1;0.0
11;2021-01-10;67;0;488;1;0.1;0.0
11;2021-01-11;136;0;624;1;0.2;0.0
11;2021-01-12;544;3;1168;4;0.3;0.0
11;2021-01-13;410;1;1578;5;0.4;0.0
11;2021-01-14;644;8;2222;13;0.6;0.0
11;2021-01-15;342;4;2564;17;0.7;0.0
11;2021-01-16;77;1;2641;18;0.7;0.0
11;2021-01-17;47;1;2688;19;0.7;0.0
11;2021-01-18;388;0;3076;19;0.8;0.0
11;2021-01-19;525;4;3601;23;1.0;0.0
11;2021-01-20;691;6;4292;29;1.2;0.0
11;2021-01-21;647;4;4939;33;1.3;0.0
11;2021-01-22;524;1;5463;34;1.5;0.0
11;2021-01-23;157;0;5620;34;1.5;0.0
11;2021-01-24;139;0;5759;34;1.5;0.0
11;2021-01-25;372;20;6131;54;1.6;0.0
11;2021-01-26;838;84;6969;138;1.9;0.0
11;2021-01-27;798;23;7767;161;2.1;0.0
11;2021-01-28;644;61;8411;222;2.3;0.1
11;2021-01-29;434;124;8845;346;2.4;0.1
11;2021-01-30;131;1;8976;347;2.4;0.1
11;2021-01-31;81;0;9057;347;2.4;0.1
11;2021-02-01;344;195;9401;542;2.5;0.1
11;2021-02-02;409;407;9810;949;2.6;0.3
11;2021-02-03;390;352;10200;1301;2.7;0.3
11;2021-02-04;373;497;10573;1798;2.8;0.5
11;2021-02-05;312;338;10885;2136;2.9;0.6
11;2021-02-06;205;62;11090;2198;3.0;0.6
11;2021-02-07;108;13;11198;2211;3.0;0.6
11;2021-02-08;315;160;11513;2371;3.1;0.6
11;2021-02-09;298;279;11811;2650;3.2;0.7
11;2021-02-10;338;447;12149;3097;3.3;0.8
11;2021-02-11;610;630;12759;3727;3.4;1.0
11;2021-02-12;401;380;13160;4107;3.5;1.1
11;2021-02-13;193;120;13353;4227;3.6;1.1
11;2021-02-14;67;27;13420;4254;3.6;1.1
11;2021-02-15;239;210;13659;4464;3.7;1.2
11;2021-02-16;262;514;13921;4978;3.7;1.3
11;2021-02-17;453;620;14374;5598;3.9;1.5
11;2021-02-18;456;573;14830;6171;4.0;1.7
11;2021-02-19;300;540;15130;6711;4.1;1.8
11;2021-02-20;147;75;15277;6786;4.1;1.8
11;2021-02-21;57;45;15334;6831;4.1;1.8
11;2021-02-22;125;332;15459;7163;4.1;1.9
11;2021-02-23;283;322;15742;7485;4.2;2.0
11;2021-02-24;251;374;15993;7859;4.3;2.1
11;2021-02-25;562;324;16555;8183;4.4;2.2
11;2021-02-26;523;320;17078;8503;4.6;2.3
11;2021-02-27;318;98;17396;8601;4.7;2.3
11;2021-02-28;95;24;17491;8625;4.7;2.3
11;2021-03-01;339;319;17830;8944;4.8;2.4
11;2021-03-02;562;392;18392;9336;4.9;2.5
11;2021-03-03;599;436;18991;9772;5.1;2.6
11;2021-03-04;1075;407;20066;10179;5.4;2.7
11;2021-03-05;1002;410;21068;10589;5.7;2.8
11;2021-03-06;1094;205;22162;10794;5.9;2.9
11;2021-03-07;658;35;22820;10829;6.1;2.9
11;2021-03-08;375;353;23195;11182;6.2;3.0
11;2021-03-09;997;393;24192;11575;6.5;3.1
11;2021-03-10;1170;546;25362;12121;6.8;3.3
11;2021-03-11;1571;444;26933;12565;7.2;3.4
11;2021-03-12;1453;439;28386;13004;7.6;3.5
11;2021-03-13;1158;238;29544;13242;7.9;3.6
11;2021-03-14;524;52;30068;13294;8.1;3.6
11;2021-03-15;651;241;30719;13535;8.2;3.6
11;2021-03-16;853;200;31572;13735;8.5;3.7
11;2021-03-17;908;220;32480;13955;8.7;3.7
11;2021-03-18;1172;283;33652;14238;9.0;3.8
11;2021-03-19;1370;246;35022;14484;9.4;3.9
11;2021-03-20;788;168;35810;14652;9.6;3.9
11;2021-03-21;225;65;36035;14717;9.7;3.9
11;2021-03-22;809;215;36844;14932;9.9;4.0
11;2021-03-23;1804;389;38648;15321;10.4;4.1
11;2021-03-24;1843;316;40491;15637;10.9;4.2
11;2021-03-25;2189;373;42680;16010;11.5;4.3
11;2021-03-26;2125;440;44805;16450;12.0;4.4
11;2021-03-27;1177;144;45982;16594;12.3;4.5
11;2021-03-28;265;43;46247;16637;12.4;4.5
11;2021-03-29;1181;218;47428;16855;12.7;4.5
11;2021-03-30;1993;318;49421;17173;13.3;4.6
11;2021-03-31;1613;382;51034;17555;13.7;4.7
11;2021-04-01;2146;424;53180;17979;14.3;4.8
11;2021-04-02;1641;430;54821;18409;14.7;4.9
11;2021-04-03;720;143;55541;18552;14.9;5.0
11;2021-04-04;198;73;55739;18625;15.0;5.0
11;2021-04-05;257;4;55996;18629;15.0;5.0
11;2021-04-06;1571;547;57567;19176;15.4;5.1
11;2021-04-07;1776;572;59343;19748;15.9;5.3
11;2021-04-08;1785;682;61128;20430;16.4;5.5
11;2021-04-09;2260;599;63388;21029;17.0;5.6
11;2021-04-10;1169;176;64557;21205;17.3;5.7
11;2021-04-11;547;107;65104;21312;17.5;5.7
11;2021-04-12;1612;534;66716;21846;17.9;5.9
11;2021-04-13;2259;882;68975;22728;18.5;6.1
11;2021-04-14;1661;1011;70636;23739;19.0;6.4
11;2021-04-15;1839;1125;72475;24864;19.4;6.7
11;2021-04-16;1835;845;74310;25709;19.9;6.9
11;2021-04-17;1771;559;76081;26268;20.4;7.0
11;2021-04-18;114;155;76195;26423;20.4;7.1
11;2021-04-19;1383;734;77578;27157;20.8;7.3
11;2021-04-20;1726;1284;79304;28441;21.3;7.6
11;2021-04-21;1778;1320;81082;29761;21.8;8.0
11;2021-04-22;1748;1321;82830;31082;22.2;8.3
11;2021-04-23;2011;1230;84841;32312;22.8;8.7
11;2021-04-24;1735;467;86576;32779;23.2;8.8
11;2021-04-25;658;180;87234;32959;23.4;8.8
11;2021-04-26;1376;836;88610;33795;23.8;9.1
11;2021-04-27;1834;1545;90444;35340;24.3;9.5
11;2021-04-28;2003;1467;92447;36807;24.8;9.9
11;2021-04-29;2246;1634;94693;38441;25.4;10.3
11;2021-04-30;2153;1427;96846;39868;26.0;10.7
11;2021-05-01;1338;341;98184;40209;26.3;10.8
11;2021-05-02;588;336;98772;40545;26.5;10.9
11;2021-05-03;1487;738;100259;41283;26.9;11.1
11;2021-05-04;1879;1430;102138;42713;27.4;11.5
11;2021-05-05;1892;1436;104030;44149;27.9;11.8
11;2021-05-06;2190;1474;106220;45623;28.5;12.2
11;2021-05-07;2104;1554;108324;47177;29.1;12.7
11;2021-05-08;895;726;109219;47903;29.3;12.9
11;2021-05-09;628;543;109847;48446;29.5;13.0
11;2021-05-10;1328;1652;111175;50098;29.8;13.4
11;2021-05-11;2039;1864;113214;51962;30.4;13.9
11;2021-05-12;1830;1635;115044;53597;30.9;14.4
11;2021-05-13;1406;414;116450;54011;31.2;14.5
11;2021-05-14;1712;1184;118162;55195;31.7;14.8
11;2021-05-15;1156;901;119318;56096;32.0;15.1
11;2021-05-16;807;165;120125;56261;32.2;15.1
11;2021-05-17;1469;1048;121594;57309;32.6;15.4
11;2021-05-18;1900;1196;123494;58505;33.1;15.7
11;2021-05-19;1848;1120;125342;59625;33.6;16.0
11;2021-05-20;1968;1091;127310;60716;34.2;16.3
11;2021-05-21;2277;1089;129587;61805;34.8;16.6
11;2021-05-22;1483;725;131070;62530;35.2;16.8
11;2021-05-23;768;67;131838;62597;35.4;16.8
11;2021-05-24;1411;226;133249;62823;35.8;16.9
11;2021-05-25;1810;1354;135059;64177;36.2;17.2
11;2021-05-26;1933;1303;136992;65480;36.8;17.6
11;2021-05-27;1984;1720;138976;67200;37.3;18.0
11;2021-05-28;1759;1897;140735;69097;37.8;18.5
11;2021-05-29;1429;1597;142164;70694;38.1;19.0
11;2021-05-30;486;395;142650;71089;38.3;19.1
11;2021-05-31;1260;1620;143910;72709;38.6;19.5
11;2021-06-01;1855;1905;145765;74614;39.1;20.0
11;2021-06-02;1761;2075;147526;76689;39.6;20.6
11;2021-06-03;2599;2411;150125;79100;40.3;21.2
11;2021-06-04;2145;2672;152270;81772;40.9;21.9
11;2021-06-05;1589;1902;153859;83674;41.3;22.5
11;2021-06-06;877;861;154736;84535;41.5;22.7
11;2021-06-07;1526;1713;156262;86248;41.9;23.1
11;2021-06-08;2037;1993;158299;88241;42.5;23.7
11;2021-06-09;1790;2192;160089;90433;43.0;24.3
11;2021-06-10;1806;2427;161895;92860;43.4;24.9
11;2021-06-11;1863;2492;163758;95352;43.9;25.6
11;2021-06-12;1455;1621;165213;96973;44.3;26.0
11;2021-06-13;711;722;165924;97695;44.5;26.2
11;2021-06-14;1033;1967;166957;99662;44.8;26.7
11;2021-06-15;1392;2682;168349;102344;45.2;27.5
11;2021-06-16;1338;2529;169687;104873;45.5;28.1
11;2021-06-17;1471;2537;171158;107410;45.9;28.8
11;2021-06-18;1518;2489;172676;109899;46.3;29.5
11;2021-06-19;1237;1409;173913;111308;46.7;29.9
11;2021-06-20;299;600;174212;111908;46.7;30.0
11;2021-06-21;839;2120;175051;114028;47.0;30.6
11;2021-06-22;1015;2606;176066;116634;47.2;31.3
11;2021-06-23;1097;2086;177163;118720;47.5;31.9
11;2021-06-24;907;2244;178070;120964;47.8;32.5
11;2021-06-25;992;2541;179062;123505;48.0;33.1
11;2021-06-26;773;1656;179835;125161;48.3;33.6
11;2021-06-27;209;688;180044;125849;48.3;33.8
11;2021-06-28;697;2300;180741;128149;48.5;34.4
11;2021-06-29;961;2597;181702;130746;48.8;35.1
11;2021-06-30;905;2521;182607;133267;49.0;35.8
11;2021-07-01;997;1886;183604;135153;49.3;36.3
11;2021-07-02;962;2540;184566;137693;49.5;36.9
11;2021-07-03;726;1800;185292;139493;49.7;37.4
11;2021-07-04;338;1109;185630;140602;49.8;37.7
11;2021-07-05;691;2131;186321;142733;50.0;38.3
11;2021-07-06;967;2519;187288;145252;50.3;39.0
11;2021-07-07;940;2511;188228;147763;50.5;39.6
11;2021-07-08;1185;1909;189413;149672;50.8;40.2
11;2021-07-09;823;1791;190236;151463;51.0;40.6
11;2021-07-10;366;1300;190602;152763;51.1;41.0
11;2021-07-11;312;563;190914;153326;51.2;41.1
11;2021-07-12;494;2666;191408;155992;51.4;41.9
11;2021-07-13;1295;3069;192703;159061;51.7;42.7
11;2021-07-14;205;234;192908;159295;51.8;42.7
11;2021-07-15;1412;2962;194320;162257;52.1;43.5
11;2021-07-16;1835;2725;196155;164982;52.6;44.3
11;2021-07-17;1073;2163;197228;167145;52.9;44.8
11;2021-07-18;650;945;197878;168090;53.1;45.1
11;2021-07-19;1327;2093;199205;170183;53.4;45.7
11;2021-07-20;1968;2403;201173;172586;54.0;46.3
11;2021-07-21;1998;2428;203171;175014;54.5;47.0
11;2021-07-22;2384;1866;205555;176880;55.2;47.5
11;2021-07-23;2214;2263;207769;179143;55.7;48.1
11;2021-07-24;1269;1619;209038;180762;56.1;48.5
11;2021-07-25;746;688;209784;181450;56.3;48.7
11;2021-07-26;1655;1412;211439;182862;56.7;49.1
11;2021-07-27;2305;1983;213744;184845;57.3;49.6
11;2021-07-28;2443;1977;216187;186822;58.0;50.1
11;2021-07-29;2734;1787;218921;188609;58.7;50.6
11;2021-07-30;2547;1776;221468;190385;59.4;51.1
11;2021-07-31;1990;1118;223458;191503;60.0;51.4
11;2021-08-01;1010;476;224468;191979;60.2;51.5
11;2021-08-02;1913;1145;226381;193124;60.7;51.8
11;2021-08-03;2412;1588;228793;194712;61.4;52.2
11;2021-08-04;2529;1242;231322;195954;62.1;52.6
11;2021-08-05;2335;1319;233657;197273;62.7;52.9
12;2020-12-27;0;0;0;0;0.0;0.0
12;2020-12-28;0;0;0;0;0.0;0.0
12;2020-12-29;0;0;0;0;0.0;0.0
12;2020-12-30;0;0;0;0;0.0;0.0
12;2020-12-31;0;0;0;0;0.0;0.0
12;2021-01-01;0;0;0;0;0.0;0.0
12;2021-01-02;0;0;0;0;0.0;0.0
12;2021-01-03;0;0;0;0;0.0;0.0
12;2021-01-04;1;0;1;0;0.0;0.0
12;2021-01-05;0;0;1;0;0.0;0.0
12;2021-01-06;12;0;13;0;0.0;0.0
12;2021-01-07;202;0;215;0;0.1;0.0
12;2021-01-08;65;0;280;0;0.1;0.0
12;2021-01-09;0;0;280;0;0.1;0.0
12;2021-01-10;1;0;281;0;0.1;0.0
12;2021-01-11;99;0;380;0;0.1;0.0
12;2021-01-12;360;1;740;1;0.3;0.0
12;2021-01-13;285;0;1025;1;0.4;0.0
12;2021-01-14;598;11;1623;12;0.6;0.0
12;2021-01-15;366;10;1989;22;0.7;0.0
12;2021-01-16;138;2;2127;24;0.8;0.0
12;2021-01-17;0;0;2127;24;0.8;0.0
12;2021-01-18;453;0;2580;24;0.9;0.0
12;2021-01-19;603;3;3183;27;1.1;0.0
12;2021-01-20;877;2;4060;29;1.5;0.0
12;2021-01-21;733;0;4793;29;1.7;0.0
12;2021-01-22;798;1;5591;30;2.0;0.0
12;2021-01-23;382;2;5973;32;2.1;0.0
12;2021-01-24;0;0;5973;32;2.1;0.0
12;2021-01-25;452;0;6425;32;2.3;0.0
12;2021-01-26;649;0;7074;32;2.5;0.0
12;2021-01-27;1879;18;8953;50;3.2;0.0
12;2021-01-28;1883;211;10836;261;3.9;0.1
12;2021-01-29;1330;43;12166;304;4.4;0.1
12;2021-01-30;359;2;12525;306;4.5;0.1
12;2021-01-31;0;0;12525;306;4.5;0.1
12;2021-02-01;333;89;12858;395;4.6;0.1
12;2021-02-02;457;243;13315;638;4.8;0.2
12;2021-02-03;457;166;13772;804;4.9;0.3
12;2021-02-04;458;525;14230;1329;5.1;0.5
12;2021-02-05;449;183;14679;1512;5.3;0.5
12;2021-02-06;219;68;14898;1580;5.4;0.6
12;2021-02-07;8;0;14906;1580;5.4;0.6
12;2021-02-08;105;316;15011;1896;5.4;0.7
12;2021-02-09;208;341;15219;2237;5.5;0.8
12;2021-02-10;465;471;15684;2708;5.6;1.0
12;2021-02-11;538;346;16222;3054;5.8;1.1
12;2021-02-12;570;345;16792;3399;6.0;1.2
12;2021-02-13;175;133;16967;3532;6.1;1.3
12;2021-02-14;1;0;16968;3532;6.1;1.3
12;2021-02-15;175;379;17143;3911;6.2;1.4
12;2021-02-16;171;513;17314;4424;6.2;1.6
12;2021-02-17;363;1437;17677;5861;6.4;2.1
12;2021-02-18;676;1661;18353;7522;6.6;2.7
12;2021-02-19;593;972;18946;8494;6.8;3.1
12;2021-02-20;103;397;19049;8891;6.8;3.2
12;2021-02-21;0;0;19049;8891;6.8;3.2
12;2021-02-22;149;404;19198;9295;6.9;3.3
12;2021-02-23;157;560;19355;9855;7.0;3.5
12;2021-02-24;157;689;19512;10544;7.0;3.8
12;2021-02-25;201;768;19713;11312;7.1;4.1
12;2021-02-26;320;652;20033;11964;7.2;4.3
12;2021-02-27;190;350;20223;12314;7.3;4.4
12;2021-02-28;13;0;20236;12314;7.3;4.4
12;2021-03-01;50;350;20286;12664;7.3;4.5
12;2021-03-02;190;506;20476;13170;7.4;4.7
12;2021-03-03;243;388;20719;13558;7.4;4.9
12;2021-03-04;277;361;20996;13919;7.5;5.0
12;2021-03-05;421;369;21417;14288;7.7;5.1
12;2021-03-06;793;129;22210;14417;8.0;5.2
12;2021-03-07;140;31;22350;14448;8.0;5.2
12;2021-03-08;234;210;22584;14658;8.1;5.3
12;2021-03-09;716;234;23300;14892;8.4;5.3
12;2021-03-10;782;740;24082;15632;8.7;5.6
12;2021-03-11;918;659;25000;16291;9.0;5.9
12;2021-03-12;1258;524;26258;16815;9.4;6.0
12;2021-03-13;896;137;27154;16952;9.8;6.1
12;2021-03-14;45;2;27199;16954;9.8;6.1
12;2021-03-15;558;155;27757;17109;10.0;6.1
12;2021-03-16;817;158;28574;17267;10.3;6.2
12;2021-03-17;1504;160;30078;17427;10.8;6.3
12;2021-03-18;995;251;31073;17678;11.2;6.4
12;2021-03-19;1382;275;32455;17953;11.7;6.4
12;2021-03-20;724;79;33179;18032;11.9;6.5
12;2021-03-21;264;10;33443;18042;12.0;6.5
12;2021-03-22;606;173;34049;18215;12.2;6.5
12;2021-03-23;1215;173;35264;18388;12.7;6.6
12;2021-03-24;1421;197;36685;18585;13.2;6.7
12;2021-03-25;1844;202;38529;18787;13.8;6.7
12;2021-03-26;1977;222;40506;19009;14.6;6.8
12;2021-03-27;980;65;41486;19074;14.9;6.9
12;2021-03-28;60;1;41546;19075;14.9;6.9
12;2021-03-29;962;81;42508;19156;15.3;6.9
12;2021-03-30;1736;119;44244;19275;15.9;6.9
12;2021-03-31;1460;102;45704;19377;16.4;7.0
12;2021-04-01;1958;156;47662;19533;17.1;7.0
12;2021-04-02;1614;341;49276;19874;17.7;7.1
12;2021-04-03;882;94;50158;19968;18.0;7.2
12;2021-04-04;1;0;50159;19968;18.0;7.2
12;2021-04-05;645;11;50804;19979;18.3;7.2
12;2021-04-06;1153;535;51957;20514;18.7;7.4
12;2021-04-07;1649;630;53606;21144;19.3;7.6
12;2021-04-08;2097;558;55703;21702;20.0;7.8
12;2021-04-09;2111;639;57814;22341;20.8;8.0
12;2021-04-10;1427;216;59241;22557;21.3;8.1
12;2021-04-11;120;1;59361;22558;21.3;8.1
12;2021-04-12;1837;501;61198;23059;22.0;8.3
12;2021-04-13;1906;774;63104;23833;22.7;8.6
12;2021-04-14;1831;1316;64935;25149;23.3;9.0
12;2021-04-15;1937;897;66872;26046;24.0;9.4
12;2021-04-16;1675;1201;68547;27247;24.6;9.8
12;2021-04-17;1554;565;70101;27812;25.2;10.0
12;2021-04-18;0;0;70101;27812;25.2;10.0
12;2021-04-19;1687;548;71788;28360;25.8;10.2
12;2021-04-20;1545;982;73333;29342;26.3;10.5
12;2021-04-21;1690;1179;75023;30521;27.0;11.0
12;2021-04-22;1689;1095;76712;31616;27.6;11.4
12;2021-04-23;1384;1330;78096;32946;28.1;11.8
12;2021-04-24;1451;719;79547;33665;28.6;12.1
12;2021-04-25;60;0;79607;33665;28.6;12.1
12;2021-04-26;1460;898;81067;34563;29.1;12.4
12;2021-04-27;1320;1279;82387;35842;29.6;12.9
12;2021-04-28;1113;1870;83500;37712;30.0;13.5
12;2021-04-29;1571;1912;85071;39624;30.6;14.2
12;2021-04-30;1812;1833;86883;41457;31.2;14.9
12;2021-05-01;1615;259;88498;41716;31.8;15.0
12;2021-05-02;5;0;88503;41716;31.8;15.0
12;2021-05-03;1712;1247;90215;42963;32.4;15.4
12;2021-05-04;1481;1392;91696;44355;32.9;15.9
12;2021-05-05;1292;1675;92988;46030;33.4;16.5
12;2021-05-06;1753;1377;94741;47407;34.0;17.0
12;2021-05-07;1481;1775;96222;49182;34.6;17.7
12;2021-05-08;1330;461;97552;49643;35.0;17.8
12;2021-05-09;13;34;97565;49677;35.0;17.8
12;2021-05-10;826;2217;98391;51894;35.3;18.6
12;2021-05-11;931;1851;99322;53745;35.7;19.3
12;2021-05-12;949;1821;100271;55566;36.0;20.0
12;2021-05-13;1587;810;101858;56376;36.6;20.3
12;2021-05-14;1236;1532;103094;57908;37.0;20.8
12;2021-05-15;1068;1113;104162;59021;37.4;21.2
12;2021-05-16;2;19;104164;59040;37.4;21.2
12;2021-05-17;1082;1811;105246;60851;37.8;21.9
12;2021-05-18;1427;1534;106673;62385;38.3;22.4
12;2021-05-19;1915;1328;108588;63713;39.0;22.9
12;2021-05-20;2114;873;110702;64586;39.8;23.2
12;2021-05-21;1822;1252;112524;65838;40.4;23.7
12;2021-05-22;1206;1013;113730;66851;40.9;24.0
12;2021-05-23;7;12;113737;66863;40.9;24.0
12;2021-05-24;1956;539;115693;67402;41.6;24.2
12;2021-05-25;1737;1160;117430;68562;42.2;24.6
12;2021-05-26;1998;778;119428;69340;42.9;24.9
12;2021-05-27;2164;743;121592;70083;43.7;25.2
12;2021-05-28;1928;1032;123520;71115;44.4;25.5
12;2021-05-29;1637;804;125157;71919;45.0;25.8
12;2021-05-30;9;43;125166;71962;45.0;25.9
12;2021-05-31;1699;814;126865;72776;45.6;26.1
12;2021-06-01;1889;1028;128754;73804;46.3;26.5
12;2021-06-02;1978;1050;130732;74854;47.0;26.9
12;2021-06-03;2121;830;132853;75684;47.7;27.2
12;2021-06-04;1966;1415;134819;77099;48.4;27.7
12;2021-06-05;1738;984;136557;78083;49.1;28.1
12;2021-06-06;5;6;136562;78089;49.1;28.1
12;2021-06-07;1091;1806;137653;79895;49.5;28.7
12;2021-06-08;1333;1200;138986;81095;49.9;29.1
12;2021-06-09;894;1290;139880;82385;50.3;29.6
12;2021-06-10;1022;917;140902;83302;50.6;29.9
12;2021-06-11;1202;2080;142104;85382;51.1;30.7
12;2021-06-12;1033;1319;143137;86701;51.4;31.1
12;2021-06-13;6;47;143143;86748;51.4;31.2
12;2021-06-14;661;1830;143804;88578;51.7;31.8
12;2021-06-15;745;1882;144549;90460;51.9;32.5
12;2021-06-16;821;1816;145370;92276;52.2;33.1
12;2021-06-17;678;995;146048;93271;52.5;33.5
12;2021-06-18;1134;1838;147182;95109;52.9;34.2
12;2021-06-19;915;1405;148097;96514;53.2;34.7
12;2021-06-20;4;10;148101;96524;53.2;34.7
12;2021-06-21;510;1738;148611;98262;53.4;35.3
12;2021-06-22;503;1474;149114;99736;53.6;35.8
12;2021-06-23;579;1307;149693;101043;53.8;36.3
12;2021-06-24;249;544;149942;101587;53.9;36.5
12;2021-06-25;872;1836;150814;103423;54.2;37.2
12;2021-06-26;673;1526;151487;104949;54.4;37.7
12;2021-06-27;1;9;151488;104958;54.4;37.7
12;2021-06-28;468;2452;151956;107410;54.6;38.6
12;2021-06-29;565;1957;152521;109367;54.8;39.3
12;2021-06-30;830;2132;153351;111499;55.1;40.1
12;2021-07-01;343;1086;153694;112585;55.2;40.4
12;2021-07-02;794;2626;154488;115211;55.5;41.4
12;2021-07-03;564;1872;155052;117083;55.7;42.1
12;2021-07-04;1;0;155053;117083;55.7;42.1
12;2021-07-05;439;2409;155492;119492;55.9;42.9
12;2021-07-06;638;2498;156130;121990;56.1;43.8
12;2021-07-07;686;2118;156816;124108;56.3;44.6
12;2021-07-08;293;913;157109;125021;56.4;44.9
12;2021-07-09;716;2592;157825;127613;56.7;45.8
12;2021-07-10;443;2077;158268;129690;56.9;46.6
12;2021-07-11;0;0;158268;129690;56.9;46.6
12;2021-07-12;582;2441;158850;132131;57.1;47.5
12;2021-07-13;834;2590;159684;134721;57.4;48.4
12;2021-07-14;44;25;159728;134746;57.4;48.4
12;2021-07-15;790;2109;160518;136855;57.7;49.2
12;2021-07-16;1236;2557;161754;139412;58.1;50.1
12;2021-07-17;783;2009;162537;141421;58.4;50.8
12;2021-07-18;22;11;162559;141432;58.4;50.8
12;2021-07-19;1307;2005;163866;143437;58.9;51.5
12;2021-07-20;1415;1473;165281;144910;59.4;52.1
12;2021-07-21;1009;937;166290;145847;59.7;52.4
12;2021-07-22;2214;1301;168504;147148;60.5;52.9
12;2021-07-23;1854;2064;170358;149212;61.2;53.6
12;2021-07-24;1597;1565;171955;150777;61.8;54.2
12;2021-07-25;96;29;172051;150806;61.8;54.2
12;2021-07-26;1910;1434;173961;152240;62.5;54.7
12;2021-07-27;2204;1007;176165;153247;63.3;55.1
12;2021-07-28;1698;669;177863;153916;63.9;55.3
12;2021-07-29;1172;794;179035;154710;64.3;55.6
12;2021-07-30;2487;1277;181522;155987;65.2;56.0
12;2021-07-31;1954;1003;183476;156990;65.9;56.4
12;2021-08-01;225;37;183701;157027;66.0;56.4
12;2021-08-02;1807;833;185508;157860;66.6;56.7
12;2021-08-03;1948;769;187456;158629;67.3;57.0
12;2021-08-04;1679;826;189135;159455;67.9;57.3
12;2021-08-05;1623;676;190758;160131;68.5;57.5
13;2020-12-27;3;0;3;0;0.0;0.0
13;2020-12-28;1;0;4;0;0.0;0.0
13;2020-12-29;0;0;4;0;0.0;0.0
13;2020-12-30;0;0;4;0;0.0;0.0
13;2020-12-31;5;0;9;0;0.0;0.0
13;2021-01-01;3;0;12;0;0.0;0.0
13;2021-01-02;3;0;15;0;0.0;0.0
13;2021-01-03;4;0;19;0;0.0;0.0
13;2021-01-04;0;0;19;0;0.0;0.0
13;2021-01-05;78;0;97;0;0.0;0.0
13;2021-01-06;118;0;215;0;0.0;0.0
13;2021-01-07;174;1;389;1;0.0;0.0
13;2021-01-08;188;0;577;1;0.0;0.0
13;2021-01-09;10;0;587;1;0.0;0.0
13;2021-01-10;2;0;589;1;0.0;0.0
13;2021-01-11;480;1;1069;2;0.1;0.0
13;2021-01-12;813;1;1882;3;0.1;0.0
13;2021-01-13;1083;1;2965;4;0.1;0.0
13;2021-01-14;1566;16;4531;20;0.2;0.0
13;2021-01-15;1534;6;6065;26;0.3;0.0
13;2021-01-16;407;2;6472;28;0.3;0.0
13;2021-01-17;41;0;6513;28;0.3;0.0
13;2021-01-18;2374;9;8887;37;0.4;0.0
13;2021-01-19;7402;28;16289;65;0.8;0.0
13;2021-01-20;5552;16;21841;81;1.1;0.0
13;2021-01-21;5348;26;27189;107;1.3;0.0
13;2021-01-22;3991;17;31180;124;1.5;0.0
13;2021-01-23;1335;6;32515;130;1.6;0.0
13;2021-01-24;490;4;33005;134;1.6;0.0
13;2021-01-25;2335;25;35340;159;1.7;0.0
13;2021-01-26;2947;89;38287;248;1.9;0.0
13;2021-01-27;3113;121;41400;369;2.0;0.0
13;2021-01-28;3240;191;44640;560;2.2;0.0
13;2021-01-29;2506;124;47146;684;2.3;0.0
13;2021-01-30;1021;10;48167;694;2.4;0.0
13;2021-01-31;248;0;48415;694;2.4;0.0
13;2021-02-01;1854;295;50269;989;2.5;0.0
13;2021-02-02;2254;616;52523;1605;2.6;0.1
13;2021-02-03;1861;579;54384;2184;2.7;0.1
13;2021-02-04;1899;931;56283;3115;2.8;0.2
13;2021-02-05;2625;1560;58908;4675;2.9;0.2
13;2021-02-06;848;314;59756;4989;2.9;0.2
13;2021-02-07;274;6;60030;4995;3.0;0.2
13;2021-02-08;1896;1547;61926;6542;3.0;0.3
13;2021-02-09;3308;4451;65234;10993;3.2;0.5
13;2021-02-10;3218;3431;68452;14424;3.4;0.7
13;2021-02-11;3572;3585;72024;18009;3.5;0.9
13;2021-02-12;2826;3156;74850;21165;3.7;1.0
13;2021-02-13;733;597;75583;21762;3.7;1.1
13;2021-02-14;72;378;75655;22140;3.7;1.1
13;2021-02-15;966;2033;76621;24173;3.8;1.2
13;2021-02-16;1392;2645;78013;26818;3.8;1.3
13;2021-02-17;1344;3007;79357;29825;3.9;1.5
13;2021-02-18;1897;2690;81254;32515;4.0;1.6
13;2021-02-19;1514;2191;82768;34706;4.1;1.7
13;2021-02-20;456;789;83224;35495;4.1;1.7
13;2021-02-21;33;286;83257;35781;4.1;1.8
13;2021-02-22;1022;2267;84279;38048;4.1;1.9
13;2021-02-23;1277;2679;85556;40727;4.2;2.0
13;2021-02-24;1505;2625;87061;43352;4.3;2.1
13;2021-02-25;2383;2158;89444;45510;4.4;2.2
13;2021-02-26;2456;2114;91900;47624;4.5;2.3
13;2021-02-27;981;749;92881;48373;4.6;2.4
13;2021-02-28;192;204;93073;48577;4.6;2.4
13;2021-03-01;1914;1531;94987;50108;4.7;2.5
13;2021-03-02;3003;2622;97990;52730;4.8;2.6
13;2021-03-03;3479;2619;101469;55349;5.0;2.7
13;2021-03-04;4195;3164;105664;58513;5.2;2.9
13;2021-03-05;4041;2789;109705;61302;5.4;3.0
13;2021-03-06;5294;829;114999;62131;5.7;3.1
13;2021-03-07;4289;361;119288;62492;5.9;3.1
13;2021-03-08;3924;1994;123212;64486;6.1;3.2
13;2021-03-09;5072;2267;128284;66753;6.3;3.3
13;2021-03-10;5173;1974;133457;68727;6.6;3.4
13;2021-03-11;7300;2121;140757;70848;6.9;3.5
13;2021-03-12;8315;2085;149072;72933;7.3;3.6
13;2021-03-13;6374;708;155446;73641;7.6;3.6
13;2021-03-14;2311;153;157757;73794;7.8;3.6
13;2021-03-15;6350;1284;164107;75078;8.1;3.7
13;2021-03-16;5073;1512;169180;76590;8.3;3.8
13;2021-03-17;5173;1384;174353;77974;8.6;3.8
13;2021-03-18;5817;1860;180170;79834;8.9;3.9
13;2021-03-19;6801;1607;186971;81441;9.2;4.0
13;2021-03-20;4037;691;191008;82132;9.4;4.0
13;2021-03-21;724;82;191732;82214;9.4;4.0
13;2021-03-22;7293;1547;199025;83761;9.8;4.1
13;2021-03-23;9119;1728;208144;85489;10.2;4.2
13;2021-03-24;8853;2178;216997;87667;10.7;4.3
13;2021-03-25;10907;2082;227904;89749;11.2;4.4
13;2021-03-26;10704;1878;238608;91627;11.7;4.5
13;2021-03-27;4864;826;243472;92453;12.0;4.5
13;2021-03-28;1117;80;244589;92533;12.0;4.5
13;2021-03-29;7573;1982;252162;94515;12.4;4.6
13;2021-03-30;12598;2476;264760;96991;13.0;4.8
13;2021-03-31;10807;3122;275567;100113;13.5;4.9
13;2021-04-01;12250;3042;287817;103155;14.1;5.1
13;2021-04-02;9789;3875;297606;107030;14.6;5.3
13;2021-04-03;4004;2801;301610;109831;14.8;5.4
13;2021-04-04;628;304;302238;110135;14.9;5.4
13;2021-04-05;3528;718;305766;110853;15.0;5.4
13;2021-04-06;8512;4236;314278;115089;15.4;5.7
13;2021-04-07;10074;4667;324352;119756;15.9;5.9
13;2021-04-08;10104;5444;334456;125200;16.4;6.2
13;2021-04-09;11251;5095;345707;130295;17.0;6.4
13;2021-04-10;7298;2077;353005;132372;17.4;6.5
13;2021-04-11;1377;533;354382;132905;17.4;6.5
13;2021-04-12;7977;4773;362359;137678;17.8;6.8
13;2021-04-13;9140;5464;371499;143142;18.3;7.0
13;2021-04-14;9529;5794;381028;148936;18.7;7.3
13;2021-04-15;9870;5940;390898;154876;19.2;7.6
13;2021-04-16;9967;5548;400865;160424;19.7;7.9
13;2021-04-17;4077;2011;404942;162435;19.9;8.0
13;2021-04-18;2523;1420;407465;163855;20.0;8.1
13;2021-04-19;6449;6396;413914;170251;20.3;8.4
13;2021-04-20;7397;7592;421311;177843;20.7;8.7
13;2021-04-21;7773;7360;429084;185203;21.1;9.1
13;2021-04-22;8462;7911;437546;193114;21.5;9.5
13;2021-04-23;8363;6766;445909;199880;21.9;9.8
13;2021-04-24;4620;3819;450529;203699;22.1;10.0
13;2021-04-25;873;524;451402;204223;22.2;10.0
13;2021-04-26;6167;7106;457569;211329;22.5;10.4
13;2021-04-27;7258;8016;464827;219345;22.8;10.8
13;2021-04-28;9449;7705;474276;227050;23.3;11.2
13;2021-04-29;11404;7539;485680;234589;23.9;11.5
13;2021-04-30;10921;7302;496601;241891;24.4;11.9
13;2021-05-01;5367;3785;501968;245676;24.7;12.1
13;2021-05-02;2098;745;504066;246421;24.8;12.1
13;2021-05-03;7301;7851;511367;254272;25.1;12.5
13;2021-05-04;8442;8512;519809;262784;25.6;12.9
13;2021-05-05;8229;8960;528038;271744;26.0;13.4
13;2021-05-06;10136;8581;538174;280325;26.5;13.8
13;2021-05-07;8849;10025;547023;290350;26.9;14.3
13;2021-05-08;4565;3926;551588;294276;27.1;14.5
13;2021-05-09;936;684;552524;294960;27.2;14.5
13;2021-05-10;7715;8758;560239;303718;27.5;14.9
13;2021-05-11;10976;9563;571215;313281;28.1;15.4
13;2021-05-12;12840;8713;584055;321994;28.7;15.8
13;2021-05-13;9507;3627;593562;325621;29.2;16.0
13;2021-05-14;13659;6444;607221;332065;29.8;16.3
13;2021-05-15;10202;4524;617423;336589;30.3;16.5
13;2021-05-16;3123;788;620546;337377;30.5;16.6
13;2021-05-17;10845;6811;631391;344188;31.0;16.9
13;2021-05-18;11908;6466;643299;350654;31.6;17.2
13;2021-05-19;12156;6338;655455;356992;32.2;17.5
13;2021-05-20;13445;6446;668900;363438;32.9;17.9
13;2021-05-21;12994;6769;681894;370207;33.5;18.2
13;2021-05-22;7514;3631;689408;373838;33.9;18.4
13;2021-05-23;863;639;690271;374477;33.9;18.4
13;2021-05-24;6765;2472;697036;376949;34.3;18.5
13;2021-05-25;9271;7591;706307;384540;34.7;18.9
13;2021-05-26;10137;7836;716444;392376;35.2;19.3
13;2021-05-27;10349;8413;726793;400789;35.7;19.7
13;2021-05-28;8992;9167;735785;409956;36.2;20.2
13;2021-05-29;7174;4628;742959;414584;36.5;20.4
13;2021-05-30;890;527;743849;415111;36.6;20.4
13;2021-05-31;8188;8030;752037;423141;37.0;20.8
13;2021-06-01;9581;9300;761618;432441;37.4;21.3
13;2021-06-02;10077;8793;771695;441234;37.9;21.7
13;2021-06-03;12279;9480;783974;450714;38.5;22.2
13;2021-06-04;12033;10037;796007;460751;39.1;22.6
13;2021-06-05;7824;5578;803831;466329;39.5;22.9
13;2021-06-06;1670;882;805501;467211;39.6;23.0
13;2021-06-07;6686;9882;812187;477093;39.9;23.5
13;2021-06-08;8311;9982;820498;487075;40.3;23.9
13;2021-06-09;8389;9734;828887;496809;40.7;24.4
13;2021-06-10;8931;9761;837818;506570;41.2;24.9
13;2021-06-11;8229;12693;846047;519263;41.6;25.5
13;2021-06-12;5786;6706;851833;525969;41.9;25.9
13;2021-06-13;950;1214;852783;527183;41.9;25.9
13;2021-06-14;5998;11134;858781;538317;42.2;26.5
13;2021-06-15;7278;11396;866059;549713;42.6;27.0
13;2021-06-16;7335;9876;873394;559589;42.9;27.5
13;2021-06-17;7424;10698;880818;570287;43.3;28.0
13;2021-06-18;7498;11068;888316;581355;43.7;28.6
13;2021-06-19;4608;7482;892924;588837;43.9;28.9
13;2021-06-20;955;1044;893879;589881;43.9;29.0
13;2021-06-21;4460;12252;898339;602133;44.2;29.6
13;2021-06-22;4926;13865;903265;615998;44.4;30.3
13;2021-06-23;5128;13566;908393;629564;44.7;30.9
13;2021-06-24;5309;12835;913702;642399;44.9;31.6
13;2021-06-25;5187;14673;918889;657072;45.2;32.3
13;2021-06-26;3018;9670;921907;666742;45.3;32.8
13;2021-06-27;534;930;922441;667672;45.3;32.8
13;2021-06-28;3712;12549;926153;680221;45.5;33.4
13;2021-06-29;4412;12892;930565;693113;45.7;34.1
13;2021-06-30;4816;12684;935381;705797;46.0;34.7
13;2021-07-01;5404;11466;940785;717263;46.2;35.3
13;2021-07-02;5483;12385;946268;729648;46.5;35.9
13;2021-07-03;3482;9155;949750;738803;46.7;36.3
13;2021-07-04;473;868;950223;739671;46.7;36.4
13;2021-07-05;3701;11777;953924;751448;46.9;36.9
13;2021-07-06;5407;11677;959331;763125;47.2;37.5
13;2021-07-07;5575;10679;964906;773804;47.4;38.0
13;2021-07-08;6177;10300;971083;784104;47.7;38.5
13;2021-07-09;5888;11907;976971;796011;48.0;39.1
13;2021-07-10;3147;8640;980118;804651;48.2;39.6
13;2021-07-11;430;1012;980548;805663;48.2;39.6
13;2021-07-12;4446;10959;984994;816622;48.4;40.1
13;2021-07-13;8918;13120;993912;829742;48.9;40.8
13;2021-07-14;5573;4828;999485;834570;49.1;41.0
13;2021-07-15;11331;12870;1010816;847440;49.7;41.7
13;2021-07-16;12069;12856;1022885;860296;50.3;42.3
13;2021-07-17;6537;8442;1029422;868738;50.6;42.7
13;2021-07-18;716;1057;1030138;869795;50.6;42.8
13;2021-07-19;9719;11116;1039857;880911;51.1;43.3
13;2021-07-20;12167;11605;1052024;892516;51.7;43.9
13;2021-07-21;12577;10254;1064601;902770;52.3;44.4
13;2021-07-22;14459;10345;1079060;913115;53.0;44.9
13;2021-07-23;14319;10834;1093379;923949;53.7;45.4
13;2021-07-24;8283;7922;1101662;931871;54.1;45.8
13;2021-07-25;1008;783;1102670;932654;54.2;45.8
13;2021-07-26;11546;9002;1114216;941656;54.8;46.3
13;2021-07-27;13423;9282;1127639;950938;55.4;46.7
13;2021-07-28;12233;8088;1139872;959026;56.0;47.1
13;2021-07-29;13697;8016;1153569;967042;56.7;47.5
13;2021-07-30;13502;8522;1167071;975564;57.4;48.0
13;2021-07-31;8604;5751;1175675;981315;57.8;48.2
13;2021-08-01;1098;706;1176773;982021;57.8;48.3
13;2021-08-02;9913;6589;1186686;988610;58.3;48.6
13;2021-08-03;10857;7161;1197543;995771;58.9;48.9
13;2021-08-04;9236;6441;1206779;1002212;59.3;49.3
13;2021-08-05;9244;7367;1216023;1009579;59.8;49.6
14;2020-12-27;0;0;0;0;0.0;0.0
14;2020-12-28;1;1;1;1;0.0;0.0
14;2020-12-29;0;0;1;1;0.0;0.0
14;2020-12-30;0;0;1;1;0.0;0.0
14;2020-12-31;3;0;4;1;0.0;0.0
14;2021-01-01;1;0;5;1;0.0;0.0
14;2021-01-02;1;0;6;1;0.0;0.0
14;2021-01-03;0;0;6;1;0.0;0.0
14;2021-01-04;4;0;10;1;0.0;0.0
14;2021-01-05;13;0;23;1;0.0;0.0
14;2021-01-06;348;0;371;1;0.1;0.0
14;2021-01-07;396;2;767;3;0.1;0.0
14;2021-01-08;613;2;1380;5;0.2;0.0
14;2021-01-09;125;0;1505;5;0.2;0.0
14;2021-01-10;41;0;1546;5;0.2;0.0
14;2021-01-11;663;1;2209;6;0.3;0.0
14;2021-01-12;934;0;3143;6;0.5;0.0
14;2021-01-13;847;1;3990;7;0.6;0.0
14;2021-01-14;2799;17;6789;24;1.0;0.0
14;2021-01-15;1876;17;8665;41;1.3;0.0
14;2021-01-16;271;2;8936;43;1.3;0.0
14;2021-01-17;145;4;9081;47;1.3;0.0
14;2021-01-18;1084;3;10165;50;1.5;0.0
14;2021-01-19;1149;2;11314;52;1.6;0.0
14;2021-01-20;1987;4;13301;56;1.9;0.0
14;2021-01-21;1811;5;15112;61;2.2;0.0
14;2021-01-22;1487;2;16599;63;2.4;0.0
14;2021-01-23;297;1;16896;64;2.4;0.0
14;2021-01-24;71;0;16967;64;2.5;0.0
14;2021-01-25;910;10;17877;74;2.6;0.0
14;2021-01-26;846;37;18723;111;2.7;0.0
14;2021-01-27;882;158;19605;269;2.8;0.0
14;2021-01-28;781;143;20386;412;2.9;0.1
14;2021-01-29;781;229;21167;641;3.1;0.1
14;2021-01-30;269;12;21436;653;3.1;0.1
14;2021-01-31;58;3;21494;656;3.1;0.1
14;2021-02-01;727;230;22221;886;3.2;0.1
14;2021-02-02;824;424;23045;1310;3.3;0.2
14;2021-02-03;747;388;23792;1698;3.4;0.2
14;2021-02-04;1168;2060;24960;3758;3.6;0.5
14;2021-02-05;1293;1316;26253;5074;3.8;0.7
14;2021-02-06;394;240;26647;5314;3.9;0.8
14;2021-02-07;179;73;26826;5387;3.9;0.8
14;2021-02-08;774;825;27600;6212;4.0;0.9
14;2021-02-09;719;1009;28319;7221;4.1;1.0
14;2021-02-10;824;1611;29143;8832;4.2;1.3
14;2021-02-11;1350;1433;30493;10265;4.4;1.5
14;2021-02-12;1380;1081;31873;11346;4.6;1.6
14;2021-02-13;308;185;32181;11531;4.7;1.7
14;2021-02-14;84;66;32265;11597;4.7;1.7
14;2021-02-15;442;1087;32707;12684;4.7;1.8
14;2021-02-16;677;983;33384;13667;4.8;2.0
14;2021-02-17;405;984;33789;14651;4.9;2.1
14;2021-02-18;705;886;34494;15537;5.0;2.2
14;2021-02-19;733;781;35227;16318;5.1;2.4
14;2021-02-20;88;271;35315;16589;5.1;2.4
14;2021-02-21;6;90;35321;16679;5.1;2.4
14;2021-02-22;432;1049;35753;17728;5.2;2.6
14;2021-02-23;486;919;36239;18647;5.2;2.7
14;2021-02-24;439;897;36678;19544;5.3;2.8
14;2021-02-25;1222;1175;37900;20719;5.5;3.0
14;2021-02-26;1576;1166;39476;21885;5.7;3.2
14;2021-02-27;506;270;39982;22155;5.8;3.2
14;2021-02-28;27;42;40009;22197;5.8;3.2
14;2021-03-01;521;929;40530;23126;5.9;3.3
14;2021-03-02;967;809;41497;23935;6.0;3.5
14;2021-03-03;1077;832;42574;24767;6.2;3.6
14;2021-03-04;1947;787;44521;25554;6.4;3.7
14;2021-03-05;2429;870;46950;26424;6.8;3.8
14;2021-03-06;3074;199;50024;26623;7.2;3.9
14;2021-03-07;1195;60;51219;26683;7.4;3.9
14;2021-03-08;1249;812;52468;27495;7.6;4.0
14;2021-03-09;1741;693;54209;28188;7.8;4.1
14;2021-03-10;1834;587;56043;28775;8.1;4.2
14;2021-03-11;2750;471;58793;29246;8.5;4.2
14;2021-03-12;4043;559;62836;29805;9.1;4.3
14;2021-03-13;1851;173;64687;29978;9.4;4.3
14;2021-03-14;30;39;64717;30017;9.4;4.3
14;2021-03-15;2005;136;66722;30153;9.6;4.4
14;2021-03-16;1400;277;68122;30430;9.9;4.4
14;2021-03-17;1155;195;69277;30625;10.0;4.4
14;2021-03-18;1479;304;70756;30929;10.2;4.5
14;2021-03-19;2602;265;73358;31194;10.6;4.5
14;2021-03-20;2655;34;76013;31228;11.0;4.5
14;2021-03-21;453;8;76466;31236;11.1;4.5
14;2021-03-22;1870;356;78336;31592;11.3;4.6
14;2021-03-23;2176;321;80512;31913;11.6;4.6
14;2021-03-24;2432;193;82944;32106;12.0;4.6
14;2021-03-25;3290;317;86234;32423;12.5;4.7
14;2021-03-26;4606;464;90840;32887;13.1;4.8
14;2021-03-27;2231;226;93071;33113;13.5;4.8
14;2021-03-28;36;1;93107;33114;13.5;4.8
14;2021-03-29;1609;481;94716;33595;13.7;4.9
14;2021-03-30;2718;514;97434;34109;14.1;4.9
14;2021-03-31;2322;915;99756;35024;14.4;5.1
14;2021-04-01;4173;1668;103929;36692;15.0;5.3
14;2021-04-02;3864;1261;107793;37953;15.6;5.5
14;2021-04-03;1129;1202;108922;39155;15.8;5.7
14;2021-04-04;25;482;108947;39637;15.8;5.7
14;2021-04-05;1217;321;110164;39958;15.9;5.8
14;2021-04-06;2384;993;112548;40951;16.3;5.9
14;2021-04-07;2726;1032;115274;41983;16.7;6.1
14;2021-04-08;4299;1110;119573;43093;17.3;6.2
14;2021-04-09;6029;1167;125602;44260;18.2;6.4
14;2021-04-10;2894;432;128496;44692;18.6;6.5
14;2021-04-11;628;120;129124;44812;18.7;6.5
14;2021-04-12;2913;1583;132037;46395;19.1;6.7
14;2021-04-13;3470;1445;135507;47840;19.6;6.9
14;2021-04-14;3112;1164;138619;49004;20.0;7.1
14;2021-04-15;4397;1510;143016;50514;20.7;7.3
14;2021-04-16;4601;1555;147617;52069;21.3;7.5
14;2021-04-17;2314;1662;149931;53731;21.7;7.8
14;2021-04-18;539;325;150470;54056;21.8;7.8
14;2021-04-19;2758;1708;153228;55764;22.2;8.1
14;2021-04-20;3388;1829;156616;57593;22.7;8.3
14;2021-04-21;3008;1465;159624;59058;23.1;8.5
14;2021-04-22;4224;2080;163848;61138;23.7;8.8
14;2021-04-23;4642;2285;168490;63423;24.4;9.2
14;2021-04-24;1850;1752;170340;65175;24.6;9.4
14;2021-04-25;456;27;170796;65202;24.7;9.4
14;2021-04-26;3373;1566;174169;66768;25.2;9.7
14;2021-04-27;3502;2572;177671;69340;25.7;10.0
14;2021-04-28;3241;1895;180912;71235;26.2;10.3
14;2021-04-29;4546;2307;185458;73542;26.8;10.6
14;2021-04-30;5119;2639;190577;76181;27.6;11.0
14;2021-05-01;3553;193;194130;76374;28.1;11.0
14;2021-05-02;1237;54;195367;76428;28.3;11.1
14;2021-05-03;2483;2764;197850;79192;28.6;11.5
14;2021-05-04;3128;2906;200978;82098;29.1;11.9
14;2021-05-05;3685;2754;204663;84852;29.6;12.3
14;2021-05-06;4931;3478;209594;88330;30.3;12.8
14;2021-05-07;4867;3854;214461;92184;31.0;13.3
14;2021-05-08;2728;1262;217189;93446;31.4;13.5
14;2021-05-09;1916;667;219105;94113;31.7;13.6
14;2021-05-10;3633;3149;222738;97262;32.2;14.1
14;2021-05-11;4345;3603;227083;100865;32.8;14.6
14;2021-05-12;4049;3217;231132;104082;33.4;15.1
14;2021-05-13;4691;1131;235823;105213;34.1;15.2
14;2021-05-14;6671;2629;242494;107842;35.1;15.6
14;2021-05-15;5143;774;247637;108616;35.8;15.7
14;2021-05-16;2318;121;249955;108737;36.1;15.7
14;2021-05-17;2822;2263;252777;111000;36.6;16.1
14;2021-05-18;4087;2240;256864;113240;37.1;16.4
14;2021-05-19;3749;2017;260613;115257;37.7;16.7
14;2021-05-20;4478;2761;265091;118018;38.3;17.1
14;2021-05-21;4271;3527;269362;121545;39.0;17.6
14;2021-05-22;1670;866;271032;122411;39.2;17.7
14;2021-05-23;648;71;271680;122482;39.3;17.7
14;2021-05-24;2844;747;274524;123229;39.7;17.8
14;2021-05-25;3631;3389;278155;126618;40.2;18.3
14;2021-05-26;3432;2408;281587;129026;40.7;18.7
14;2021-05-27;4770;3236;286357;132262;41.4;19.1
14;2021-05-28;5087;3892;291444;136154;42.1;19.7
14;2021-05-29;2341;2458;293785;138612;42.5;20.0
14;2021-05-30;759;239;294544;138851;42.6;20.1
14;2021-05-31;4093;2966;298637;141817;43.2;20.5
14;2021-06-01;5741;3217;304378;145034;44.0;21.0
14;2021-06-02;5028;2851;309406;147885;44.7;21.4
14;2021-06-03;6661;4012;316067;151897;45.7;22.0
14;2021-06-04;6446;5136;322513;157033;46.6;22.7
14;2021-06-05;4354;1865;326867;158898;47.3;23.0
14;2021-06-06;2041;83;328908;158981;47.6;23.0
14;2021-06-07;4248;3450;333156;162431;48.2;23.5
14;2021-06-08;5236;3128;338392;165559;48.9;23.9
14;2021-06-09;4273;2965;342665;168524;49.6;24.4
14;2021-06-10;5079;2966;347744;171490;50.3;24.8
14;2021-06-11;4838;4888;352582;176378;51.0;25.5
14;2021-06-12;3680;4507;356262;180885;51.5;26.2
14;2021-06-13;848;1090;357110;181975;51.6;26.3
14;2021-06-14;2184;3792;359294;185767;52.0;26.9
14;2021-06-15;3312;3970;362606;189737;52.4;27.4
14;2021-06-16;3446;4554;366052;194291;52.9;28.1
14;2021-06-17;4232;5264;370284;199555;53.6;28.9
14;2021-06-18;3730;6117;374014;205672;54.1;29.7
14;2021-06-19;2587;2949;376601;208621;54.5;30.2
14;2021-06-20;579;1556;377180;210177;54.5;30.4
14;2021-06-21;2122;4360;379302;214537;54.9;31.0
14;2021-06-22;2580;5177;381882;219714;55.2;31.8
14;2021-06-23;2502;4346;384384;224060;55.6;32.4
14;2021-06-24;3450;5804;387834;229864;56.1;33.2
14;2021-06-25;2742;7277;390576;237141;56.5;34.3
14;2021-06-26;2171;4540;392747;241681;56.8;35.0
14;2021-06-27;440;1829;393187;243510;56.9;35.2
14;2021-06-28;1306;3968;394493;247478;57.1;35.8
14;2021-06-29;1785;5362;396278;252840;57.3;36.6
14;2021-06-30;1980;4616;398258;257456;57.6;37.2
14;2021-07-01;2925;5066;401183;262522;58.0;38.0
14;2021-07-02;2587;6666;403770;269188;58.4;38.9
14;2021-07-03;1426;2647;405196;271835;58.6;39.3
14;2021-07-04;422;714;405618;272549;58.7;39.4
14;2021-07-05;1189;4780;406807;277329;58.8;40.1
14;2021-07-06;2081;6000;408888;283329;59.1;41.0
14;2021-07-07;2251;4582;411139;287911;59.5;41.6
14;2021-07-08;2902;5521;414041;293432;59.9;42.4
14;2021-07-09;2760;6446;416801;299878;60.3;43.4
14;2021-07-10;2032;3202;418833;303080;60.6;43.8
14;2021-07-11;897;873;419730;303953;60.7;44.0
14;2021-07-12;1624;5910;421354;309863;60.9;44.8
14;2021-07-13;3055;7342;424409;317205;61.4;45.9
14;2021-07-14;2239;3054;426648;320259;61.7;46.3
14;2021-07-15;4141;7662;430789;327921;62.3;47.4
14;2021-07-16;4677;7701;435466;335622;63.0;48.5
14;2021-07-17;2096;4207;437562;339829;63.3;49.1
14;2021-07-18;808;1869;438370;341698;63.4;49.4
14;2021-07-19;2566;6121;440936;347819;63.8;50.3
14;2021-07-20;3232;7263;444168;355082;64.2;51.4
14;2021-07-21;4081;5832;448249;360914;64.8;52.2
14;2021-07-22;4743;6593;452992;367507;65.5;53.1
14;2021-07-23;5352;6758;458344;374265;66.3;54.1
14;2021-07-24;3068;3783;461412;378048;66.7;54.7
14;2021-07-25;1498;1244;462910;379292;66.9;54.9
14;2021-07-26;4660;4182;467570;383474;67.6;55.5
14;2021-07-27;5358;4348;472928;387822;68.4;56.1
14;2021-07-28;5087;3961;478015;391783;69.1;56.7
14;2021-07-29;6390;4876;484405;396659;70.1;57.4
14;2021-07-30;5788;5155;490193;401814;70.9;58.1
14;2021-07-31;2756;2498;492949;404312;71.3;58.5
14;2021-08-01;1890;927;494839;405239;71.6;58.6
14;2021-08-02;3880;4286;498719;409525;72.1;59.2
14;2021-08-03;4441;4149;503160;413674;72.8;59.8
14;2021-08-04;4520;3520;507680;417194;73.4;60.3
14;2021-08-05;4567;4014;512247;421208;74.1;60.9
15;2020-12-27;2;0;2;0;0.0;0.0
15;2020-12-28;0;0;2;0;0.0;0.0
15;2020-12-29;0;0;2;0;0.0;0.0
15;2020-12-30;0;0;2;0;0.0;0.0
15;2020-12-31;0;0;2;0;0.0;0.0
15;2021-01-01;1;0;3;0;0.0;0.0
15;2021-01-02;0;0;3;0;0.0;0.0
15;2021-01-03;0;0;3;0;0.0;0.0
15;2021-01-04;0;0;3;0;0.0;0.0
15;2021-01-05;0;0;3;0;0.0;0.0
15;2021-01-06;0;0;3;0;0.0;0.0
15;2021-01-07;71;0;74;0;0.1;0.0
15;2021-01-08;107;0;181;0;0.1;0.0
15;2021-01-09;0;0;181;0;0.1;0.0
15;2021-01-10;1;0;182;0;0.1;0.0
15;2021-01-11;99;0;281;0;0.2;0.0
15;2021-01-12;92;0;373;0;0.3;0.0
15;2021-01-13;230;0;603;0;0.4;0.0
15;2021-01-14;308;1;911;1;0.6;0.0
15;2021-01-15;138;0;1049;1;0.7;0.0
15;2021-01-16;90;0;1139;1;0.8;0.0
15;2021-01-17;0;0;1139;1;0.8;0.0
15;2021-01-18;404;2;1543;3;1.1;0.0
15;2021-01-19;550;0;2093;3;1.5;0.0
15;2021-01-20;628;1;2721;4;1.9;0.0
15;2021-01-21;575;3;3296;7;2.3;0.0
15;2021-01-22;503;2;3799;9;2.7;0.0
15;2021-01-23;432;1;4231;10;3.0;0.0
15;2021-01-24;6;0;4237;10;3.0;0.0
15;2021-01-25;400;0;4637;10;3.2;0.0
15;2021-01-26;437;0;5074;10;3.6;0.0
15;2021-01-27;727;0;5801;10;4.1;0.0
15;2021-01-28;625;51;6426;61;4.5;0.0
15;2021-01-29;333;82;6759;143;4.7;0.1
15;2021-01-30;218;3;6977;146;4.9;0.1
15;2021-01-31;0;0;6977;146;4.9;0.1
15;2021-02-01;237;89;7214;235;5.1;0.2
15;2021-02-02;189;90;7403;325;5.2;0.2
15;2021-02-03;266;158;7669;483;5.4;0.3
15;2021-02-04;663;205;8332;688;5.8;0.5
15;2021-02-05;297;256;8629;944;6.0;0.7
15;2021-02-06;98;76;8727;1020;6.1;0.7
15;2021-02-07;0;0;8727;1020;6.1;0.7
15;2021-02-08;233;107;8960;1127;6.3;0.8
15;2021-02-09;205;118;9165;1245;6.4;0.9
15;2021-02-10;338;299;9503;1544;6.7;1.1
15;2021-02-11;116;240;9619;1784;6.7;1.2
15;2021-02-12;136;160;9755;1944;6.8;1.4
15;2021-02-13;92;78;9847;2022;6.9;1.4
15;2021-02-14;0;0;9847;2022;6.9;1.4
15;2021-02-15;63;215;9910;2237;6.9;1.6
15;2021-02-16;52;295;9962;2532;7.0;1.8
15;2021-02-17;142;471;10104;3003;7.1;2.1
15;2021-02-18;87;747;10191;3750;7.1;2.6
15;2021-02-19;90;432;10281;4182;7.2;2.9
15;2021-02-20;20;259;10301;4441;7.2;3.1
15;2021-02-21;0;0;10301;4441;7.2;3.1
15;2021-02-22;23;497;10324;4938;7.2;3.5
15;2021-02-23;180;457;10504;5395;7.4;3.8
15;2021-02-24;31;456;10535;5851;7.4;4.1
15;2021-02-25;228;1002;10763;6853;7.5;4.8
15;2021-02-26;186;476;10949;7329;7.7;5.1
15;2021-02-27;146;88;11095;7417;7.8;5.2
15;2021-02-28;1;0;11096;7417;7.8;5.2
15;2021-03-01;121;222;11217;7639;7.9;5.3
15;2021-03-02;250;307;11467;7946;8.0;5.6
15;2021-03-03;207;29;11674;7975;8.2;5.6
15;2021-03-04;246;249;11920;8224;8.3;5.8
15;2021-03-05;348;170;12268;8394;8.6;5.9
15;2021-03-06;680;11;12948;8405;9.1;5.9
15;2021-03-07;81;1;13029;8406;9.1;5.9
15;2021-03-08;93;106;13122;8512;9.2;6.0
15;2021-03-09;280;285;13402;8797;9.4;6.2
15;2021-03-10;416;161;13818;8958;9.7;6.3
15;2021-03-11;434;296;14252;9254;10.0;6.5
15;2021-03-12;524;94;14776;9348;10.3;6.5
15;2021-03-13;355;8;15131;9356;10.6;6.6
15;2021-03-14;18;0;15149;9356;10.6;6.6
15;2021-03-15;542;62;15691;9418;11.0;6.6
15;2021-03-16;328;20;16019;9438;11.2;6.6
15;2021-03-17;130;53;16149;9491;11.3;6.6
15;2021-03-18;250;95;16399;9586;11.5;6.7
15;2021-03-19;668;30;17067;9616;12.0;6.7
15;2021-03-20;148;36;17215;9652;12.1;6.8
15;2021-03-21;6;0;17221;9652;12.1;6.8
15;2021-03-22;574;77;17795;9729;12.5;6.8
15;2021-03-23;775;95;18570;9824;13.0;6.9
15;2021-03-24;936;34;19506;9858;13.7;6.9
15;2021-03-25;1282;29;20788;9887;14.6;6.9
15;2021-03-26;1009;54;21797;9941;15.3;7.0
15;2021-03-27;301;6;22098;9947;15.5;7.0
15;2021-03-28;20;0;22118;9947;15.5;7.0
15;2021-03-29;781;15;22899;9962;16.0;7.0
15;2021-03-30;1134;198;24033;10160;16.8;7.1
15;2021-03-31;939;22;24972;10182;17.5;7.1
15;2021-04-01;1233;57;26205;10239;18.3;7.2
15;2021-04-02;1141;57;27346;10296;19.1;7.2
15;2021-04-03;120;18;27466;10314;19.2;7.2
15;2021-04-04;0;0;27466;10314;19.2;7.2
15;2021-04-05;33;1;27499;10315;19.3;7.2
15;2021-04-06;834;83;28333;10398;19.8;7.3
15;2021-04-07;663;101;28996;10499;20.3;7.4
15;2021-04-08;1247;136;30243;10635;21.2;7.4
15;2021-04-09;1277;97;31520;10732;22.1;7.5
15;2021-04-10;364;19;31884;10751;22.3;7.5
15;2021-04-11;14;0;31898;10751;22.3;7.5
15;2021-04-12;644;458;32542;11209;22.8;7.8
15;2021-04-13;1124;322;33666;11531;23.6;8.1
15;2021-04-14;1038;198;34704;11729;24.3;8.2
15;2021-04-15;1183;306;35887;12035;25.1;8.4
15;2021-04-16;1038;555;36925;12590;25.9;8.8
15;2021-04-17;444;12;37369;12602;26.2;8.8
15;2021-04-18;0;10;37369;12612;26.2;8.8
15;2021-04-19;540;513;37909;13125;26.5;9.2
15;2021-04-20;847;613;38756;13738;27.1;9.6
15;2021-04-21;595;650;39351;14388;27.6;10.1
15;2021-04-22;728;774;40079;15162;28.1;10.6
15;2021-04-23;730;679;40809;15841;28.6;11.1
15;2021-04-24;363;123;41172;15964;28.8;11.2
15;2021-04-25;1;3;41173;15967;28.8;11.2
15;2021-04-26;324;632;41497;16599;29.1;11.6
15;2021-04-27;469;934;41966;17533;29.4;12.3
15;2021-04-28;378;788;42344;18321;29.7;12.8
15;2021-04-29;586;1010;42930;19331;30.1;13.5
15;2021-04-30;547;1078;43477;20409;30.4;14.3
15;2021-05-01;283;30;43760;20439;30.6;14.3
15;2021-05-02;0;0;43760;20439;30.6;14.3
15;2021-05-03;881;331;44641;20770;31.3;14.5
15;2021-05-04;802;857;45443;21627;31.8;15.1
15;2021-05-05;676;679;46119;22306;32.3;15.6
15;2021-05-06;826;967;46945;23273;32.9;16.3
15;2021-05-07;1153;906;48098;24179;33.7;16.9
15;2021-05-08;492;55;48590;24234;34.0;17.0
15;2021-05-09;24;9;48614;24243;34.0;17.0
15;2021-05-10;705;912;49319;25155;34.5;17.6
15;2021-05-11;1185;1185;50504;26340;35.4;18.4
15;2021-05-12;1147;833;51651;27173;36.2;19.0
15;2021-05-13;1165;440;52816;27613;37.0;19.3
15;2021-05-14;1504;581;54320;28194;38.0;19.7
15;2021-05-15;1410;417;55730;28611;39.0;20.0
15;2021-05-16;1;10;55731;28621;39.0;20.0
15;2021-05-17;1000;606;56731;29227;39.7;20.5
15;2021-05-18;1222;970;57953;30197;40.6;21.1
15;2021-05-19;1020;459;58973;30656;41.3;21.5
15;2021-05-20;1239;776;60212;31432;42.2;22.0
15;2021-05-21;1349;747;61561;32179;43.1;22.5
15;2021-05-22;526;186;62087;32365;43.5;22.7
15;2021-05-23;2;11;62089;32376;43.5;22.7
15;2021-05-24;693;257;62782;32633;44.0;22.9
15;2021-05-25;1151;620;63933;33253;44.8;23.3
15;2021-05-26;1095;459;65028;33712;45.5;23.6
15;2021-05-27;1269;660;66297;34372;46.4;24.1
15;2021-05-28;1509;884;67806;35256;47.5;24.7
15;2021-05-29;984;361;68790;35617;48.2;24.9
15;2021-05-30;14;25;68804;35642;48.2;25.0
15;2021-05-31;1201;478;70005;36120;49.0;25.3
15;2021-06-01;1399;571;71404;36691;50.0;25.7
15;2021-06-02;865;419;72269;37110;50.6;26.0
15;2021-06-03;931;706;73200;37816;51.3;26.5
15;2021-06-04;1076;718;74276;38534;52.0;27.0
15;2021-06-05;651;263;74927;38797;52.5;27.2
15;2021-06-06;16;20;74943;38817;52.5;27.2
15;2021-06-07;798;350;75741;39167;53.0;27.4
15;2021-06-08;474;396;76215;39563;53.4;27.7
15;2021-06-09;376;376;76591;39939;53.6;28.0
15;2021-06-10;272;426;76863;40365;53.8;28.3
15;2021-06-11;661;1099;77524;41464;54.3;29.0
15;2021-06-12;377;466;77901;41930;54.5;29.4
15;2021-06-13;12;6;77913;41936;54.6;29.4
15;2021-06-14;542;976;78455;42912;54.9;30.0
15;2021-06-15;450;1164;78905;44076;55.3;30.9
15;2021-06-16;541;897;79446;44973;55.6;31.5
15;2021-06-17;287;935;79733;45908;55.8;32.1
15;2021-06-18;741;1204;80474;47112;56.4;33.0
15;2021-06-19;543;705;81017;47817;56.7;33.5
15;2021-06-20;11;1;81028;47818;56.7;33.5
15;2021-06-21;279;1036;81307;48854;56.9;34.2
15;2021-06-22;231;1479;81538;50333;57.1;35.2
15;2021-06-23;342;1445;81880;51778;57.3;36.3
15;2021-06-24;292;1093;82172;52871;57.5;37.0
15;2021-06-25;379;1641;82551;54512;57.8;38.2
15;2021-06-26;165;908;82716;55420;57.9;38.8
15;2021-06-27;0;0;82716;55420;57.9;38.8
15;2021-06-28;176;1226;82892;56646;58.0;39.7
15;2021-06-29;301;1264;83193;57910;58.3;40.6
15;2021-06-30;268;981;83461;58891;58.4;41.2
15;2021-07-01;379;1221;83840;60112;58.7;42.1
15;2021-07-02;407;1350;84247;61462;59.0;43.0
15;2021-07-03;251;707;84498;62169;59.2;43.5
15;2021-07-04;0;1;84498;62170;59.2;43.5
15;2021-07-05;246;1259;84744;63429;59.3;44.4
15;2021-07-06;271;1470;85015;64899;59.5;45.4
15;2021-07-07;252;1346;85267;66245;59.7;46.4
15;2021-07-08;488;1351;85755;67596;60.0;47.3
15;2021-07-09;480;1790;86235;69386;60.4;48.6
15;2021-07-10;215;866;86450;70252;60.5;49.2
15;2021-07-11;7;5;86457;70257;60.5;49.2
15;2021-07-12;269;1486;86726;71743;60.7;50.2
15;2021-07-13;578;1770;87304;73513;61.1;51.5
15;2021-07-14;8;130;87312;73643;61.1;51.6
15;2021-07-15;1129;730;88441;74373;61.9;52.1
15;2021-07-16;1126;1339;89567;75712;62.7;53.0
15;2021-07-17;816;950;90383;76662;63.3;53.7
15;2021-07-18;0;3;90383;76665;63.3;53.7
15;2021-07-19;1058;1271;91441;77936;64.0;54.6
15;2021-07-20;1607;569;93048;78505;65.2;55.0
15;2021-07-21;1172;603;94220;79108;66.0;55.4
15;2021-07-22;889;513;95109;79621;66.6;55.8
15;2021-07-23;1331;1061;96440;80682;67.5;56.5
15;2021-07-24;626;768;97066;81450;68.0;57.0
15;2021-07-25;1;24;97067;81474;68.0;57.1
15;2021-07-26;1236;594;98303;82068;68.8;57.5
15;2021-07-27;1682;565;99985;82633;70.0;57.9
15;2021-07-28;1229;584;101214;83217;70.9;58.3
15;2021-07-29;830;396;102044;83613;71.5;58.5
15;2021-07-30;1003;1130;103047;84743;72.2;59.3
15;2021-07-31;593;635;103640;85378;72.6;59.8
15;2021-08-01;21;12;103661;85390;72.6;59.8
15;2021-08-02;1143;537;104804;85927;73.4;60.2
15;2021-08-03;1145;380;105949;86307;74.2;60.4
15;2021-08-04;787;409;106736;86716;74.7;60.7
15;2021-08-05;362;284;107098;87000;75.0;60.9
16;2020-12-27;0;0;0;0;0.0;0.0
16;2020-12-28;0;0;0;0;0.0;0.0
16;2020-12-29;0;0;0;0;0.0;0.0
16;2020-12-30;0;0;0;0;0.0;0.0
16;2020-12-31;0;0;0;0;0.0;0.0
16;2021-01-01;0;0;0;0;0.0;0.0
16;2021-01-02;0;0;0;0;0.0;0.0
16;2021-01-03;0;0;0;0;0.0;0.0
16;2021-01-04;1;0;1;0;0.0;0.0
16;2021-01-05;1;0;2;0;0.0;0.0
16;2021-01-06;88;0;90;0;0.0;0.0
16;2021-01-07;239;0;329;0;0.1;0.0
16;2021-01-08;464;2;793;2;0.2;0.0
16;2021-01-09;1;0;794;2;0.2;0.0
16;2021-01-10;1;0;795;2;0.2;0.0
16;2021-01-11;303;0;1098;2;0.3;0.0
16;2021-01-12;435;1;1533;3;0.4;0.0
16;2021-01-13;480;0;2013;3;0.6;0.0
16;2021-01-14;596;6;2609;9;0.7;0.0
16;2021-01-15;504;4;3113;13;0.9;0.0
16;2021-01-16;0;0;3113;13;0.9;0.0
16;2021-01-17;0;0;3113;13;0.9;0.0
16;2021-01-18;430;5;3543;18;1.0;0.0
16;2021-01-19;831;2;4374;20;1.3;0.0
16;2021-01-20;1181;2;5555;22;1.6;0.0
16;2021-01-21;1350;3;6905;25;2.0;0.0
16;2021-01-22;1111;0;8016;25;2.3;0.0
16;2021-01-23;183;0;8199;25;2.4;0.0
16;2021-01-24;0;0;8199;25;2.4;0.0
16;2021-01-25;641;2;8840;27;2.5;0.0
16;2021-01-26;1025;0;9865;27;2.8;0.0
16;2021-01-27;1400;105;11265;132;3.2;0.0
16;2021-01-28;1256;60;12521;192;3.6;0.1
16;2021-01-29;743;140;13264;332;3.8;0.1
16;2021-01-30;36;0;13300;332;3.8;0.1
16;2021-01-31;0;0;13300;332;3.8;0.1
16;2021-02-01;395;205;13695;537;3.9;0.2
16;2021-02-02;577;174;14272;711;4.1;0.2
16;2021-02-03;620;352;14892;1063;4.3;0.3
16;2021-02-04;462;271;15354;1334;4.4;0.4
16;2021-02-05;504;277;15858;1611;4.6;0.5
16;2021-02-06;1;80;15859;1691;4.6;0.5
16;2021-02-07;41;2;15900;1693;4.6;0.5
16;2021-02-08;355;219;16255;1912;4.7;0.5
16;2021-02-09;649;294;16904;2206;4.9;0.6
16;2021-02-10;693;679;17597;2885;5.1;0.8
16;2021-02-11;797;616;18394;3501;5.3;1.0
16;2021-02-12;623;833;19017;4334;5.5;1.2
16;2021-02-13;42;78;19059;4412;5.5;1.3
16;2021-02-14;2;7;19061;4419;5.5;1.3
16;2021-02-15;216;667;19277;5086;5.5;1.5
16;2021-02-16;374;958;19651;6044;5.6;1.7
16;2021-02-17;351;1311;20002;7355;5.7;2.1
16;2021-02-18;510;1255;20512;8610;5.9;2.5
16;2021-02-19;389;799;20901;9409;6.0;2.7
16;2021-02-20;1;8;20902;9417;6.0;2.7
16;2021-02-21;0;0;20902;9417;6.0;2.7
16;2021-02-22;135;542;21037;9959;6.0;2.9
16;2021-02-23;205;928;21242;10887;6.1;3.1
16;2021-02-24;274;899;21516;11786;6.2;3.4
16;2021-02-25;396;690;21912;12476;6.3;3.6
16;2021-02-26;478;502;22390;12978;6.4;3.7
16;2021-02-27;249;1;22639;12979;6.5;3.7
16;2021-02-28;5;5;22644;12984;6.5;3.7
16;2021-03-01;152;327;22796;13311;6.5;3.8
16;2021-03-02;272;671;23068;13982;6.6;4.0
16;2021-03-03;392;727;23460;14709;6.7;4.2
16;2021-03-04;807;569;24267;15278;7.0;4.4
16;2021-03-05;1142;541;25409;15819;7.3;4.5
16;2021-03-06;751;14;26160;15833;7.5;4.5
16;2021-03-07;94;18;26254;15851;7.5;4.6
16;2021-03-08;437;319;26691;16170;7.7;4.6
16;2021-03-09;772;700;27463;16870;7.9;4.8
16;2021-03-10;606;669;28069;17539;8.1;5.0
16;2021-03-11;1446;531;29515;18070;8.5;5.2
16;2021-03-12;1164;460;30679;18530;8.8;5.3
16;2021-03-13;764;13;31443;18543;9.0;5.3
16;2021-03-14;1;0;31444;18543;9.0;5.3
16;2021-03-15;461;182;31905;18725;9.2;5.4
16;2021-03-16;859;421;32764;19146;9.4;5.5
16;2021-03-17;589;285;33353;19431;9.6;5.6
16;2021-03-18;1031;283;34384;19714;9.9;5.7
16;2021-03-19;1101;247;35485;19961;10.2;5.7
16;2021-03-20;395;2;35880;19963;10.3;5.7
16;2021-03-21;9;0;35889;19963;10.3;5.7
16;2021-03-22;727;100;36616;20063;10.5;5.8
16;2021-03-23;1462;103;38078;20166;10.9;5.8
16;2021-03-24;1120;185;39198;20351;11.3;5.8
16;2021-03-25;2046;90;41244;20441;11.8;5.9
16;2021-03-26;1915;94;43159;20535;12.4;5.9
16;2021-03-27;433;22;43592;20557;12.5;5.9
16;2021-03-28;0;0;43592;20557;12.5;5.9
16;2021-03-29;925;61;44517;20618;12.8;5.9
16;2021-03-30;1883;179;46400;20797;13.3;6.0
16;2021-03-31;1514;133;47914;20930;13.8;6.0
16;2021-04-01;2007;400;49921;21330;14.3;6.1
16;2021-04-02;1442;379;51363;21709;14.8;6.2
16;2021-04-03;288;5;51651;21714;14.8;6.2
16;2021-04-04;1;0;51652;21714;14.8;6.2
16;2021-04-05;2;0;51654;21714;14.8;6.2
16;2021-04-06;2012;543;53666;22257;15.4;6.4
16;2021-04-07;1952;400;55618;22657;16.0;6.5
16;2021-04-08;2823;588;58441;23245;16.8;6.7
16;2021-04-09;2694;552;61135;23797;17.6;6.8
16;2021-04-10;1290;37;62425;23834;17.9;6.8
16;2021-04-11;2;0;62427;23834;17.9;6.8
16;2021-04-12;1431;316;63858;24150;18.3;6.9
16;2021-04-13;2123;839;65981;24989;19.0;7.2
16;2021-04-14;1952;631;67933;25620;19.5;7.4
16;2021-04-15;2102;984;70035;26604;20.1;7.6
16;2021-04-16;2037;780;72072;27384;20.7;7.9
16;2021-04-17;1504;84;73576;27468;21.1;7.9
16;2021-04-18;197;3;73773;27471;21.2;7.9
16;2021-04-19;1439;523;75212;27994;21.6;8.0
16;2021-04-20;2054;1231;77266;29225;22.2;8.4
16;2021-04-21;1776;741;79042;29966;22.7;8.6
16;2021-04-22;2293;1003;81335;30969;23.4;8.9
16;2021-04-23;2360;1168;83695;32137;24.0;9.2
16;2021-04-24;829;37;84524;32174;24.3;9.2
16;2021-04-25;117;9;84641;32183;24.3;9.2
16;2021-04-26;1401;806;86042;32989;24.7;9.5
16;2021-04-27;2057;1417;88099;34406;25.3;9.9
16;2021-04-28;1590;1126;89689;35532;25.8;10.2
16;2021-04-29;2245;1495;91934;37027;26.4;10.6
16;2021-04-30;2853;1341;94787;38368;27.2;11.0
16;2021-05-01;353;59;95140;38427;27.3;11.0
16;2021-05-02;155;13;95295;38440;27.4;11.0
16;2021-05-03;2610;533;97905;38973;28.1;11.2
16;2021-05-04;2060;2045;99965;41018;28.7;11.8
16;2021-05-05;1689;1831;101654;42849;29.2;12.3
16;2021-05-06;1886;2237;103540;45086;29.7;12.9
16;2021-05-07;3069;2124;106609;47210;30.6;13.6
16;2021-05-08;1196;468;107805;47678;31.0;13.7
16;2021-05-09;530;26;108335;47704;31.1;13.7
16;2021-05-10;1930;1626;110265;49330;31.7;14.2
16;2021-05-11;2354;1959;112619;51289;32.3;14.7
16;2021-05-12;1733;1797;114352;53086;32.8;15.2
16;2021-05-13;1461;355;115813;53441;33.3;15.3
16;2021-05-14;1989;1560;117802;55001;33.8;15.8
16;2021-05-15;596;896;118398;55897;34.0;16.1
16;2021-05-16;132;6;118530;55903;34.0;16.1
16;2021-05-17;1609;1287;120139;57190;34.5;16.4
16;2021-05-18;2759;1422;122898;58612;35.3;16.8
16;2021-05-19;2005;1238;124903;59850;35.9;17.2
16;2021-05-20;2836;1387;127739;61237;36.7;17.6
16;2021-05-21;2945;1397;130684;62634;37.5;18.0
16;2021-05-22;412;711;131096;63345;37.7;18.2
16;2021-05-23;210;11;131306;63356;37.7;18.2
16;2021-05-24;1261;236;132567;63592;38.1;18.3
16;2021-05-25;2763;1459;135330;65051;38.9;18.7
16;2021-05-26;1833;1187;137163;66238;39.4;19.0
16;2021-05-27;2418;1583;139581;67821;40.1;19.5
16;2021-05-28;2893;1568;142474;69389;40.9;19.9
16;2021-05-29;814;882;143288;70271;41.2;20.2
16;2021-05-30;1;4;143289;70275;41.2;20.2
16;2021-05-31;1983;1102;145272;71377;41.7;20.5
16;2021-06-01;2345;1715;147617;73092;42.4;21.0
16;2021-06-02;1822;1504;149439;74596;42.9;21.4
16;2021-06-03;2621;1761;152060;76357;43.7;21.9
16;2021-06-04;2834;2035;154894;78392;44.5;22.5
16;2021-06-05;1006;549;155900;78941;44.8;22.7
16;2021-06-06;160;28;156060;78969;44.8;22.7
16;2021-06-07;1991;1282;158051;80251;45.4;23.0
16;2021-06-08;2395;1997;160446;82248;46.1;23.6
16;2021-06-09;2528;1612;162974;83860;46.8;24.1
16;2021-06-10;2573;2002;165547;85862;47.5;24.7
16;2021-06-11;2152;2735;167699;88597;48.2;25.4
16;2021-06-12;1613;515;169312;89112;48.6;25.6
16;2021-06-13;261;72;169573;89184;48.7;25.6
16;2021-06-14;796;2797;170369;91981;48.9;26.4
16;2021-06-15;1865;2623;172234;94604;49.5;27.2
16;2021-06-16;1577;2084;173811;96688;49.9;27.8
16;2021-06-17;2042;2509;175853;99197;50.5;28.5
16;2021-06-18;2063;3220;177916;102417;51.1;29.4
16;2021-06-19;1350;1313;179266;103730;51.5;29.8
16;2021-06-20;243;28;179509;103758;51.6;29.8
16;2021-06-21;1410;2173;180919;105931;52.0;30.4
16;2021-06-22;1673;2942;182592;108873;52.4;31.3
16;2021-06-23;1564;2018;184156;110891;52.9;31.8
16;2021-06-24;1925;2168;186081;113059;53.4;32.5
16;2021-06-25;1985;2728;188066;115787;54.0;33.3
16;2021-06-26;1056;722;189122;116509;54.3;33.5
16;2021-06-27;132;25;189254;116534;54.4;33.5
16;2021-06-28;1162;1964;190416;118498;54.7;34.0
16;2021-06-29;1278;3360;191694;121858;55.1;35.0
16;2021-06-30;1334;2712;193028;124570;55.4;35.8
16;2021-07-01;1856;3155;194884;127725;56.0;36.7
16;2021-07-02;1424;3584;196308;131309;56.4;37.7
16;2021-07-03;690;1114;196998;132423;56.6;38.0
16;2021-07-04;3;15;197001;132438;56.6;38.0
16;2021-07-05;812;2299;197813;134737;56.8;38.7
16;2021-07-06;1273;3369;199086;138106;57.2;39.7
16;2021-07-07;858;2275;199944;140381;57.4;40.3
16;2021-07-08;1230;2739;201174;143120;57.8;41.1
16;2021-07-09;1112;3717;202286;146837;58.1;42.2
16;2021-07-10;338;1341;202624;148178;58.2;42.6
16;2021-07-11;2;13;202626;148191;58.2;42.6
16;2021-07-12;632;2445;203258;150636;58.4;43.3
16;2021-07-13;1377;3533;204635;154169;58.8;44.3
16;2021-07-14;798;876;205433;155045;59.0;44.5
16;2021-07-15;1239;3410;206672;158455;59.4;45.5
16;2021-07-16;1490;3386;208162;161841;59.8;46.5
16;2021-07-17;530;1191;208692;163032;59.9;46.8
16;2021-07-18;13;6;208705;163038;59.9;46.8
16;2021-07-19;614;2860;209319;165898;60.1;47.6
16;2021-07-20;1120;3296;210439;169194;60.4;48.6
16;2021-07-21;1115;2621;211554;171815;60.8;49.3
16;2021-07-22;1859;2864;213413;174679;61.3;50.2
16;2021-07-23;1540;3546;214953;178225;61.7;51.2
16;2021-07-24;636;1212;215589;179437;61.9;51.5
16;2021-07-25;11;11;215600;179448;61.9;51.5
16;2021-07-26;1524;2127;217124;181575;62.4;52.1
16;2021-07-27;1847;2821;218971;184396;62.9;53.0
16;2021-07-28;1847;2310;220818;186706;63.4;53.6
16;2021-07-29;2234;2473;223052;189179;64.1;54.3
16;2021-07-30;2342;3110;225394;192289;64.7;55.2
16;2021-07-31;953;1352;226347;193641;65.0;55.6
16;2021-08-01;182;22;226529;193663;65.1;55.6
16;2021-08-02;2114;1824;228643;195487;65.7;56.1
16;2021-08-03;2109;2338;230752;197825;66.3;56.8
16;2021-08-04;2110;1879;232862;199704;66.9;57.4
16;2021-08-05;2747;1649;235609;201353;67.7;57.8
17;2020-12-27;0;0;0;0;0.0;0.0
17;2020-12-28;0;0;0;0;0.0;0.0
17;2020-12-29;0;0;0;0;0.0;0.0
17;2020-12-30;1;0;1;0;0.0;0.0
17;2020-12-31;0;0;1;0;0.0;0.0
17;2021-01-01;1;0;2;0;0.0;0.0
17;2021-01-02;1;0;3;0;0.0;0.0
17;2021-01-03;0;0;3;0;0.0;0.0
17;2021-01-04;56;0;59;0;0.0;0.0
17;2021-01-05;98;0;157;0;0.0;0.0
17;2021-01-06;132;0;289;0;0.0;0.0
17;2021-01-07;485;1;774;1;0.1;0.0
17;2021-01-08;418;0;1192;1;0.2;0.0
17;2021-01-09;0;0;1192;1;0.2;0.0
17;2021-01-10;1;0;1193;1;0.2;0.0
17;2021-01-11;380;1;1573;2;0.2;0.0
17;2021-01-12;746;1;2319;3;0.4;0.0
17;2021-01-13;652;2;2971;5;0.5;0.0
17;2021-01-14;616;9;3587;14;0.6;0.0
17;2021-01-15;679;1;4266;15;0.7;0.0
17;2021-01-16;128;2;4394;17;0.7;0.0
17;2021-01-17;17;0;4411;17;0.7;0.0
17;2021-01-18;882;1;5293;18;0.8;0.0
17;2021-01-19;1907;2;7200;20;1.1;0.0
17;2021-01-20;2391;2;9591;22;1.5;0.0
17;2021-01-21;2498;2;12089;24;1.9;0.0
17;2021-01-22;1881;5;13970;29;2.2;0.0
17;2021-01-23;738;1;14708;30;2.3;0.0
17;2021-01-24;48;0;14756;30;2.3;0.0
17;2021-01-25;1383;5;16139;35;2.5;0.0
17;2021-01-26;2110;3;18249;38;2.8;0.0
17;2021-01-27;1674;33;19923;71;3.1;0.0
17;2021-01-28;2474;230;22397;301;3.5;0.0
17;2021-01-29;1738;220;24135;521;3.7;0.1
17;2021-01-30;528;5;24663;526;3.8;0.1
17;2021-01-31;37;2;24700;528;3.8;0.1
17;2021-02-01;740;211;25440;739;3.9;0.1
17;2021-02-02;1202;348;26642;1087;4.1;0.2
17;2021-02-03;1284;409;27926;1496;4.3;0.2
17;2021-02-04;1158;502;29084;1998;4.5;0.3
17;2021-02-05;601;756;29685;2754;4.6;0.4
17;2021-02-06;20;42;29705;2796;4.6;0.4
17;2021-02-07;31;13;29736;2809;4.6;0.4
17;2021-02-08;707;403;30443;3212;4.7;0.5
17;2021-02-09;1100;1318;31543;4530;4.9;0.7
17;2021-02-10;863;1285;32406;5815;5.0;0.9
17;2021-02-11;1239;1400;33645;7215;5.2;1.1
17;2021-02-12;772;968;34417;8183;5.3;1.3
17;2021-02-13;42;104;34459;8287;5.3;1.3
17;2021-02-14;0;10;34459;8297;5.3;1.3
17;2021-02-15;620;1226;35079;9523;5.4;1.5
17;2021-02-16;748;1833;35827;11356;5.5;1.8
17;2021-02-17;796;1359;36623;12715;5.7;2.0
17;2021-02-18;965;2185;37588;14900;5.8;2.3
17;2021-02-19;1066;1545;38654;16445;6.0;2.5
17;2021-02-20;104;308;38758;16753;6.0;2.6
17;2021-02-21;9;2;38767;16755;6.0;2.6
17;2021-02-22;646;1631;39413;18386;6.1;2.8
17;2021-02-23;780;1536;40193;19922;6.2;3.1
17;2021-02-24;1077;1593;41270;21515;6.4;3.3
17;2021-02-25;1085;1709;42355;23224;6.5;3.6
17;2021-02-26;1307;1294;43662;24518;6.7;3.8
17;2021-02-27;525;247;44187;24765;6.8;3.8
17;2021-02-28;19;9;44206;24774;6.8;3.8
17;2021-03-01;634;1043;44840;25817;6.9;4.0
17;2021-03-02;1091;870;45931;26687;7.1;4.1
17;2021-03-03;1615;798;47546;27485;7.3;4.2
17;2021-03-04;2425;1137;49971;28622;7.7;4.4
17;2021-03-05;2660;680;52631;29302;8.1;4.5
17;2021-03-06;1028;26;53659;29328;8.3;4.5
17;2021-03-07;183;47;53842;29375;8.3;4.5
17;2021-03-08;1014;835;54856;30210;8.5;4.7
17;2021-03-09;1745;614;56601;30824;8.7;4.8
17;2021-03-10;2047;642;58648;31466;9.1;4.9
17;2021-03-11;3228;997;61876;32463;9.6;5.0
17;2021-03-12;3354;626;65230;33089;10.1;5.1
17;2021-03-13;1199;11;66429;33100;10.3;5.1
17;2021-03-14;32;0;66461;33100;10.3;5.1
17;2021-03-15;1239;994;67700;34094;10.5;5.3
17;2021-03-16;892;536;68592;34630;10.6;5.4
17;2021-03-17;1458;701;70050;35331;10.8;5.5
17;2021-03-18;1682;762;71732;36093;11.1;5.6
17;2021-03-19;2095;543;73827;36636;11.4;5.7
17;2021-03-20;1081;56;74908;36692;11.6;5.7
17;2021-03-21;36;42;74944;36734;11.6;5.7
17;2021-03-22;1576;688;76520;37422;11.8;5.8
17;2021-03-23;2489;579;79009;38001;12.2;5.9
17;2021-03-24;3545;851;82554;38852;12.8;6.0
17;2021-03-25;4708;641;87262;39493;13.5;6.1
17;2021-03-26;4941;468;92203;39961;14.2;6.2
17;2021-03-27;1737;69;93940;40030;14.5;6.2
17;2021-03-28;365;45;94305;40075;14.6;6.2
17;2021-03-29;2360;564;96665;40639;14.9;6.3
17;2021-03-30;2651;984;99316;41623;15.3;6.4
17;2021-03-31;3840;904;103156;42527;15.9;6.6
17;2021-04-01;4013;1154;107169;43681;16.6;6.8
17;2021-04-02;3702;828;110871;44509;17.1;6.9
17;2021-04-03;1151;186;112022;44695;17.3;6.9
17;2021-04-04;501;6;112523;44701;17.4;6.9
17;2021-04-05;444;128;112967;44829;17.5;6.9
17;2021-04-06;3480;1027;116447;45856;18.0;7.1
17;2021-04-07;4128;1143;120575;46999;18.6;7.3
17;2021-04-08;4566;1467;125141;48466;19.3;7.5
17;2021-04-09;6493;838;131634;49304;20.3;7.6
17;2021-04-10;2582;65;134216;49369;20.7;7.6
17;2021-04-11;787;16;135003;49385;20.9;7.6
17;2021-04-12;2887;1612;137890;50997;21.3;7.9
17;2021-04-13;4146;1285;142036;52282;22.0;8.1
17;2021-04-14;4415;1189;146451;53471;22.6;8.3
17;2021-04-15;4593;1136;151044;54607;23.3;8.4
17;2021-04-16;4294;1151;155338;55758;24.0;8.6
17;2021-04-17;1681;382;157019;56140;24.3;8.7
17;2021-04-18;472;81;157491;56221;24.3;8.7
17;2021-04-19;2342;2061;159833;58282;24.7;9.0
17;2021-04-20;2924;2550;162757;60832;25.2;9.4
17;2021-04-21;2973;1939;165730;62771;25.6;9.7
17;2021-04-22;3115;2358;168845;65129;26.1;10.1
17;2021-04-23;2444;2726;171289;67855;26.5;10.5
17;2021-04-24;1666;923;172955;68778;26.7;10.6
17;2021-04-25;665;244;173620;69022;26.8;10.7
17;2021-04-26;2575;2625;176195;71647;27.2;11.1
17;2021-04-27;3154;2671;179349;74318;27.7;11.5
17;2021-04-28;3101;2941;182450;77259;28.2;11.9
17;2021-04-29;4144;2862;186594;80121;28.8;12.4
17;2021-04-30;4351;2635;190945;82756;29.5;12.8
17;2021-05-01;848;542;191793;83298;29.6;12.9
17;2021-05-02;550;840;192343;84138;29.7;13.0
17;2021-05-03;2544;2955;194887;87093;30.1;13.5
17;2021-05-04;2319;3729;197206;90822;30.5;14.0
17;2021-05-05;2910;3701;200116;94523;30.9;14.6
17;2021-05-06;4123;3405;204239;97928;31.6;15.1
17;2021-05-07;4352;3633;208591;101561;32.2;15.7
17;2021-05-08;1298;754;209889;102315;32.4;15.8
17;2021-05-09;1307;705;211196;103020;32.6;15.9
17;2021-05-10;2722;3689;213918;106709;33.1;16.5
17;2021-05-11;3503;3995;217421;110704;33.6;17.1
17;2021-05-12;3532;3808;220953;114512;34.1;17.7
17;2021-05-13;2547;692;223500;115204;34.5;17.8
17;2021-05-14;3034;2394;226534;117598;35.0;18.2
17;2021-05-15;2126;662;228660;118260;35.3;18.3
17;2021-05-16;1735;315;230395;118575;35.6;18.3
17;2021-05-17;4288;1992;234683;120567;36.3;18.6
17;2021-05-18;4744;1636;239427;122203;37.0;18.9
17;2021-05-19;5063;1267;244490;123470;37.8;19.1
17;2021-05-20;4946;1946;249436;125416;38.5;19.4
17;2021-05-21;4997;1958;254433;127374;39.3;19.7
17;2021-05-22;2394;532;256827;127906;39.7;19.8
17;2021-05-23;1899;126;258726;128032;40.0;19.8
17;2021-05-24;1426;207;260152;128239;40.2;19.8
17;2021-05-25;4029;1770;264181;130009;40.8;20.1
17;2021-05-26;4367;2037;268548;132046;41.5;20.4
17;2021-05-27;5213;2131;273761;134177;42.3;20.7
17;2021-05-28;4465;3432;278226;137609;43.0;21.3
17;2021-05-29;1560;1704;279786;139313;43.2;21.5
17;2021-05-30;857;407;280643;139720;43.4;21.6
17;2021-05-31;2943;3013;283586;142733;43.8;22.1
17;2021-06-01;4294;2926;287880;145659;44.5;22.5
17;2021-06-02;4195;3172;292075;148831;45.1;23.0
17;2021-06-03;5058;3165;297133;151996;45.9;23.5
17;2021-06-04;4516;3854;301649;155850;46.6;24.1
17;2021-06-05;1990;1603;303639;157453;46.9;24.3
17;2021-06-06;850;732;304489;158185;47.1;24.4
17;2021-06-07;3136;4344;307625;162529;47.5;25.1
17;2021-06-08;3790;4491;311415;167020;48.1;25.8
17;2021-06-09;4348;3050;315763;170070;48.8;26.3
17;2021-06-10;4923;2791;320686;172861;49.6;26.7
17;2021-06-11;4782;3682;325468;176543;50.3;27.3
17;2021-06-12;1813;1397;327281;177940;50.6;27.5
17;2021-06-13;609;414;327890;178354;50.7;27.6
17;2021-06-14;2833;4535;330723;182889;51.1;28.3
17;2021-06-15;3622;4375;334345;187264;51.7;28.9
17;2021-06-16;4132;3685;338477;190949;52.3;29.5
17;2021-06-17;4366;4120;342843;195069;53.0;30.1
17;2021-06-18;4047;4433;346890;199502;53.6;30.8
17;2021-06-19;1453;1989;348343;201491;53.8;31.1
17;2021-06-20;596;1034;348939;202525;53.9;31.3
17;2021-06-21;2558;4368;351497;206893;54.3;32.0
17;2021-06-22;3528;4447;355025;211340;54.9;32.7
17;2021-06-23;3788;3983;358813;215323;55.5;33.3
17;2021-06-24;3592;3954;362405;219277;56.0;33.9
17;2021-06-25;2712;4981;365117;224258;56.4;34.7
17;2021-06-26;903;2335;366020;226593;56.6;35.0
17;2021-06-27;395;1903;366415;228496;56.6;35.3
17;2021-06-28;1521;5416;367936;233912;56.9;36.1
17;2021-06-29;1681;5884;369617;239796;57.1;37.1
17;2021-06-30;2028;5550;371645;245346;57.4;37.9
17;2021-07-01;2255;5554;373900;250900;57.8;38.8
17;2021-07-02;2480;5987;376380;256887;58.2;39.7
17;2021-07-03;625;2546;377005;259433;58.3;40.1
17;2021-07-04;154;1250;377159;260683;58.3;40.3
17;2021-07-05;1879;5179;379038;265862;58.6;41.1
17;2021-07-06;2125;5598;381163;271460;58.9;42.0
17;2021-07-07;2399;5498;383562;276958;59.3;42.8
17;2021-07-08;2906;5443;386468;282401;59.7;43.6
17;2021-07-09;2517;6089;388985;288490;60.1;44.6
17;2021-07-10;827;2475;389812;290965;60.2;45.0
17;2021-07-11;368;905;390180;291870;60.3;45.1
17;2021-07-12;1997;5632;392177;297502;60.6;46.0
17;2021-07-13;2353;6719;394530;304221;61.0;47.0
17;2021-07-14;65;71;394595;304292;61.0;47.0
17;2021-07-15;2173;6864;396768;311156;61.3;48.1
17;2021-07-16;2746;6976;399514;318132;61.7;49.2
17;2021-07-17;1001;2280;400515;320412;61.9;49.5
17;2021-07-18;309;1040;400824;321452;61.9;49.7
17;2021-07-19;2616;5920;403440;327372;62.3;50.6
17;2021-07-20;3267;6328;406707;333700;62.9;51.6
17;2021-07-21;3761;6026;410468;339726;63.4;52.5
17;2021-07-22;4210;6279;414678;346005;64.1;53.5
17;2021-07-23;3791;6573;418469;352578;64.7;54.5
17;2021-07-24;2063;1399;420532;353977;65.0;54.7
17;2021-07-25;1034;412;421566;354389;65.1;54.8
17;2021-07-26;3668;5422;425234;359811;65.7;55.6
17;2021-07-27;4678;5438;429912;365249;66.4;56.4
17;2021-07-28;5179;5172;435091;370421;67.2;57.2
17;2021-07-29;5146;5333;440237;375754;68.0;58.1
17;2021-07-30;5446;5559;445683;381313;68.9;58.9
17;2021-07-31;2101;1205;447784;382518;69.2;59.1
17;2021-08-01;1080;355;448864;382873;69.4;59.2
17;2021-08-02;4586;4374;453450;387247;70.1;59.8
17;2021-08-03;5698;4150;459148;391397;71.0;60.5
17;2021-08-04;6153;3355;465301;394752;71.9;61.0
17;2021-08-05;6280;3135;471581;397887;72.9;61.5
18;2020-12-27;0;0;0;0;0.0;0.0
18;2020-12-28;0;0;0;0;0.0;0.0
18;2020-12-29;0;0;0;0;0.0;0.0
18;2020-12-30;1;0;1;0;0.0;0.0
18;2020-12-31;0;0;1;0;0.0;0.0
18;2021-01-01;0;0;1;0;0.0;0.0
18;2021-01-02;0;0;1;0;0.0;0.0
18;2021-01-03;0;0;1;0;0.0;0.0
18;2021-01-04;3;0;4;0;0.0;0.0
18;2021-01-05;0;0;4;0;0.0;0.0
18;2021-01-06;1;0;5;0;0.0;0.0
18;2021-01-07;30;1;35;1;0.0;0.0
18;2021-01-08;65;0;100;1;0.0;0.0
18;2021-01-09;225;0;325;1;0.1;0.0
18;2021-01-10;146;0;471;1;0.2;0.0
18;2021-01-11;170;1;641;2;0.2;0.0
18;2021-01-12;372;0;1013;2;0.3;0.0
18;2021-01-13;270;2;1283;4;0.4;0.0
18;2021-01-14;269;2;1552;6;0.5;0.0
18;2021-01-15;332;2;1884;8;0.6;0.0
18;2021-01-16;288;3;2172;11;0.7;0.0
18;2021-01-17;1;0;2173;11;0.7;0.0
18;2021-01-18;290;0;2463;11;0.8;0.0
18;2021-01-19;1375;5;3838;16;1.3;0.0
18;2021-01-20;1239;1;5077;17;1.7;0.0
18;2021-01-21;963;0;6040;17;2.0;0.0
18;2021-01-22;780;1;6820;18;2.3;0.0
18;2021-01-23;249;2;7069;20;2.4;0.0
18;2021-01-24;0;0;7069;20;2.4;0.0
18;2021-01-25;509;0;7578;20;2.6;0.0
18;2021-01-26;395;1;7973;21;2.7;0.0
18;2021-01-27;390;2;8363;23;2.8;0.0
18;2021-01-28;566;8;8929;31;3.0;0.0
18;2021-01-29;492;72;9421;103;3.2;0.0
18;2021-01-30;432;167;9853;270;3.3;0.1
18;2021-01-31;82;121;9935;391;3.4;0.1
18;2021-02-01;328;142;10263;533;3.5;0.2
18;2021-02-02;506;244;10769;777;3.6;0.3
18;2021-02-03;398;204;11167;981;3.8;0.3
18;2021-02-04;630;226;11797;1207;4.0;0.4
18;2021-02-05;449;194;12246;1401;4.1;0.5
18;2021-02-06;283;103;12529;1504;4.2;0.5
18;2021-02-07;108;1;12637;1505;4.3;0.5
18;2021-02-08;268;230;12905;1735;4.4;0.6
18;2021-02-09;582;781;13487;2516;4.6;0.8
18;2021-02-10;740;699;14227;3215;4.8;1.1
18;2021-02-11;655;450;14882;3665;5.0;1.2
18;2021-02-12;501;325;15383;3990;5.2;1.3
18;2021-02-13;286;124;15669;4114;5.3;1.4
18;2021-02-14;364;98;16033;4212;5.4;1.4
18;2021-02-15;379;394;16412;4606;5.5;1.6
18;2021-02-16;399;400;16811;5006;5.7;1.7
18;2021-02-17;403;458;17214;5464;5.8;1.8
18;2021-02-18;344;540;17558;6004;5.9;2.0
18;2021-02-19;471;303;18029;6307;6.1;2.1
18;2021-02-20;719;238;18748;6545;6.3;2.2
18;2021-02-21;316;2;19064;6547;6.4;2.2
18;2021-02-22;217;372;19281;6919;6.5;2.3
18;2021-02-23;204;351;19485;7270;6.6;2.5
18;2021-02-24;240;271;19725;7541;6.7;2.5
18;2021-02-25;293;521;20018;8062;6.8;2.7
18;2021-02-26;582;236;20600;8298;6.9;2.8
18;2021-02-27;510;389;21110;8687;7.1;2.9
18;2021-02-28;6;68;21116;8755;7.1;3.0
18;2021-03-01;235;415;21351;9170;7.2;3.1
18;2021-03-02;283;520;21634;9690;7.3;3.3
18;2021-03-03;346;586;21980;10276;7.4;3.5
18;2021-03-04;475;573;22455;10849;7.6;3.7
18;2021-03-05;524;374;22979;11223;7.8;3.8
18;2021-03-06;1070;340;24049;11563;8.1;3.9
18;2021-03-07;7;140;24056;11703;8.1;3.9
18;2021-03-08;334;362;24390;12065;8.2;4.1
18;2021-03-09;409;368;24799;12433;8.4;4.2
18;2021-03-10;423;453;25222;12886;8.5;4.3
18;2021-03-11;517;421;25739;13307;8.7;4.5
18;2021-03-12;704;303;26443;13610;8.9;4.6
18;2021-03-13;1163;249;27606;13859;9.3;4.7
18;2021-03-14;301;212;27907;14071;9.4;4.7
18;2021-03-15;491;377;28398;14448;9.6;4.9
18;2021-03-16;392;314;28790;14762;9.7;5.0
18;2021-03-17;383;413;29173;15175;9.8;5.1
18;2021-03-18;512;229;29685;15404;10.0;5.2
18;2021-03-19;756;226;30441;15630;10.3;5.3
18;2021-03-20;987;618;31428;16248;10.6;5.5
18;2021-03-21;309;307;31737;16555;10.7;5.6
18;2021-03-22;601;296;32338;16851;10.9;5.7
18;2021-03-23;706;291;33044;17142;11.1;5.8
18;2021-03-24;1052;296;34096;17438;11.5;5.9
18;2021-03-25;1049;297;35145;17735;11.9;6.0
18;2021-03-26;1210;346;36355;18081;12.3;6.1
18;2021-03-27;1489;319;37844;18400;12.8;6.2
18;2021-03-28;215;0;38059;18400;12.8;6.2
18;2021-03-29;1101;196;39160;18596;13.2;6.3
18;2021-03-30;1085;302;40245;18898;13.6;6.4
18;2021-03-31;1306;253;41551;19151;14.0;6.5
18;2021-04-01;1376;343;42927;19494;14.5;6.6
18;2021-04-02;1229;307;44156;19801;14.9;6.7
18;2021-04-03;581;181;44737;19982;15.1;6.7
18;2021-04-04;71;5;44808;19987;15.1;6.7
18;2021-04-05;199;0;45007;19987;15.2;6.7
18;2021-04-06;1026;345;46033;20332;15.5;6.9
18;2021-04-07;1322;361;47355;20693;16.0;7.0
18;2021-04-08;1692;330;49047;21023;16.5;7.1
18;2021-04-09;1832;278;50879;21301;17.2;7.2
18;2021-04-10;2633;649;53512;21950;18.1;7.4
18;2021-04-11;1985;312;55497;22262;18.7;7.5
18;2021-04-12;1402;394;56899;22656;19.2;7.6
18;2021-04-13;1784;465;58683;23121;19.8;7.8
18;2021-04-14;1378;516;60061;23637;20.3;8.0
18;2021-04-15;1532;527;61593;24164;20.8;8.2
18;2021-04-16;1614;587;63207;24751;21.3;8.4
18;2021-04-17;1599;518;64806;25269;21.9;8.5
18;2021-04-18;377;232;65183;25501;22.0;8.6
18;2021-04-19;1316;590;66499;26091;22.4;8.8
18;2021-04-20;1446;706;67945;26797;22.9;9.0
18;2021-04-21;1271;904;69216;27701;23.4;9.3
18;2021-04-22;1401;701;70617;28402;23.8;9.6
18;2021-04-23;1386;734;72003;29136;24.3;9.8
18;2021-04-24;1355;1267;73358;30403;24.7;10.3
18;2021-04-25;288;216;73646;30619;24.8;10.3
18;2021-04-26;1205;943;74851;31562;25.3;10.6
18;2021-04-27;1544;760;76395;32322;25.8;10.9
18;2021-04-28;1357;873;77752;33195;26.2;11.2
18;2021-04-29;1847;735;79599;33930;26.9;11.4
18;2021-04-30;1570;993;81169;34923;27.4;11.8
18;2021-05-01;787;209;81956;35132;27.7;11.9
18;2021-05-02;806;58;82762;35190;27.9;11.9
18;2021-05-03;1626;1001;84388;36191;28.5;12.2
18;2021-05-04;1729;1275;86117;37466;29.1;12.6
18;2021-05-05;1735;1211;87852;38677;29.6;13.0
18;2021-05-06;2164;1355;90016;40032;30.4;13.5
18;2021-05-07;1233;1398;91249;41430;30.8;14.0
18;2021-05-08;994;1462;92243;42892;31.1;14.5
18;2021-05-09;501;2260;92744;45152;31.3;15.2
18;2021-05-10;1157;1507;93901;46659;31.7;15.7
18;2021-05-11;1694;1751;95595;48410;32.3;16.3
18;2021-05-12;1808;1493;97403;49903;32.9;16.8
18;2021-05-13;1061;370;98464;50273;33.2;17.0
18;2021-05-14;1347;943;99811;51216;33.7;17.3
18;2021-05-15;1810;1159;101621;52375;34.3;17.7
18;2021-05-16;538;582;102159;52957;34.5;17.9
18;2021-05-17;1245;1092;103404;54049;34.9;18.2
18;2021-05-18;2147;931;105551;54980;35.6;18.5
18;2021-05-19;2163;916;107714;55896;36.3;18.9
18;2021-05-20;2276;980;109990;56876;37.1;19.2
18;2021-05-21;1498;762;111488;57638;37.6;19.4
18;2021-05-22;1724;1074;113212;58712;38.2;19.8
18;2021-05-23;485;336;113697;59048;38.4;19.9
18;2021-05-24;462;292;114159;59340;38.5;20.0
18;2021-05-25;1843;1065;116002;60405;39.1;20.4
18;2021-05-26;2151;839;118153;61244;39.9;20.7
18;2021-05-27;2207;1231;120360;62475;40.6;21.1
18;2021-05-28;1713;1305;122073;63780;41.2;21.5
18;2021-05-29;2620;1662;124693;65442;42.1;22.1
18;2021-05-30;1483;505;126176;65947;42.6;22.2
18;2021-05-31;1786;694;127962;66641;43.2;22.5
18;2021-06-01;2040;948;130002;67589;43.9;22.8
18;2021-06-02;2009;1022;132011;68611;44.5;23.1
18;2021-06-03;2284;1196;134295;69807;45.3;23.6
18;2021-06-04;1909;1123;136204;70930;46.0;23.9
18;2021-06-05;2803;1449;139007;72379;46.9;24.4
18;2021-06-06;365;381;139372;72760;47.0;24.5
18;2021-06-07;1296;1232;140668;73992;47.5;25.0
18;2021-06-08;1492;1393;142160;75385;48.0;25.4
18;2021-06-09;1328;1065;143488;76450;48.4;25.8
18;2021-06-10;1632;1407;145120;77857;49.0;26.3
18;2021-06-11;1496;1405;146616;79262;49.5;26.7
18;2021-06-12;1243;2509;147859;81771;49.9;27.6
18;2021-06-13;126;262;147985;82033;49.9;27.7
18;2021-06-14;657;1827;148642;83860;50.1;28.3
18;2021-06-15;1093;1821;149735;85681;50.5;28.9
18;2021-06-16;1255;1438;150990;87119;50.9;29.4
18;2021-06-17;1204;1670;152194;88789;51.3;30.0
18;2021-06-18;1292;1665;153486;90454;51.8;30.5
18;2021-06-19;1564;1251;155050;91705;52.3;30.9
18;2021-06-20;247;159;155297;91864;52.4;31.0
18;2021-06-21;665;1597;155962;93461;52.6;31.5
18;2021-06-22;1069;1638;157031;95099;53.0;32.1
18;2021-06-23;942;1640;157973;96739;53.3;32.6
18;2021-06-24;1031;1059;159004;97798;53.6;33.0
18;2021-06-25;893;1744;159897;99542;53.9;33.6
18;2021-06-26;1098;1473;160995;101015;54.3;34.1
18;2021-06-27;30;373;161025;101388;54.3;34.2
18;2021-06-28;421;1924;161446;103312;54.5;34.9
18;2021-06-29;595;2380;162041;105692;54.7;35.7
18;2021-06-30;600;2544;162641;108236;54.9;36.5
18;2021-07-01;962;2157;163603;110393;55.2;37.2
18;2021-07-02;616;1685;164219;112078;55.4;37.8
18;2021-07-03;754;2577;164973;114655;55.7;38.7
18;2021-07-04;164;1034;165137;115689;55.7;39.0
18;2021-07-05;763;1878;165900;117567;56.0;39.7
18;2021-07-06;557;2306;166457;119873;56.2;40.4
18;2021-07-07;767;2116;167224;121989;56.4;41.2
18;2021-07-08;1029;1985;168253;123974;56.8;41.8
18;2021-07-09;702;2308;168955;126282;57.0;42.6
18;2021-07-10;778;3181;169733;129463;57.3;43.7
18;2021-07-11;79;665;169812;130128;57.3;43.9
18;2021-07-12;222;2251;170034;132379;57.4;44.7
18;2021-07-13;618;2912;170652;135291;57.6;45.6
18;2021-07-14;194;939;170846;136230;57.6;46.0
18;2021-07-15;1391;2817;172237;139047;58.1;46.9
18;2021-07-16;1174;2131;173411;141178;58.5;47.6
18;2021-07-17;1121;2477;174532;143655;58.9;48.5
18;2021-07-18;228;331;174760;143986;59.0;48.6
18;2021-07-19;1048;1660;175808;145646;59.3;49.1
18;2021-07-20;1621;2270;177429;147916;59.9;49.9
18;2021-07-21;1886;2051;179315;149967;60.5;50.6
18;2021-07-22;2204;1887;181519;151854;61.2;51.2
18;2021-07-23;1390;1613;182909;153467;61.7;51.8
18;2021-07-24;881;1534;183790;155001;62.0;52.3
18;2021-07-25;189;399;183979;155400;62.1;52.4
18;2021-07-26;1395;1504;185374;156904;62.5;52.9
18;2021-07-27;1809;1539;187183;158443;63.2;53.5
18;2021-07-28;2189;1797;189372;160240;63.9;54.1
18;2021-07-29;2136;1817;191508;162057;64.6;54.7
18;2021-07-30;1576;1341;193084;163398;65.1;55.1
18;2021-07-31;1233;1281;194317;164679;65.6;55.6
18;2021-08-01;86;31;194403;164710;65.6;55.6
18;2021-08-02;1400;756;195803;165466;66.1;55.8
18;2021-08-03;1706;1615;197509;167081;66.6;56.4
18;2021-08-04;2408;1085;199917;168166;67.4;56.7
18;2021-08-05;1514;1237;201431;169403;68.0;57.2
19;2020-12-27;0;0;0;0;0.0;0.0
19;2020-12-28;0;0;0;0;0.0;0.0
19;2020-12-29;1;0;1;0;0.0;0.0
19;2020-12-30;0;0;1;0;0.0;0.0
19;2020-12-31;0;0;1;0;0.0;0.0
19;2021-01-01;0;0;1;0;0.0;0.0
19;2021-01-02;0;0;1;0;0.0;0.0
19;2021-01-03;0;0;1;0;0.0;0.0
19;2021-01-04;0;0;1;0;0.0;0.0
19;2021-01-05;0;0;1;0;0.0;0.0
19;2021-01-06;0;0;1;0;0.0;0.0
19;2021-01-07;343;1;344;1;0.1;0.0
19;2021-01-08;247;1;591;2;0.2;0.0
19;2021-01-09;1;0;592;2;0.2;0.0
19;2021-01-10;1;0;593;2;0.2;0.0
19;2021-01-11;38;0;631;2;0.3;0.0
19;2021-01-12;413;1;1044;3;0.4;0.0
19;2021-01-13;422;3;1466;6;0.6;0.0
19;2021-01-14;473;1;1939;7;0.8;0.0
19;2021-01-15;224;0;2163;7;0.9;0.0
19;2021-01-16;0;0;2163;7;0.9;0.0
19;2021-01-17;1;0;2164;7;0.9;0.0
19;2021-01-18;251;1;2415;8;1.0;0.0
19;2021-01-19;518;0;2933;8;1.2;0.0
19;2021-01-20;921;1;3854;9;1.6;0.0
19;2021-01-21;505;3;4359;12;1.8;0.0
19;2021-01-22;1317;3;5676;15;2.4;0.0
19;2021-01-23;281;0;5957;15;2.5;0.0
19;2021-01-24;36;0;5993;15;2.5;0.0
19;2021-01-25;233;0;6226;15;2.6;0.0
19;2021-01-26;607;4;6833;19;2.8;0.0
19;2021-01-27;334;3;7167;22;3.0;0.0
19;2021-01-28;297;249;7464;271;3.1;0.1
19;2021-01-29;347;60;7811;331;3.3;0.1
19;2021-01-30;130;24;7941;355;3.3;0.1
19;2021-01-31;41;0;7982;355;3.3;0.1
19;2021-02-01;155;95;8137;450;3.4;0.2
19;2021-02-02;303;429;8440;879;3.5;0.4
19;2021-02-03;284;244;8724;1123;3.6;0.5
19;2021-02-04;255;376;8979;1499;3.7;0.6
19;2021-02-05;310;75;9289;1574;3.9;0.7
19;2021-02-06;211;1;9500;1575;4.0;0.7
19;2021-02-07;48;1;9548;1576;4.0;0.7
19;2021-02-08;177;150;9725;1726;4.0;0.7
19;2021-02-09;333;275;10058;2001;4.2;0.8
19;2021-02-10;515;296;10573;2297;4.4;1.0
19;2021-02-11;412;325;10985;2622;4.6;1.1
19;2021-02-12;797;1167;11782;3789;4.9;1.6
19;2021-02-13;351;184;12133;3973;5.0;1.7
19;2021-02-14;98;13;12231;3986;5.1;1.7
19;2021-02-15;200;247;12431;4233;5.2;1.8
19;2021-02-16;385;172;12816;4405;5.3;1.8
19;2021-02-17;305;469;13121;4874;5.5;2.0
19;2021-02-18;174;511;13295;5385;5.5;2.2
19;2021-02-19;469;301;13764;5686;5.7;2.4
19;2021-02-20;133;208;13897;5894;5.8;2.5
19;2021-02-21;20;40;13917;5934;5.8;2.5
19;2021-02-22;219;210;14136;6144;5.9;2.6
19;2021-02-23;268;362;14404;6506;6.0;2.7
19;2021-02-24;359;210;14763;6716;6.1;2.8
19;2021-02-25;519;380;15282;7096;6.4;3.0
19;2021-02-26;395;317;15677;7413;6.5;3.1
19;2021-02-27;348;161;16025;7574;6.7;3.2
19;2021-02-28;68;36;16093;7610;6.7;3.2
19;2021-03-01;266;221;16359;7831;6.8;3.3
19;2021-03-02;428;258;16787;8089;7.0;3.4
19;2021-03-03;688;337;17475;8426;7.3;3.5
19;2021-03-04;825;350;18300;8776;7.6;3.7
19;2021-03-05;892;735;19192;9511;8.0;4.0
19;2021-03-06;1072;215;20264;9726;8.4;4.0
19;2021-03-07;463;37;20727;9763;8.6;4.1
19;2021-03-08;636;160;21363;9923;8.9;4.1
19;2021-03-09;835;248;22198;10171;9.2;4.2
19;2021-03-10;1154;317;23352;10488;9.7;4.4
19;2021-03-11;1272;308;24624;10796;10.2;4.5
19;2021-03-12;1135;404;25759;11200;10.7;4.7
19;2021-03-13;1110;165;26869;11365;11.2;4.7
19;2021-03-14;159;84;27028;11449;11.2;4.8
19;2021-03-15;699;135;27727;11584;11.5;4.8
19;2021-03-16;688;302;28415;11886;11.8;4.9
19;2021-03-17;837;280;29252;12166;12.2;5.1
19;2021-03-18;767;283;30019;12449;12.5;5.2
19;2021-03-19;1013;488;31032;12937;12.9;5.4
19;2021-03-20;782;131;31814;13068;13.2;5.4
19;2021-03-21;128;4;31942;13072;13.3;5.4
19;2021-03-22;549;177;32491;13249;13.5;5.5
19;2021-03-23;1044;231;33535;13480;14.0;5.6
19;2021-03-24;1169;372;34704;13852;14.4;5.8
19;2021-03-25;1188;414;35892;14266;14.9;5.9
19;2021-03-26;1323;272;37215;14538;15.5;6.0
19;2021-03-27;855;187;38070;14725;15.8;6.1
19;2021-03-28;63;60;38133;14785;15.9;6.2
19;2021-03-29;610;177;38743;14962;16.1;6.2
19;2021-03-30;970;343;39713;15305;16.5;6.4
19;2021-03-31;1156;500;40869;15805;17.0;6.6
19;2021-04-01;1493;424;42362;16229;17.6;6.8
19;2021-04-02;1006;525;43368;16754;18.0;7.0
19;2021-04-03;597;283;43965;17037;18.3;7.1
19;2021-04-04;130;3;44095;17040;18.3;7.1
19;2021-04-05;40;75;44135;17115;18.4;7.1
19;2021-04-06;736;603;44871;17718;18.7;7.4
19;2021-04-07;978;732;45849;18450;19.1;7.7
19;2021-04-08;1115;1013;46964;19463;19.5;8.1
19;2021-04-09;1640;610;48604;20073;20.2;8.4
19;2021-04-10;945;555;49549;20628;20.6;8.6
19;2021-04-11;558;75;50107;20703;20.8;8.6
19;2021-04-12;680;521;50787;21224;21.1;8.8
19;2021-04-13;915;577;51702;21801;21.5;9.1
19;2021-04-14;1336;838;53038;22639;22.1;9.4
19;2021-04-15;1229;869;54267;23508;22.6;9.8
19;2021-04-16;1504;819;55771;24327;23.2;10.1
19;2021-04-17;761;476;56532;24803;23.5;10.3
19;2021-04-18;659;69;57191;24872;23.8;10.3
19;2021-04-19;730;439;57921;25311;24.1;10.5
19;2021-04-20;977;747;58898;26058;24.5;10.8
19;2021-04-21;1271;697;60169;26755;25.0;11.1
19;2021-04-22;1189;890;61358;27645;25.5;11.5
19;2021-04-23;1127;1020;62485;28665;26.0;11.9
19;2021-04-24;678;673;63163;29338;26.3;12.2
19;2021-04-25;675;69;63838;29407;26.6;12.2
19;2021-04-26;1056;327;64894;29734;27.0;12.4
19;2021-04-27;1028;570;65922;30304;27.4;12.6
19;2021-04-28;1553;552;67475;30856;28.1;12.8
19;2021-04-29;1452;1194;68927;32050;28.7;13.3
19;2021-04-30;1877;1058;70804;33108;29.5;13.8
19;2021-05-01;669;168;71473;33276;29.7;13.8
19;2021-05-02;550;150;72023;33426;30.0;13.9
19;2021-05-03;854;548;72877;33974;30.3;14.1
19;2021-05-04;1025;707;73902;34681;30.7;14.4
19;2021-05-05;1254;739;75156;35420;31.3;14.7
19;2021-05-06;1127;1199;76283;36619;31.7;15.2
19;2021-05-07;1665;1187;77948;37806;32.4;15.7
19;2021-05-08;712;209;78660;38015;32.7;15.8
19;2021-05-09;487;545;79147;38560;32.9;16.0
19;2021-05-10;1164;670;80311;39230;33.4;16.3
19;2021-05-11;1636;856;81947;40086;34.1;16.7
19;2021-05-12;1944;1317;83891;41403;34.9;17.2
19;2021-05-13;571;242;84462;41645;35.1;17.3
19;2021-05-14;1645;987;86107;42632;35.8;17.7
19;2021-05-15;1443;590;87550;43222;36.4;18.0
19;2021-05-16;349;82;87899;43304;36.6;18.0
19;2021-05-17;1497;544;89396;43848;37.2;18.2
19;2021-05-18;1671;486;91067;44334;37.9;18.4
19;2021-05-19;1997;817;93064;45151;38.7;18.8
19;2021-05-20;1720;888;94784;46039;39.4;19.2
19;2021-05-21;1964;814;96748;46853;40.3;19.5
19;2021-05-22;1272;652;98020;47505;40.8;19.8
19;2021-05-23;324;130;98344;47635;40.9;19.8
19;2021-05-24;139;46;98483;47681;41.0;19.8
19;2021-05-25;1503;487;99986;48168;41.6;20.0
19;2021-05-26;1926;664;101912;48832;42.4;20.3
19;2021-05-27;1786;831;103698;49663;43.1;20.7
19;2021-05-28;1938;988;105636;50651;44.0;21.1
19;2021-05-29;1372;705;107008;51356;44.5;21.4
19;2021-05-30;190;497;107198;51853;44.6;21.6
19;2021-05-31;1200;537;108398;52390;45.1;21.8
19;2021-06-01;1281;883;109679;53273;45.6;22.2
19;2021-06-02;1817;959;111496;54232;46.4;22.6
19;2021-06-03;1447;1252;112943;55484;47.0;23.1
19;2021-06-04;1847;1349;114790;56833;47.8;23.6
19;2021-06-05;1209;814;115999;57647;48.3;24.0
19;2021-06-06;87;649;116086;58296;48.3;24.3
19;2021-06-07;922;933;117008;59229;48.7;24.6
19;2021-06-08;1105;907;118113;60136;49.1;25.0
19;2021-06-09;1328;1461;119441;61597;49.7;25.6
19;2021-06-10;1283;1581;120724;63178;50.2;26.3
19;2021-06-11;1315;1917;122039;65095;50.8;27.1
19;2021-06-12;1356;1317;123395;66412;51.3;27.6
19;2021-06-13;543;422;123938;66834;51.6;27.8
19;2021-06-14;736;1017;124674;67851;51.9;28.2
19;2021-06-15;979;1142;125653;68993;52.3;28.7
19;2021-06-16;1224;1362;126877;70355;52.8;29.3
19;2021-06-17;869;1792;127746;72147;53.2;30.0
19;2021-06-18;1057;2137;128803;74284;53.6;30.9
19;2021-06-19;918;1301;129721;75585;54.0;31.4
19;2021-06-20;395;325;130116;75910;54.1;31.6
19;2021-06-21;499;1075;130615;76985;54.3;32.0
19;2021-06-22;698;1491;131313;78476;54.6;32.7
19;2021-06-23;742;1984;132055;80460;54.9;33.5
19;2021-06-24;685;1663;132740;82123;55.2;34.2
19;2021-06-25;562;2217;133302;84340;55.5;35.1
19;2021-06-26;468;1738;133770;86078;55.7;35.8
19;2021-06-27;288;443;134058;86521;55.8;36.0
19;2021-06-28;315;1500;134373;88021;55.9;36.6
19;2021-06-29;352;1890;134725;89911;56.1;37.4
19;2021-06-30;790;2151;135515;92062;56.4;38.3
19;2021-07-01;358;2317;135873;94379;56.5;39.3
19;2021-07-02;778;2318;136651;96697;56.9;40.2
19;2021-07-03;511;1737;137162;98434;57.1;41.0
19;2021-07-04;1;73;137163;98507;57.1;41.0
19;2021-07-05;599;1016;137762;99523;57.3;41.4
19;2021-07-06;505;1539;138267;101062;57.5;42.1
19;2021-07-07;705;2047;138972;103109;57.8;42.9
19;2021-07-08;767;2149;139739;105258;58.1;43.8
19;2021-07-09;714;2658;140453;107916;58.4;44.9
19;2021-07-10;586;1705;141039;109621;58.7;45.6
19;2021-07-11;45;212;141084;109833;58.7;45.7
19;2021-07-12;446;1489;141530;111322;58.9;46.3
19;2021-07-13;677;1829;142207;113151;59.2;47.1
19;2021-07-14;200;273;142407;113424;59.3;47.2
19;2021-07-15;867;2052;143274;115476;59.6;48.0
19;2021-07-16;1219;2440;144493;117916;60.1;49.1
19;2021-07-17;700;1718;145193;119634;60.4;49.8
19;2021-07-18;363;666;145556;120300;60.6;50.1
19;2021-07-19;961;1405;146517;121705;61.0;50.6
19;2021-07-20;962;1672;147479;123377;61.4;51.3
19;2021-07-21;1068;1711;148547;125088;61.8;52.0
19;2021-07-22;1386;1854;149933;126942;62.4;52.8
19;2021-07-23;1775;1987;151708;128929;63.1;53.6
19;2021-07-24;905;1752;152613;130681;63.5;54.4
19;2021-07-25;157;513;152770;131194;63.6;54.6
19;2021-07-26;896;908;153666;132102;63.9;55.0
19;2021-07-27;1418;1110;155084;133212;64.5;55.4
19;2021-07-28;2036;1219;157120;134431;65.4;55.9
19;2021-07-29;1611;1198;158731;135629;66.0;56.4
19;2021-07-30;1898;1017;160629;136646;66.8;56.9
19;2021-07-31;1115;1013;161744;137659;67.3;57.3
19;2021-08-01;348;370;162092;138029;67.4;57.4
19;2021-08-02;1135;803;163227;138832;67.9;57.8
19;2021-08-03;1444;1038;164671;139870;68.5;58.2
19;2021-08-04;1952;752;166623;140622;69.3;58.5
19;2021-08-05;1574;930;168197;141552;70.0;58.9
21;2020-12-27;4;0;4;0;0.0;0.0
21;2020-12-28;1;0;5;0;0.0;0.0
21;2020-12-29;19;0;24;0;0.0;0.0
21;2020-12-30;22;0;46;0;0.0;0.0
21;2020-12-31;0;0;46;0;0.0;0.0
21;2021-01-01;0;0;46;0;0.0;0.0
21;2021-01-02;1;0;47;0;0.0;0.0
21;2021-01-03;0;0;47;0;0.0;0.0
21;2021-01-04;22;0;69;0;0.0;0.0
21;2021-01-05;250;2;319;2;0.1;0.0
21;2021-01-06;300;0;619;2;0.1;0.0
21;2021-01-07;387;0;1006;2;0.2;0.0
21;2021-01-08;455;2;1461;4;0.3;0.0
21;2021-01-09;252;0;1713;4;0.3;0.0
21;2021-01-10;1;0;1714;4;0.3;0.0
21;2021-01-11;623;1;2337;5;0.4;0.0
21;2021-01-12;652;0;2989;5;0.6;0.0
21;2021-01-13;702;2;3691;7;0.7;0.0
21;2021-01-14;1185;5;4876;12;0.9;0.0
21;2021-01-15;715;4;5591;16;1.0;0.0
21;2021-01-16;162;0;5753;16;1.1;0.0
21;2021-01-17;4;0;5757;16;1.1;0.0
21;2021-01-18;1315;7;7072;23;1.3;0.0
21;2021-01-19;1362;2;8434;25;1.6;0.0
21;2021-01-20;1295;46;9729;71;1.8;0.0
21;2021-01-21;1537;2;11266;73;2.1;0.0
21;2021-01-22;1240;4;12506;77;2.3;0.0
21;2021-01-23;488;0;12994;77;2.4;0.0
21;2021-01-24;122;0;13116;77;2.5;0.0
21;2021-01-25;923;18;14039;95;2.6;0.0
21;2021-01-26;1537;146;15576;241;2.9;0.0
21;2021-01-27;2040;153;17616;394;3.3;0.1
21;2021-01-28;1448;227;19064;621;3.6;0.1
21;2021-01-29;1022;212;20086;833;3.8;0.2
21;2021-01-30;469;31;20555;864;3.9;0.2
21;2021-01-31;97;3;20652;867;3.9;0.2
21;2021-02-01;451;288;21103;1155;4.0;0.2
21;2021-02-02;453;442;21556;1597;4.0;0.3
21;2021-02-03;440;283;21996;1880;4.1;0.4
21;2021-02-04;416;549;22412;2429;4.2;0.5
21;2021-02-05;487;526;22899;2955;4.3;0.6
21;2021-02-06;154;223;23053;3178;4.3;0.6
21;2021-02-07;2;2;23055;3180;4.3;0.6
21;2021-02-08;434;391;23489;3571;4.4;0.7
21;2021-02-09;514;519;24003;4090;4.5;0.8
21;2021-02-10;460;584;24463;4674;4.6;0.9
21;2021-02-11;483;737;24946;5411;4.7;1.0
21;2021-02-12;356;938;25302;6349;4.7;1.2
21;2021-02-13;360;321;25662;6670;4.8;1.3
21;2021-02-14;238;147;25900;6817;4.9;1.3
21;2021-02-15;118;1426;26018;8243;4.9;1.5
21;2021-02-16;207;1575;26225;9818;4.9;1.8
21;2021-02-17;395;1987;26620;11805;5.0;2.2
21;2021-02-18;603;1359;27223;13164;5.1;2.5
21;2021-02-19;215;1144;27438;14308;5.1;2.7
21;2021-02-20;122;428;27560;14736;5.2;2.8
21;2021-02-21;1;83;27561;14819;5.2;2.8
21;2021-02-22;81;779;27642;15598;5.2;2.9
21;2021-02-23;169;1043;27811;16641;5.2;3.1
21;2021-02-24;224;749;28035;17390;5.3;3.3
21;2021-02-25;646;836;28681;18226;5.4;3.4
21;2021-02-26;925;723;29606;18949;5.6;3.6
21;2021-02-27;535;301;30141;19250;5.7;3.6
21;2021-02-28;24;135;30165;19385;5.7;3.6
21;2021-03-01;679;630;30844;20015;5.8;3.8
21;2021-03-02;1054;551;31898;20566;6.0;3.9
21;2021-03-03;1162;439;33060;21005;6.2;3.9
21;2021-03-04;1682;520;34742;21525;6.5;4.0
21;2021-03-05;2198;656;36940;22181;6.9;4.2
21;2021-03-06;1592;197;38532;22378;7.2;4.2
21;2021-03-07;4;16;38536;22394;7.2;4.2
21;2021-03-08;770;445;39306;22839;7.4;4.3
21;2021-03-09;1567;567;40873;23406;7.7;4.4
21;2021-03-10;1625;557;42498;23963;8.0;4.5
21;2021-03-11;2188;691;44686;24654;8.4;4.6
21;2021-03-12;2895;430;47581;25084;8.9;4.7
21;2021-03-13;1931;186;49512;25270;9.3;4.7
21;2021-03-14;38;50;49550;25320;9.3;4.8
21;2021-03-15;1409;82;50959;25402;9.6;4.8
21;2021-03-16;1878;144;52837;25546;9.9;4.8
21;2021-03-17;1799;109;54636;25655;10.3;4.8
21;2021-03-18;2120;256;56756;25911;10.7;4.9
21;2021-03-19;1961;142;58717;26053;11.0;4.9
21;2021-03-20;1228;37;59945;26090;11.2;4.9
21;2021-03-21;1;0;59946;26090;11.2;4.9
21;2021-03-22;1555;86;61501;26176;11.5;4.9
21;2021-03-23;2691;100;64192;26276;12.0;4.9
21;2021-03-24;2889;154;67081;26430;12.6;5.0
21;2021-03-25;3729;230;70810;26660;13.3;5.0
21;2021-03-26;3656;186;74466;26846;14.0;5.0
21;2021-03-27;1729;55;76195;26901;14.3;5.0
21;2021-03-28;200;37;76395;26938;14.3;5.1
21;2021-03-29;1789;515;78184;27453;14.7;5.2
21;2021-03-30;2349;798;80533;28251;15.1;5.3
21;2021-03-31;2717;653;83250;28904;15.6;5.4
21;2021-04-01;2689;714;85939;29618;16.1;5.6
21;2021-04-02;2245;743;88184;30361;16.5;5.7
21;2021-04-03;1016;277;89200;30638;16.7;5.7
21;2021-04-04;2;12;89202;30650;16.7;5.8
21;2021-04-05;7;0;89209;30650;16.7;5.8
21;2021-04-06;1355;1139;90564;31789;17.0;6.0
21;2021-04-07;1747;970;92311;32759;17.3;6.1
21;2021-04-08;3216;1124;95527;33883;17.9;6.4
21;2021-04-09;3479;1183;99006;35066;18.6;6.6
21;2021-04-10;1378;736;100384;35802;18.8;6.7
21;2021-04-11;144;3;100528;35805;18.9;6.7
21;2021-04-12;1114;1359;101642;37164;19.1;7.0
21;2021-04-13;1655;1782;103297;38946;19.4;7.3
21;2021-04-14;1482;1480;104779;40426;19.7;7.6
21;2021-04-15;1902;1594;106681;42020;20.0;7.9
21;2021-04-16;2321;1313;109002;43333;20.5;8.1
21;2021-04-17;1018;969;110020;44302;20.6;8.3
21;2021-04-18;15;4;110035;44306;20.6;8.3
21;2021-04-19;1110;1327;111145;45633;20.9;8.6
21;2021-04-20;1240;1840;112385;47473;21.1;8.9
21;2021-04-21;1093;1724;113478;49197;21.3;9.2
21;2021-04-22;1276;2216;114754;51413;21.5;9.6
21;2021-04-23;1981;1723;116735;53136;21.9;10.0
21;2021-04-24;1001;870;117736;54006;22.1;10.1
21;2021-04-25;9;168;117745;54174;22.1;10.2
21;2021-04-26;1011;1594;118756;55768;22.3;10.5
21;2021-04-27;1837;1942;120593;57710;22.6;10.8
21;2021-04-28;2231;2221;122824;59931;23.0;11.2
21;2021-04-29;3132;2263;125956;62194;23.6;11.7
21;2021-04-30;3557;1859;129513;64053;24.3;12.0
21;2021-05-01;963;226;130476;64279;24.5;12.1
21;2021-05-02;2;5;130478;64284;24.5;12.1
21;2021-05-03;2082;1347;132560;65631;24.9;12.3
21;2021-05-04;2578;1643;135138;67274;25.4;12.6
21;2021-05-05;2248;1686;137386;68960;25.8;12.9
21;2021-05-06;3010;2239;140396;71199;26.3;13.4
21;2021-05-07;2808;2181;143204;73380;26.9;13.8
21;2021-05-08;1066;267;144270;73647;27.1;13.8
21;2021-05-09;26;175;144296;73822;27.1;13.9
21;2021-05-10;3169;1718;147465;75540;27.7;14.2
21;2021-05-11;4917;1998;152382;77538;28.6;14.6
21;2021-05-12;4800;1737;157182;79275;29.5;14.9
21;2021-05-13;3846;363;161028;79638;30.2;14.9
21;2021-05-14;5198;1462;166226;81100;31.2;15.2
21;2021-05-15;3430;648;169656;81748;31.8;15.3
21;2021-05-16;49;4;169705;81752;31.8;15.3
21;2021-05-17;4130;1246;173835;82998;32.6;15.6
21;2021-05-18;4358;1492;178193;84490;33.4;15.9
21;2021-05-19;3472;1109;181665;85599;34.1;16.1
21;2021-05-20;3895;1344;185560;86943;34.8;16.3
21;2021-05-21;3625;2141;189185;89084;35.5;16.7
21;2021-05-22;1669;767;190854;89851;35.8;16.9
21;2021-05-23;4;17;190858;89868;35.8;16.9
21;2021-05-24;1817;266;192675;90134;36.2;16.9
21;2021-05-25;2645;1971;195320;92105;36.7;17.3
21;2021-05-26;2605;1997;197925;94102;37.1;17.7
21;2021-05-27;4013;2106;201938;96208;37.9;18.1
21;2021-05-28;3571;2826;205509;99034;38.6;18.6
21;2021-05-29;1927;1463;207436;100497;38.9;18.9
21;2021-05-30;96;13;207532;100510;38.9;18.9
21;2021-05-31;2501;1781;210033;102291;39.4;19.2
21;2021-06-01;3452;2260;213485;104551;40.1;19.6
21;2021-06-02;2613;1766;216098;106317;40.6;20.0
21;2021-06-03;3146;2079;219244;108396;41.1;20.3
21;2021-06-04;3279;2586;222523;110982;41.8;20.8
21;2021-06-05;2925;1654;225448;112636;42.3;21.1
21;2021-06-06;51;85;225499;112721;42.3;21.2
21;2021-06-07;4314;1350;229813;114071;43.1;21.4
21;2021-06-08;4938;2139;234751;116210;44.1;21.8
21;2021-06-09;4502;1620;239253;117830;44.9;22.1
21;2021-06-10;3927;2596;243180;120426;45.6;22.6
21;2021-06-11;4163;3108;247343;123534;46.4;23.2
21;2021-06-12;2199;1606;249542;125140;46.8;23.5
21;2021-06-13;29;11;249571;125151;46.8;23.5
21;2021-06-14;2196;2570;251767;127721;47.2;24.0
21;2021-06-15;2959;3091;254726;130812;47.8;24.5
21;2021-06-16;2852;2609;257578;133421;48.3;25.0
21;2021-06-17;3421;3043;260999;136464;49.0;25.6
21;2021-06-18;2426;3799;263425;140263;49.4;26.3
21;2021-06-19;2042;1863;265467;142126;49.8;26.7
21;2021-06-20;26;13;265493;142139;49.8;26.7
21;2021-06-21;1839;3412;267332;145551;50.2;27.3
21;2021-06-22;1879;5834;269211;151385;50.5;28.4
21;2021-06-23;2028;5013;271239;156398;50.9;29.3
21;2021-06-24;2364;4662;273603;161060;51.3;30.2
21;2021-06-25;1525;5899;275128;166959;51.6;31.3
21;2021-06-26;1440;3900;276568;170859;51.9;32.1
21;2021-06-27;17;125;276585;170984;51.9;32.1
21;2021-06-28;1395;4019;277980;175003;52.2;32.8
21;2021-06-29;1634;4178;279614;179181;52.5;33.6
21;2021-06-30;1566;3371;281180;182552;52.8;34.3
21;2021-07-01;1659;4145;282839;186697;53.1;35.0
21;2021-07-02;2168;4224;285007;190921;53.5;35.8
21;2021-07-03;1094;2099;286101;193020;53.7;36.2
21;2021-07-04;37;55;286138;193075;53.7;36.2
21;2021-07-05;1605;3627;287743;196702;54.0;36.9
21;2021-07-06;1345;3589;289088;200291;54.2;37.6
21;2021-07-07;1452;3240;290540;203531;54.5;38.2
21;2021-07-08;1873;4159;292413;207690;54.9;39.0
21;2021-07-09;2071;4352;294484;212042;55.3;39.8
21;2021-07-10;1088;2552;295572;214594;55.5;40.3
21;2021-07-11;19;74;295591;214668;55.5;40.3
21;2021-07-12;1649;3730;297240;218398;55.8;41.0
21;2021-07-13;2298;4895;299538;223293;56.2;41.9
21;2021-07-14;2869;2014;302407;225307;56.7;42.3
21;2021-07-15;3796;4556;306203;229863;57.5;43.1
21;2021-07-16;3875;5257;310078;235120;58.2;44.1
21;2021-07-17;2764;4163;312842;239283;58.7;44.9
21;2021-07-18;155;81;312997;239364;58.7;44.9
21;2021-07-19;2377;4625;315374;243989;59.2;45.8
21;2021-07-20;2747;5495;318121;249484;59.7;46.8
21;2021-07-21;2892;4790;321013;254274;60.2;47.7
21;2021-07-22;3000;4718;324013;258992;60.8;48.6
21;2021-07-23;4326;4873;328339;263865;61.6;49.5
21;2021-07-24;3030;3008;331369;266873;62.2;50.1
21;2021-07-25;67;39;331436;266912;62.2;50.1
21;2021-07-26;2651;3577;334087;270489;62.7;50.8
21;2021-07-27;3363;3771;337450;274260;63.3;51.5
21;2021-07-28;3508;3336;340958;277596;64.0;52.1
21;2021-07-29;4010;3358;344968;280954;64.7;52.7
21;2021-07-30;4514;3332;349482;284286;65.6;53.3
21;2021-07-31;3395;2354;352877;286640;66.2;53.8
21;2021-08-01;328;53;353205;286693;66.3;53.8
21;2021-08-02;2443;3158;355648;289851;66.7;54.4
21;2021-08-03;2532;2763;358180;292614;67.2;54.9
21;2021-08-04;2275;2464;360455;295078;67.6;55.4
21;2021-08-05;2090;3066;362545;298144;68.0;55.9
22;2020-12-27;0;0;0;0;0.0;0.0
22;2020-12-28;0;0;0;0;0.0;0.0
22;2020-12-29;0;0;0;0;0.0;0.0
22;2020-12-30;0;0;0;0;0.0;0.0
22;2020-12-31;0;0;0;0;0.0;0.0
22;2021-01-01;0;0;0;0;0.0;0.0
22;2021-01-02;2;0;2;0;0.0;0.0
22;2021-01-03;0;0;2;0;0.0;0.0
22;2021-01-04;4;0;6;0;0.0;0.0
22;2021-01-05;61;0;67;0;0.0;0.0
22;2021-01-06;114;1;181;1;0.0;0.0
22;2021-01-07;67;0;248;1;0.0;0.0
22;2021-01-08;174;0;422;1;0.1;0.0
22;2021-01-09;1;0;423;1;0.1;0.0
22;2021-01-10;0;0;423;1;0.1;0.0
22;2021-01-11;233;3;656;4;0.1;0.0
22;2021-01-12;627;0;1283;4;0.2;0.0
22;2021-01-13;675;1;1958;5;0.3;0.0
22;2021-01-14;715;8;2673;13;0.4;0.0
22;2021-01-15;527;2;3200;15;0.5;0.0
22;2021-01-16;97;0;3297;15;0.6;0.0
22;2021-01-17;1;0;3298;15;0.6;0.0
22;2021-01-18;310;1;3608;16;0.6;0.0
22;2021-01-19;680;1;4288;17;0.7;0.0
22;2021-01-20;598;0;4886;17;0.8;0.0
22;2021-01-21;947;1;5833;18;1.0;0.0
22;2021-01-22;838;2;6671;20;1.1;0.0
22;2021-01-23;219;0;6890;20;1.2;0.0
22;2021-01-24;1;0;6891;20;1.2;0.0
22;2021-01-25;747;10;7638;30;1.3;0.0
22;2021-01-26;1015;59;8653;89;1.5;0.0
22;2021-01-27;3855;110;12508;199;2.1;0.0
22;2021-01-28;4511;84;17019;283;2.9;0.0
22;2021-01-29;1884;129;18903;412;3.2;0.1
22;2021-01-30;287;0;19190;412;3.2;0.1
22;2021-01-31;2;0;19192;412;3.2;0.1
22;2021-02-01;641;81;19833;493;3.3;0.1
22;2021-02-02;903;436;20736;929;3.5;0.2
22;2021-02-03;690;504;21426;1433;3.6;0.2
22;2021-02-04;966;636;22392;2069;3.8;0.3
22;2021-02-05;721;563;23113;2632;3.9;0.4
22;2021-02-06;249;0;23362;2632;3.9;0.4
22;2021-02-07;0;0;23362;2632;3.9;0.4
22;2021-02-08;531;133;23893;2765;4.0;0.5
22;2021-02-09;615;344;24508;3109;4.1;0.5
22;2021-02-10;425;201;24933;3310;4.2;0.6
22;2021-02-11;1086;324;26019;3634;4.4;0.6
22;2021-02-12;594;329;26613;3963;4.5;0.7
22;2021-02-13;319;78;26932;4041;4.5;0.7
22;2021-02-14;0;5;26932;4046;4.5;0.7
22;2021-02-15;672;428;27604;4474;4.6;0.8
22;2021-02-16;1041;705;28645;5179;4.8;0.9
22;2021-02-17;1203;2462;29848;7641;5.0;1.3
22;2021-02-18;2140;3002;31988;10643;5.4;1.8
22;2021-02-19;1636;1944;33624;12587;5.6;2.1
22;2021-02-20;479;213;34103;12800;5.7;2.1
22;2021-02-21;4;49;34107;12849;5.7;2.2
22;2021-02-22;402;721;34509;13570;5.8;2.3
22;2021-02-23;663;931;35172;14501;5.9;2.4
22;2021-02-24;695;945;35867;15446;6.0;2.6
22;2021-02-25;1201;1207;37068;16653;6.2;2.8
22;2021-02-26;1065;710;38133;17363;6.4;2.9
22;2021-02-27;563;284;38696;17647;6.5;3.0
22;2021-02-28;16;8;38712;17655;6.5;3.0
22;2021-03-01;955;524;39667;18179;6.7;3.0
22;2021-03-02;1205;874;40872;19053;6.9;3.2
22;2021-03-03;1325;860;42197;19913;7.1;3.3
22;2021-03-04;1599;930;43796;20843;7.3;3.5
22;2021-03-05;2103;806;45899;21649;7.7;3.6
22;2021-03-06;1113;295;47012;21944;7.9;3.7
22;2021-03-07;219;1;47231;21945;7.9;3.7
22;2021-03-08;1291;655;48522;22600;8.1;3.8
22;2021-03-09;1824;746;50346;23346;8.4;3.9
22;2021-03-10;1983;1003;52329;24349;8.8;4.1
22;2021-03-11;2371;1653;54700;26002;9.2;4.4
22;2021-03-12;3096;956;57796;26958;9.7;4.5
22;2021-03-13;1710;289;59506;27247;10.0;4.6
22;2021-03-14;245;23;59751;27270;10.0;4.6
22;2021-03-15;1616;565;61367;27835;10.3;4.7
22;2021-03-16;1597;853;62964;28688;10.6;4.8
22;2021-03-17;2645;699;65609;29387;11.0;4.9
22;2021-03-18;2552;1107;68161;30494;11.4;5.1
22;2021-03-19;3278;796;71439;31290;12.0;5.2
22;2021-03-20;2208;284;73647;31574;12.4;5.3
22;2021-03-21;16;0;73663;31574;12.4;5.3
22;2021-03-22;2364;359;76027;31933;12.8;5.4
22;2021-03-23;3144;781;79171;32714;13.3;5.5
22;2021-03-24;3484;683;82655;33397;13.9;5.6
22;2021-03-25;3952;599;86607;33996;14.5;5.7
22;2021-03-26;4003;477;90610;34473;15.2;5.8
22;2021-03-27;2084;179;92694;34652;15.5;5.8
22;2021-03-28;67;1;92761;34653;15.6;5.8
22;2021-03-29;2769;908;95530;35561;16.0;6.0
22;2021-03-30;3563;1153;99093;36714;16.6;6.2
22;2021-03-31;3674;1087;102767;37801;17.2;6.3
22;2021-04-01;4921;1117;107688;38918;18.1;6.5
22;2021-04-02;4392;1033;112080;39951;18.8;6.7
22;2021-04-03;1996;403;114076;40354;19.1;6.8
22;2021-04-04;37;0;114113;40354;19.1;6.8
22;2021-04-05;14;0;114127;40354;19.1;6.8
22;2021-04-06;3289;1139;117416;41493;19.7;7.0
22;2021-04-07;3425;1363;120841;42856;20.3;7.2
22;2021-04-08;4444;1317;125285;44173;21.0;7.4
22;2021-04-09;5184;1351;130469;45524;21.9;7.6
22;2021-04-10;2443;364;132912;45888;22.3;7.7
22;2021-04-11;477;8;133389;45896;22.4;7.7
22;2021-04-12;2986;995;136375;46891;22.9;7.9
22;2021-04-13;3320;1517;139695;48408;23.4;8.1
22;2021-04-14;3168;2484;142863;50892;24.0;8.5
22;2021-04-15;3597;2433;146460;53325;24.6;8.9
22;2021-04-16;3628;2489;150088;55814;25.2;9.4
22;2021-04-17;1915;1786;152003;57600;25.5;9.7
22;2021-04-18;17;0;152020;57600;25.5;9.7
22;2021-04-19;3021;2142;155041;59742;26.0;10.0
22;2021-04-20;3306;2787;158347;62529;26.6;10.5
22;2021-04-21;3223;2731;161570;65260;27.1;10.9
22;2021-04-22;3593;3128;165163;68388;27.7;11.5
22;2021-04-23;3727;3165;168890;71553;28.3;12.0
22;2021-04-24;1993;1962;170883;73515;28.7;12.3
22;2021-04-25;17;0;170900;73515;28.7;12.3
22;2021-04-26;3208;2846;174108;76361;29.2;12.8
22;2021-04-27;3373;3143;177481;79504;29.8;13.3
22;2021-04-28;3490;3149;180971;82653;30.4;13.9
22;2021-04-29;4079;3271;185050;85924;31.0;14.4
22;2021-04-30;3904;3225;188954;89149;31.7;15.0
22;2021-05-01;60;69;189014;89218;31.7;15.0
22;2021-05-02;1237;59;190251;89277;31.9;15.0
22;2021-05-03;2030;2709;192281;91986;32.3;15.4
22;2021-05-04;2154;2896;194435;94882;32.6;15.9
22;2021-05-05;2052;3007;196487;97889;33.0;16.4
22;2021-05-06;2510;3497;198997;101386;33.4;17.0
22;2021-05-07;2830;3406;201827;104792;33.9;17.6
22;2021-05-08;45;122;201872;104914;33.9;17.6
22;2021-05-09;600;435;202472;105349;34.0;17.7
22;2021-05-10;4473;2725;206945;108074;34.7;18.1
22;2021-05-11;5104;2901;212049;110975;35.6;18.6
22;2021-05-12;6599;1017;218648;111992;36.7;18.8
22;2021-05-13;528;35;219176;112027;36.8;18.8
22;2021-05-14;6401;1082;225577;113109;37.8;19.0
22;2021-05-15;3987;426;229564;113535;38.5;19.0
22;2021-05-16;419;36;229983;113571;38.6;19.0
22;2021-05-17;5665;516;235648;114087;39.5;19.1
22;2021-05-18;6007;946;241655;115033;40.5;19.3
22;2021-05-19;6126;703;247781;115736;41.6;19.4
22;2021-05-20;6588;1374;254369;117110;42.7;19.6
22;2021-05-21;5889;1460;260258;118570;43.7;19.9
22;2021-05-22;4083;772;264341;119342;44.3;20.0
22;2021-05-23;406;14;264747;119356;44.4;20.0
22;2021-05-24;5305;221;270052;119577;45.3;20.1
22;2021-05-25;5631;1177;275683;120754;46.2;20.3
22;2021-05-26;4212;2804;279895;123558;46.9;20.7
22;2021-05-27;4501;3839;284396;127397;47.7;21.4
22;2021-05-28;4386;4439;288782;131836;48.4;22.1
22;2021-05-29;3046;1770;291828;133606;48.9;22.4
22;2021-05-30;19;7;291847;133613;49.0;22.4
22;2021-05-31;3651;3153;295498;136766;49.6;22.9
22;2021-06-01;3519;3690;299017;140456;50.2;23.6
22;2021-06-02;3081;3384;302098;143840;50.7;24.1
22;2021-06-03;3193;4097;305291;147937;51.2;24.8
22;2021-06-04;3369;4548;308660;152485;51.8;25.6
22;2021-06-05;3540;2026;312200;154511;52.4;25.9
22;2021-06-06;213;29;312413;154540;52.4;25.9
22;2021-06-07;3039;3254;315452;157794;52.9;26.5
22;2021-06-08;2791;3529;318243;161323;53.4;27.1
22;2021-06-09;2538;3507;320781;164830;53.8;27.6
22;2021-06-10;2517;4250;323298;169080;54.2;28.4
22;2021-06-11;2543;4228;325841;173308;54.7;29.1
22;2021-06-12;2412;1455;328253;174763;55.1;29.3
22;2021-06-13;133;1093;328386;175856;55.1;29.5
22;2021-06-14;2638;2466;331024;178322;55.5;29.9
22;2021-06-15;3093;2997;334117;181319;56.0;30.4
22;2021-06-16;3003;2810;337120;184129;56.5;30.9
22;2021-06-17;2569;3178;339689;187307;57.0;31.4
22;2021-06-18;3098;4113;342787;191420;57.5;32.1
22;2021-06-19;2982;1453;345769;192873;58.0;32.4
22;2021-06-20;154;8;345923;192881;58.0;32.4
22;2021-06-21;1775;5020;347698;197901;58.3;33.2
22;2021-06-22;2401;5554;350099;203455;58.7;34.1
22;2021-06-23;1277;6206;351376;209661;58.9;35.2
22;2021-06-24;2570;3913;353946;213574;59.4;35.8
22;2021-06-25;1554;6814;355500;220388;59.6;37.0
22;2021-06-26;782;3856;356282;224244;59.8;37.6
22;2021-06-27;4;512;356286;224756;59.8;37.7
22;2021-06-28;1050;5588;357336;230344;59.9;38.6
22;2021-06-29;1370;5958;358706;236302;60.2;39.6
22;2021-06-30;1120;5738;359826;242040;60.4;40.6
22;2021-07-01;1360;6041;361186;248081;60.6;41.6
22;2021-07-02;1701;6091;362887;254172;60.9;42.6
22;2021-07-03;989;3817;363876;257989;61.0;43.3
22;2021-07-04;144;364;364020;258353;61.1;43.3
22;2021-07-05;1560;5803;365580;264156;61.3;44.3
22;2021-07-06;2297;5995;367877;270151;61.7;45.3
22;2021-07-07;2248;4932;370125;275083;62.1;46.1
22;2021-07-08;2486;5098;372611;280181;62.5;47.0
22;2021-07-09;2462;5384;375073;285565;62.9;47.9
22;2021-07-10;1772;3355;376845;288920;63.2;48.5
22;2021-07-11;479;71;377324;288991;63.3;48.5
22;2021-07-12;2287;4731;379611;293722;63.7;49.3
22;2021-07-13;3754;5050;383365;298772;64.3;50.1
22;2021-07-14;691;2499;384056;301271;64.4;50.5
22;2021-07-15;3787;4626;387843;305897;65.1;51.3
22;2021-07-16;3779;5293;391622;311190;65.7;52.2
22;2021-07-17;2519;3418;394141;314608;66.1;52.8
22;2021-07-18;561;86;394702;314694;66.2;52.8
22;2021-07-19;2714;4103;397416;318797;66.7;53.5
22;2021-07-20;3824;4128;401240;322925;67.3;54.2
22;2021-07-21;3936;3409;405176;326334;68.0;54.7
22;2021-07-22;4780;3704;409956;330038;68.8;55.4
22;2021-07-23;4397;4210;414353;334248;69.5;56.1
22;2021-07-24;2228;2617;416581;336865;69.9;56.5
22;2021-07-25;117;150;416698;337015;69.9;56.5
22;2021-07-26;2981;3911;419679;340926;70.4;57.2
22;2021-07-27;3643;4916;423322;345842;71.0;58.0
22;2021-07-28;3636;3643;426958;349485;71.6;58.6
22;2021-07-29;4244;3768;431202;353253;72.3;59.3
22;2021-07-30;3994;3970;435196;357223;73.0;59.9
22;2021-07-31;2374;2789;437570;360012;73.4;60.4
22;2021-08-01;114;152;437684;360164;73.4;60.4
22;2021-08-02;4615;2516;442299;362680;74.2;60.8
22;2021-08-03;4745;3409;447044;366089;75.0;61.4
22;2021-08-04;5713;2467;452757;368556;75.9;61.8
22;2021-08-05;4081;3787;456838;372343;76.6;62.5
23;2020-12-27;0;0;0;0;0.0;0.0
23;2020-12-28;1;0;1;0;0.0;0.0
23;2020-12-29;0;0;1;0;0.0;0.0
23;2020-12-30;0;0;1;0;0.0;0.0
23;2020-12-31;0;0;1;0;0.0;0.0
23;2021-01-01;0;0;1;0;0.0;0.0
23;2021-01-02;1;0;2;0;0.0;0.0
23;2021-01-03;0;0;2;0;0.0;0.0
23;2021-01-04;1;0;3;0;0.0;0.0
23;2021-01-05;3;0;6;0;0.0;0.0
23;2021-01-06;10;0;16;0;0.0;0.0
23;2021-01-07;116;0;132;0;0.1;0.0
23;2021-01-08;116;0;248;0;0.2;0.0
23;2021-01-09;35;0;283;0;0.2;0.0
23;2021-01-10;1;0;284;0;0.2;0.0
23;2021-01-11;173;0;457;0;0.4;0.0
23;2021-01-12;234;1;691;1;0.6;0.0
23;2021-01-13;308;0;999;1;0.9;0.0
23;2021-01-14;292;3;1291;4;1.1;0.0
23;2021-01-15;334;5;1625;9;1.4;0.0
23;2021-01-16;163;1;1788;10;1.5;0.0
23;2021-01-17;0;0;1788;10;1.5;0.0
23;2021-01-18;341;1;2129;11;1.8;0.0
23;2021-01-19;497;2;2626;13;2.3;0.0
23;2021-01-20;362;1;2988;14;2.6;0.0
23;2021-01-21;697;1;3685;15;3.2;0.0
23;2021-01-22;477;0;4162;15;3.6;0.0
23;2021-01-23;368;1;4530;16;3.9;0.0
23;2021-01-24;0;0;4530;16;3.9;0.0
23;2021-01-25;382;17;4912;33;4.2;0.0
23;2021-01-26;300;5;5212;38;4.5;0.0
23;2021-01-27;228;3;5440;41;4.7;0.0
23;2021-01-28;232;47;5672;88;4.9;0.1
23;2021-01-29;303;103;5975;191;5.1;0.2
23;2021-01-30;100;28;6075;219;5.2;0.2
23;2021-01-31;2;34;6077;253;5.2;0.2
23;2021-02-01;147;106;6224;359;5.4;0.3
23;2021-02-02;157;123;6381;482;5.5;0.4
23;2021-02-03;105;210;6486;692;5.6;0.6
23;2021-02-04;78;265;6564;957;5.6;0.8
23;2021-02-05;115;314;6679;1271;5.7;1.1
23;2021-02-06;14;168;6693;1439;5.8;1.2
23;2021-02-07;1;0;6694;1439;5.8;1.2
23;2021-02-08;125;218;6819;1657;5.9;1.4
23;2021-02-09;85;296;6904;1953;5.9;1.7
23;2021-02-10;89;283;6993;2236;6.0;1.9
23;2021-02-11;244;590;7237;2826;6.2;2.4
23;2021-02-12;174;284;7411;3110;6.4;2.7
23;2021-02-13;8;191;7419;3301;6.4;2.8
23;2021-02-14;8;0;7427;3301;6.4;2.8
23;2021-02-15;157;367;7584;3668;6.5;3.2
23;2021-02-16;103;443;7687;4111;6.6;3.5
23;2021-02-17;65;493;7752;4604;6.7;4.0
23;2021-02-18;142;370;7894;4974;6.8;4.3
23;2021-02-19;109;253;8003;5227;6.9;4.5
23;2021-02-20;2;93;8005;5320;6.9;4.6
23;2021-02-21;0;0;8005;5320;6.9;4.6
23;2021-02-22;104;212;8109;5532;7.0;4.8
23;2021-02-23;107;220;8216;5752;7.1;4.9
23;2021-02-24;174;168;8390;5920;7.2;5.1
23;2021-02-25;183;109;8573;6029;7.4;5.2
23;2021-02-26;287;165;8860;6194;7.6;5.3
23;2021-02-27;112;10;8972;6204;7.7;5.3
23;2021-02-28;1;31;8973;6235;7.7;5.4
23;2021-03-01;88;201;9061;6436;7.8;5.5
23;2021-03-02;229;132;9290;6568;8.0;5.6
23;2021-03-03;132;90;9422;6658;8.1;5.7
23;2021-03-04;307;138;9729;6796;8.4;5.8
23;2021-03-05;517;111;10246;6907;8.8;5.9
23;2021-03-06;494;4;10740;6911;9.2;5.9
23;2021-03-07;313;2;11053;6913;9.5;5.9
23;2021-03-08;197;72;11250;6985;9.7;6.0
23;2021-03-09;421;96;11671;7081;10.0;6.1
23;2021-03-10;348;39;12019;7120;10.3;6.1
23;2021-03-11;324;49;12343;7169;10.6;6.2
23;2021-03-12;618;33;12961;7202;11.1;6.2
23;2021-03-13;286;12;13247;7214;11.4;6.2
23;2021-03-14;45;34;13292;7248;11.4;6.2
23;2021-03-15;220;126;13512;7374;11.6;6.3
23;2021-03-16;192;90;13704;7464;11.8;6.4
23;2021-03-17;131;101;13835;7565;11.9;6.5
23;2021-03-18;192;98;14027;7663;12.1;6.6
23;2021-03-19;205;121;14232;7784;12.2;6.7
23;2021-03-20;630;35;14862;7819;12.8;6.7
23;2021-03-21;128;0;14990;7819;12.9;6.7
23;2021-03-22;264;147;15254;7966;13.1;6.9
23;2021-03-23;504;105;15758;8071;13.6;6.9
23;2021-03-24;422;124;16180;8195;13.9;7.0
23;2021-03-25;818;186;16998;8381;14.6;7.2
23;2021-03-26;733;194;17731;8575;15.2;7.4
23;2021-03-27;505;48;18236;8623;15.7;7.4
23;2021-03-28;3;9;18239;8632;15.7;7.4
23;2021-03-29;358;111;18597;8743;16.0;7.5
23;2021-03-30;537;175;19134;8918;16.5;7.7
23;2021-03-31;411;173;19545;9091;16.8;7.8
23;2021-04-01;600;169;20145;9260;17.3;8.0
23;2021-04-02;498;296;20643;9556;17.8;8.2
23;2021-04-03;715;43;21358;9599;18.4;8.3
23;2021-04-04;4;0;21362;9599;18.4;8.3
23;2021-04-05;0;3;21362;9602;18.4;8.3
23;2021-04-06;381;294;21743;9896;18.7;8.5
23;2021-04-07;705;307;22448;10203;19.3;8.8
23;2021-04-08;803;232;23251;10435;20.0;9.0
23;2021-04-09;939;357;24190;10792;20.8;9.3
23;2021-04-10;1097;108;25287;10900;21.7;9.4
23;2021-04-11;21;2;25308;10902;21.8;9.4
23;2021-04-12;692;233;26000;11135;22.4;9.6
23;2021-04-13;667;301;26667;11436;22.9;9.8
23;2021-04-14;586;174;27253;11610;23.4;10.0
23;2021-04-15;928;182;28181;11792;24.2;10.1
23;2021-04-16;902;206;29083;11998;25.0;10.3
23;2021-04-17;994;551;30077;12549;25.9;10.8
23;2021-04-18;3;136;30080;12685;25.9;10.9
23;2021-04-19;611;296;30691;12981;26.4;11.2
23;2021-04-20;721;289;31412;13270;27.0;11.4
23;2021-04-21;733;394;32145;13664;27.6;11.8
23;2021-04-22;657;473;32802;14137;28.2;12.2
23;2021-04-23;592;340;33394;14477;28.7;12.5
23;2021-04-24;855;448;34249;14925;29.5;12.8
23;2021-04-25;0;0;34249;14925;29.5;12.8
23;2021-04-26;615;252;34864;15177;30.0;13.1
23;2021-04-27;675;426;35539;15603;30.6;13.4
23;2021-04-28;628;275;36167;15878;31.1;13.7
23;2021-04-29;883;379;37050;16257;31.9;14.0
23;2021-04-30;719;787;37769;17044;32.5;14.7
23;2021-05-01;1223;38;38992;17082;33.5;14.7
23;2021-05-02;14;0;39006;17082;33.5;14.7
23;2021-05-03;431;520;39437;17602;33.9;15.1
23;2021-05-04;616;511;40053;18113;34.4;15.6
23;2021-05-05;538;711;40591;18824;34.9;16.2
23;2021-05-06;727;700;41318;19524;35.5;16.8
23;2021-05-07;683;640;42001;20164;36.1;17.3
23;2021-05-08;1409;586;43410;20750;37.3;17.8
23;2021-05-09;3;0;43413;20750;37.3;17.8
23;2021-05-10;556;656;43969;21406;37.8;18.4
23;2021-05-11;561;764;44530;22170;38.3;19.1
23;2021-05-12;720;661;45250;22831;38.9;19.6
23;2021-05-13;536;56;45786;22887;39.4;19.7
23;2021-05-14;788;459;46574;23346;40.1;20.1
23;2021-05-15;994;234;47568;23580;40.9;20.3
23;2021-05-16;0;0;47568;23580;40.9;20.3
23;2021-05-17;567;448;48135;24028;41.4;20.7
23;2021-05-18;773;291;48908;24319;42.1;20.9
23;2021-05-19;1050;256;49958;24575;43.0;21.1
23;2021-05-20;836;317;50794;24892;43.7;21.4
23;2021-05-21;1104;310;51898;25202;44.6;21.7
23;2021-05-22;740;125;52638;25327;45.3;21.8
23;2021-05-23;2;20;52640;25347;45.3;21.8
23;2021-05-24;362;164;53002;25511;45.6;21.9
23;2021-05-25;904;336;53906;25847;46.4;22.2
23;2021-05-26;1076;226;54982;26073;47.3;22.4
23;2021-05-27;931;433;55913;26506;48.1;22.8
23;2021-05-28;781;744;56694;27250;48.8;23.4
23;2021-05-29;638;1100;57332;28350;49.3;24.4
23;2021-05-30;6;63;57338;28413;49.3;24.4
23;2021-05-31;433;540;57771;28953;49.7;24.9
23;2021-06-01;581;826;58352;29779;50.2;25.6
23;2021-06-02;624;521;58976;30300;50.7;26.1
23;2021-06-03;706;550;59682;30850;51.3;26.5
23;2021-06-04;779;613;60461;31463;52.0;27.1
23;2021-06-05;546;777;61007;32240;52.5;27.7
23;2021-06-06;0;0;61007;32240;52.5;27.7
23;2021-06-07;393;696;61400;32936;52.8;28.3
23;2021-06-08;322;775;61722;33711;53.1;29.0
23;2021-06-09;284;649;62006;34360;53.3;29.6
23;2021-06-10;372;692;62378;35052;53.6;30.1
23;2021-06-11;380;808;62758;35860;54.0;30.8
23;2021-06-12;383;1264;63141;37124;54.3;31.9
23;2021-06-13;13;5;63154;37129;54.3;31.9
23;2021-06-14;236;590;63390;37719;54.5;32.4
23;2021-06-15;230;861;63620;38580;54.7;33.2
23;2021-06-16;362;581;63982;39161;55.0;33.7
23;2021-06-17;338;810;64320;39971;55.3;34.4
23;2021-06-18;355;767;64675;40738;55.6;35.0
23;2021-06-19;490;1523;65165;42261;56.0;36.3
23;2021-06-20;2;11;65167;42272;56.0;36.4
23;2021-06-21;203;620;65370;42892;56.2;36.9
23;2021-06-22;216;683;65586;43575;56.4;37.5
23;2021-06-23;220;749;65806;44324;56.6;38.1
23;2021-06-24;198;606;66004;44930;56.8;38.6
23;2021-06-25;303;815;66307;45745;57.0;39.3
23;2021-06-26;222;999;66529;46744;57.2;40.2
23;2021-06-27;3;0;66532;46744;57.2;40.2
23;2021-06-28;115;693;66647;47437;57.3;40.8
23;2021-06-29;189;823;66836;48260;57.5;41.5
23;2021-06-30;165;944;67001;49204;57.6;42.3
23;2021-07-01;168;870;67169;50074;57.8;43.1
23;2021-07-02;191;1070;67360;51144;57.9;44.0
23;2021-07-03;250;980;67610;52124;58.1;44.8
23;2021-07-04;1;0;67611;52124;58.1;44.8
23;2021-07-05;158;805;67769;52929;58.3;45.5
23;2021-07-06;213;1043;67982;53972;58.5;46.4
23;2021-07-07;209;854;68191;54826;58.6;47.2
23;2021-07-08;252;738;68443;55564;58.9;47.8
23;2021-07-09;272;1010;68715;56574;59.1;48.7
23;2021-07-10;234;646;68949;57220;59.3;49.2
23;2021-07-11;0;0;68949;57220;59.3;49.2
23;2021-07-12;232;702;69181;57922;59.5;49.8
23;2021-07-13;471;920;69652;58842;59.9;50.6
23;2021-07-14;210;321;69862;59163;60.1;50.9
23;2021-07-15;474;813;70336;59976;60.5;51.6
23;2021-07-16;761;570;71097;60546;61.1;52.1
23;2021-07-17;218;479;71315;61025;61.3;52.5
23;2021-07-18;0;1;71315;61026;61.3;52.5
23;2021-07-19;702;629;72017;61655;61.9;53.0
23;2021-07-20;630;567;72647;62222;62.5;53.5
23;2021-07-21;695;634;73342;62856;63.1;54.1
23;2021-07-22;937;436;74279;63292;63.9;54.4
23;2021-07-23;838;504;75117;63796;64.6;54.9
23;2021-07-24;1007;436;76124;64232;65.5;55.2
23;2021-07-25;11;16;76135;64248;65.5;55.3
23;2021-07-26;783;568;76918;64816;66.2;55.7
23;2021-07-27;908;438;77826;65254;66.9;56.1
23;2021-07-28;870;413;78696;65667;67.7;56.5
23;2021-07-29;1044;398;79740;66065;68.6;56.8
23;2021-07-30;938;520;80678;66585;69.4;57.3
23;2021-07-31;1160;304;81838;66889;70.4;57.5
23;2021-08-01;18;8;81856;66897;70.4;57.5
23;2021-08-02;662;503;82518;67400;71.0;58.0
23;2021-08-03;736;459;83254;67859;71.6;58.4
23;2021-08-04;607;296;83861;68155;72.1;58.6
23;2021-08-05;679;359;84540;68514;72.7;58.9
24;2020-12-27;0;0;0;0;0.0;0.0
24;2020-12-28;0;0;0;0;0.0;0.0
24;2020-12-29;2;0;2;0;0.0;0.0
24;2020-12-30;1;0;3;0;0.0;0.0
24;2020-12-31;0;0;3;0;0.0;0.0
24;2021-01-01;0;0;3;0;0.0;0.0
24;2021-01-02;0;0;3;0;0.0;0.0
24;2021-01-03;0;0;3;0;0.0;0.0
24;2021-01-04;0;0;3;0;0.0;0.0
24;2021-01-05;1;0;4;0;0.0;0.0
24;2021-01-06;0;0;4;0;0.0;0.0
24;2021-01-07;190;0;194;0;0.0;0.0
24;2021-01-08;280;0;474;0;0.1;0.0
24;2021-01-09;185;0;659;0;0.2;0.0
24;2021-01-10;35;0;694;0;0.2;0.0
24;2021-01-11;269;0;963;0;0.2;0.0
24;2021-01-12;281;0;1244;0;0.3;0.0
24;2021-01-13;233;1;1477;1;0.4;0.0
24;2021-01-14;1012;9;2489;10;0.6;0.0
24;2021-01-15;602;3;3091;13;0.8;0.0
24;2021-01-16;86;0;3177;13;0.8;0.0
24;2021-01-17;1;1;3178;14;0.8;0.0
24;2021-01-18;298;0;3476;14;0.9;0.0
24;2021-01-19;467;1;3943;15;1.0;0.0
24;2021-01-20;551;0;4494;15;1.1;0.0
24;2021-01-21;644;6;5138;21;1.3;0.0
24;2021-01-22;514;0;5652;21;1.4;0.0
24;2021-01-23;151;1;5803;22;1.4;0.0
24;2021-01-24;2;0;5805;22;1.4;0.0
24;2021-01-25;441;0;6246;22;1.5;0.0
24;2021-01-26;634;66;6880;88;1.7;0.0
24;2021-01-27;1262;12;8142;100;2.0;0.0
24;2021-01-28;983;123;9125;223;2.2;0.1
24;2021-01-29;932;139;10057;362;2.5;0.1
24;2021-01-30;281;1;10338;363;2.5;0.1
24;2021-01-31;0;0;10338;363;2.5;0.1
24;2021-02-01;377;173;10715;536;2.6;0.1
24;2021-02-02;612;314;11327;850;2.8;0.2
24;2021-02-03;650;493;11977;1343;2.9;0.3
24;2021-02-04;975;392;12952;1735;3.2;0.4
24;2021-02-05;686;434;13638;2169;3.3;0.5
24;2021-02-06;137;35;13775;2204;3.4;0.5
24;2021-02-07;33;1;13808;2205;3.4;0.5
24;2021-02-08;309;234;14117;2439;3.5;0.6
24;2021-02-09;451;230;14568;2669;3.6;0.7
24;2021-02-10;372;110;14940;2779;3.7;0.7
24;2021-02-11;556;517;15496;3296;3.8;0.8
24;2021-02-12;495;394;15991;3690;3.9;0.9
24;2021-02-13;202;46;16193;3736;4.0;0.9
24;2021-02-14;89;1;16282;3737;4.0;0.9
24;2021-02-15;187;241;16469;3978;4.0;1.0
24;2021-02-16;334;522;16803;4500;4.1;1.1
24;2021-02-17;579;827;17382;5327;4.3;1.3
24;2021-02-18;441;730;17823;6057;4.4;1.5
24;2021-02-19;460;676;18283;6733;4.5;1.6
24;2021-02-20;163;143;18446;6876;4.5;1.7
24;2021-02-21;107;0;18553;6876;4.5;1.7
24;2021-02-22;426;530;18979;7406;4.6;1.8
24;2021-02-23;562;682;19541;8088;4.8;2.0
24;2021-02-24;534;832;20075;8920;4.9;2.2
24;2021-02-25;725;863;20800;9783;5.1;2.4
24;2021-02-26;975;972;21775;10755;5.3;2.6
24;2021-02-27;363;265;22138;11020;5.4;2.7
24;2021-02-28;24;4;22162;11024;5.4;2.7
24;2021-03-01;292;373;22454;11397;5.5;2.8
24;2021-03-02;538;417;22992;11814;5.6;2.9
24;2021-03-03;679;342;23671;12156;5.8;3.0
24;2021-03-04;913;507;24584;12663;6.0;3.1
24;2021-03-05;1065;563;25649;13226;6.3;3.2
24;2021-03-06;1122;141;26771;13367;6.6;3.3
24;2021-03-07;232;62;27003;13429;6.6;3.3
24;2021-03-08;530;257;27533;13686;6.7;3.4
24;2021-03-09;1173;442;28706;14128;7.0;3.5
24;2021-03-10;1141;448;29847;14576;7.3;3.6
24;2021-03-11;1603;461;31450;15037;7.7;3.7
24;2021-03-12;2049;440;33499;15477;8.2;3.8
24;2021-03-13;1344;202;34843;15679;8.5;3.8
24;2021-03-14;141;92;34984;15771;8.6;3.9
24;2021-03-15;952;169;35936;15940;8.8;3.9
24;2021-03-16;1141;231;37077;16171;9.1;4.0
24;2021-03-17;1215;284;38292;16455;9.4;4.0
24;2021-03-18;1055;556;39347;17011;9.6;4.2
24;2021-03-19;1254;534;40601;17545;9.9;4.3
24;2021-03-20;1055;149;41656;17694;10.2;4.3
24;2021-03-21;25;11;41681;17705;10.2;4.3
24;2021-03-22;1223;421;42904;18126;10.5;4.4
24;2021-03-23;1879;399;44783;18525;11.0;4.5
24;2021-03-24;1888;386;46671;18911;11.4;4.6
24;2021-03-25;1989;465;48660;19376;11.9;4.7
24;2021-03-26;2373;283;51033;19659;12.5;4.8
24;2021-03-27;1349;40;52382;19699;12.8;4.8
24;2021-03-28;61;9;52443;19708;12.8;4.8
24;2021-03-29;1673;325;54116;20033;13.3;4.9
24;2021-03-30;2408;395;56524;20428;13.8;5.0
24;2021-03-31;2181;311;58705;20739;14.4;5.1
24;2021-04-01;2195;311;60900;21050;14.9;5.2
24;2021-04-02;2072;395;62972;21445;15.4;5.3
24;2021-04-03;1373;122;64345;21567;15.8;5.3
24;2021-04-04;73;0;64418;21567;15.8;5.3
24;2021-04-05;946;58;65364;21625;16.0;5.3
24;2021-04-06;2351;699;67715;22324;16.6;5.5
24;2021-04-07;2717;689;70432;23013;17.2;5.6
24;2021-04-08;3005;955;73437;23968;18.0;5.9
24;2021-04-09;3486;1002;76923;24970;18.8;6.1
24;2021-04-10;2593;308;79516;25278;19.5;6.2
24;2021-04-11;1101;19;80617;25297;19.7;6.2
24;2021-04-12;2496;818;83113;26115;20.4;6.4
24;2021-04-13;2902;1201;86015;27316;21.1;6.7
24;2021-04-14;2934;1189;88949;28505;21.8;7.0
24;2021-04-15;2792;1088;91741;29593;22.5;7.2
24;2021-04-16;3266;965;95007;30558;23.3;7.5
24;2021-04-17;2269;499;97276;31057;23.8;7.6
24;2021-04-18;424;6;97700;31063;23.9;7.6
24;2021-04-19;1598;1009;99298;32072;24.3;7.9
24;2021-04-20;2266;1427;101564;33499;24.9;8.2
24;2021-04-21;2145;1440;103709;34939;25.4;8.6
24;2021-04-22;2061;1256;105770;36195;25.9;8.9
24;2021-04-23;1958;1333;107728;37528;26.4;9.2
24;2021-04-24;861;725;108589;38253;26.6;9.4
24;2021-04-25;54;4;108643;38257;26.6;9.4
24;2021-04-26;1295;1480;109938;39737;26.9;9.7
24;2021-04-27;1853;1880;111791;41617;27.4;10.2
24;2021-04-28;1504;1954;113295;43571;27.7;10.7
24;2021-04-29;1726;1886;115021;45457;28.2;11.1
24;2021-04-30;2269;1776;117290;47233;28.7;11.6
24;2021-05-01;2054;1066;119344;48299;29.2;11.8
24;2021-05-02;1923;209;121267;48508;29.7;11.9
24;2021-05-03;1474;1834;122741;50342;30.1;12.3
24;2021-05-04;2227;2291;124968;52633;30.6;12.9
24;2021-05-05;1887;2719;126855;55352;31.1;13.6
24;2021-05-06;1888;2773;128743;58125;31.5;14.2
24;2021-05-07;2262;2789;131005;60914;32.1;14.9
24;2021-05-08;1282;1152;132287;62066;32.4;15.2
24;2021-05-09;1166;899;133453;62965;32.7;15.4
24;2021-05-10;1095;2627;134548;65592;32.9;16.1
24;2021-05-11;2037;2795;136585;68387;33.4;16.7
24;2021-05-12;1925;2253;138510;70640;33.9;17.3
24;2021-05-13;1465;1214;139975;71854;34.3;17.6
24;2021-05-14;2378;1332;142353;73186;34.9;17.9
24;2021-05-15;2049;812;144402;73998;35.4;18.1
24;2021-05-16;1170;347;145572;74345;35.6;18.2
24;2021-05-17;2242;1254;147814;75599;36.2;18.5
24;2021-05-18;2481;1817;150295;77416;36.8;19.0
24;2021-05-19;2284;1377;152579;78793;37.4;19.3
24;2021-05-20;2373;1580;154952;80373;37.9;19.7
24;2021-05-21;2433;1413;157385;81786;38.5;20.0
24;2021-05-22;1719;406;159104;82192;39.0;20.1
24;2021-05-23;951;72;160055;82264;39.2;20.1
24;2021-05-24;1514;335;161569;82599;39.6;20.2
24;2021-05-25;2297;1382;163866;83981;40.1;20.6
24;2021-05-26;2147;1315;166013;85296;40.7;20.9
24;2021-05-27;1748;2196;167761;87492;41.1;21.4
24;2021-05-28;2145;2004;169906;89496;41.6;21.9
24;2021-05-29;1151;2089;171057;91585;41.9;22.4
24;2021-05-30;1418;170;172475;91755;42.2;22.5
24;2021-05-31;1743;1365;174218;93120;42.7;22.8
24;2021-06-01;2573;1973;176791;95093;43.3;23.3
24;2021-06-02;2652;1784;179443;96877;43.9;23.7
24;2021-06-03;2291;1465;181734;98342;44.5;24.1
24;2021-06-04;2381;1892;184115;100234;45.1;24.5
24;2021-06-05;2005;1417;186120;101651;45.6;24.9
24;2021-06-06;767;223;186887;101874;45.8;24.9
24;2021-06-07;1432;1492;188319;103366;46.1;25.3
24;2021-06-08;1676;1909;189995;105275;46.5;25.8
24;2021-06-09;1322;1596;191317;106871;46.8;26.2
24;2021-06-10;1575;1908;192892;108779;47.2;26.6
24;2021-06-11;1326;2079;194218;110858;47.6;27.1
24;2021-06-12;1125;2544;195343;113402;47.8;27.8
24;2021-06-13;1238;921;196581;114323;48.1;28.0
24;2021-06-14;1165;1859;197746;116182;48.4;28.4
24;2021-06-15;1486;2992;199232;119174;48.8;29.2
24;2021-06-16;1672;2732;200904;121906;49.2;29.9
24;2021-06-17;1542;2182;202446;124088;49.6;30.4
24;2021-06-18;1398;2862;203844;126950;49.9;31.1
24;2021-06-19;1275;1520;205119;128470;50.2;31.5
24;2021-06-20;513;498;205632;128968;50.4;31.6
24;2021-06-21;931;1834;206563;130802;50.6;32.0
24;2021-06-22;1454;2592;208017;133394;50.9;32.7
24;2021-06-23;1426;2420;209443;135814;51.3;33.3
24;2021-06-24;1134;1913;210577;137727;51.6;33.7
24;2021-06-25;966;2817;211543;140544;51.8;34.4
24;2021-06-26;863;2104;212406;142648;52.0;34.9
24;2021-06-27;402;976;212808;143624;52.1;35.2
24;2021-06-28;814;2482;213622;146106;52.3;35.8
24;2021-06-29;937;2866;214559;148972;52.5;36.5
24;2021-06-30;1106;2457;215665;151429;52.8;37.1
24;2021-07-01;1126;2297;216791;153726;53.1;37.6
24;2021-07-02;1093;2743;217884;156469;53.4;38.3
24;2021-07-03;808;1902;218692;158371;53.5;38.8
24;2021-07-04;410;1011;219102;159382;53.6;39.0
24;2021-07-05;786;2315;219888;161697;53.8;39.6
24;2021-07-06;877;3355;220765;165052;54.1;40.4
24;2021-07-07;1080;3042;221845;168094;54.3;41.2
24;2021-07-08;1339;2121;223184;170215;54.6;41.7
24;2021-07-09;1173;3224;224357;173439;54.9;42.5
24;2021-07-10;479;1963;224836;175402;55.1;42.9
24;2021-07-11;584;1188;225420;176590;55.2;43.2
24;2021-07-12;893;2525;226313;179115;55.4;43.9
24;2021-07-13;1321;3220;227634;182335;55.7;44.6
24;2021-07-14;612;1191;228246;183526;55.9;44.9
24;2021-07-15;1687;2780;229933;186306;56.3;45.6
24;2021-07-16;2137;2604;232070;188910;56.8;46.3
24;2021-07-17;1521;2236;233591;191146;57.2;46.8
24;2021-07-18;706;886;234297;192032;57.4;47.0
24;2021-07-19;1566;2184;235863;194216;57.8;47.6
24;2021-07-20;2004;2445;237867;196661;58.2;48.2
24;2021-07-21;1871;2327;239738;198988;58.7;48.7
24;2021-07-22;2332;2447;242070;201435;59.3;49.3
24;2021-07-23;2275;2621;244345;204056;59.8;50.0
24;2021-07-24;1802;1539;246147;205595;60.3;50.3
24;2021-07-25;809;867;246956;206462;60.5;50.6
24;2021-07-26;1562;2018;248518;208480;60.9;51.0
24;2021-07-27;2829;2279;251347;210759;61.5;51.6
24;2021-07-28;2723;1933;254070;212692;62.2;52.1
24;2021-07-29;3014;2221;257084;214913;63.0;52.6
24;2021-07-30;2444;1909;259528;216822;63.5;53.1
24;2021-07-31;1632;1551;261160;218373;63.9;53.5
24;2021-08-01;1099;647;262259;219020;64.2;53.6
24;2021-08-02;1910;1618;264169;220638;64.7;54.0
24;2021-08-03;2870;1901;267039;222539;65.4;54.5
24;2021-08-04;3061;1610;270100;224149;66.1;54.9
24;2021-08-05;2984;1417;273084;225566;66.9;55.2
25;2020-12-27;0;0;0;0;0.0;0.0
25;2020-12-28;1;0;1;0;0.0;0.0
25;2020-12-29;0;0;1;0;0.0;0.0
25;2020-12-30;0;0;1;0;0.0;0.0
25;2020-12-31;2;0;3;0;0.0;0.0
25;2021-01-01;0;0;3;0;0.0;0.0
25;2021-01-02;0;0;3;0;0.0;0.0
25;2021-01-03;0;0;3;0;0.0;0.0
25;2021-01-04;0;0;3;0;0.0;0.0
25;2021-01-05;1;0;4;0;0.0;0.0
25;2021-01-06;75;1;79;1;0.0;0.0
25;2021-01-07;236;1;315;2;0.1;0.0
25;2021-01-08;345;1;660;3;0.1;0.0
25;2021-01-09;102;0;762;3;0.1;0.0
25;2021-01-10;0;0;762;3;0.1;0.0
25;2021-01-11;499;4;1261;7;0.2;0.0
25;2021-01-12;675;2;1936;9;0.4;0.0
25;2021-01-13;626;2;2562;11;0.5;0.0
25;2021-01-14;896;15;3458;26;0.6;0.0
25;2021-01-15;784;6;4242;32;0.8;0.0
25;2021-01-16;206;1;4448;33;0.8;0.0
25;2021-01-17;112;0;4560;33;0.8;0.0
25;2021-01-18;1295;7;5855;40;1.1;0.0
25;2021-01-19;1412;4;7267;44;1.3;0.0
25;2021-01-20;1419;4;8686;48;1.6;0.0
25;2021-01-21;1796;2;10482;50;1.9;0.0
25;2021-01-22;1503;3;11985;53;2.2;0.0
25;2021-01-23;499;1;12484;54;2.3;0.0
25;2021-01-24;119;0;12603;54;2.3;0.0
25;2021-01-25;990;0;13593;54;2.5;0.0
25;2021-01-26;1487;42;15080;96;2.8;0.0
25;2021-01-27;1247;70;16327;166;3.0;0.0
25;2021-01-28;1089;76;17416;242;3.2;0.0
25;2021-01-29;905;231;18321;473;3.4;0.1
25;2021-01-30;293;92;18614;565;3.5;0.1
25;2021-01-31;2;0;18616;565;3.5;0.1
25;2021-02-01;611;221;19227;786;3.6;0.1
25;2021-02-02;674;414;19901;1200;3.7;0.2
25;2021-02-03;759;249;20660;1449;3.8;0.3
25;2021-02-04;715;446;21375;1895;4.0;0.4
25;2021-02-05;518;464;21893;2359;4.1;0.4
25;2021-02-06;198;157;22091;2516;4.1;0.5
25;2021-02-07;2;34;22093;2550;4.1;0.5
25;2021-02-08;613;507;22706;3057;4.2;0.6
25;2021-02-09;616;492;23322;3549;4.3;0.7
25;2021-02-10;817;485;24139;4034;4.5;0.7
25;2021-02-11;586;853;24725;4887;4.6;0.9
25;2021-02-12;413;548;25138;5435;4.7;1.0
25;2021-02-13;97;141;25235;5576;4.7;1.0
25;2021-02-14;0;0;25235;5576;4.7;1.0
25;2021-02-15;187;1039;25422;6615;4.7;1.2
25;2021-02-16;214;1456;25636;8071;4.8;1.5
25;2021-02-17;110;1343;25746;9414;4.8;1.7
25;2021-02-18;146;1436;25892;10850;4.8;2.0
25;2021-02-19;102;1270;25994;12120;4.8;2.2
25;2021-02-20;26;493;26020;12613;4.8;2.3
25;2021-02-21;1;143;26021;12756;4.8;2.4
25;2021-02-22;83;1067;26104;13823;4.8;2.6
25;2021-02-23;196;1081;26300;14904;4.9;2.8
25;2021-02-24;104;975;26404;15879;4.9;2.9
25;2021-02-25;522;1006;26926;16885;5.0;3.1
25;2021-02-26;607;981;27533;17866;5.1;3.3
25;2021-02-27;227;374;27760;18240;5.1;3.4
25;2021-02-28;5;1;27765;18241;5.1;3.4
25;2021-03-01;444;620;28209;18861;5.2;3.5
25;2021-03-02;651;833;28860;19694;5.3;3.7
25;2021-03-03;541;732;29401;20426;5.5;3.8
25;2021-03-04;1154;653;30555;21079;5.7;3.9
25;2021-03-05;1852;373;32407;21452;6.0;4.0
25;2021-03-06;1168;224;33575;21676;6.2;4.0
25;2021-03-07;9;6;33584;21682;6.2;4.0
25;2021-03-08;548;709;34132;22391;6.3;4.2
25;2021-03-09;1039;773;35171;23164;6.5;4.3
25;2021-03-10;1150;648;36321;23812;6.7;4.4
25;2021-03-11;1658;578;37979;24390;7.0;4.5
25;2021-03-12;1996;443;39975;24833;7.4;4.6
25;2021-03-13;1114;96;41089;24929;7.6;4.6
25;2021-03-14;35;1;41124;24930;7.6;4.6
25;2021-03-15;1125;131;42249;25061;7.8;4.6
25;2021-03-16;1276;111;43525;25172;8.1;4.7
25;2021-03-17;1414;135;44939;25307;8.3;4.7
25;2021-03-18;1527;77;46466;25384;8.6;4.7
25;2021-03-19;1596;122;48062;25506;8.9;4.7
25;2021-03-20;822;33;48884;25539;9.1;4.7
25;2021-03-21;24;0;48908;25539;9.1;4.7
25;2021-03-22;1486;80;50394;25619;9.3;4.7
25;2021-03-23;2160;132;52554;25751;9.7;4.8
25;2021-03-24;2417;89;54971;25840;10.2;4.8
25;2021-03-25;2838;186;57809;26026;10.7;4.8
25;2021-03-26;3156;167;60965;26193;11.3;4.9
25;2021-03-27;1110;84;62075;26277;11.5;4.9
25;2021-03-28;121;63;62196;26340;11.5;4.9
25;2021-03-29;1786;277;63982;26617;11.9;4.9
25;2021-03-30;2212;388;66194;27005;12.3;5.0
25;2021-03-31;2218;348;68412;27353;12.7;5.1
25;2021-04-01;2451;514;70863;27867;13.1;5.2
25;2021-04-02;2027;594;72890;28461;13.5;5.3
25;2021-04-03;447;107;73337;28568;13.6;5.3
25;2021-04-04;39;21;73376;28589;13.6;5.3
25;2021-04-05;145;4;73521;28593;13.6;5.3
25;2021-04-06;1932;672;75453;29265;14.0;5.4
25;2021-04-07;1878;845;77331;30110;14.3;5.6
25;2021-04-08;2430;815;79761;30925;14.8;5.7
25;2021-04-09;2595;986;82356;31911;15.3;5.9
25;2021-04-10;978;289;83334;32200;15.4;6.0
25;2021-04-11;105;28;83439;32228;15.5;6.0
25;2021-04-12;1557;960;84996;33188;15.8;6.2
25;2021-04-13;1985;1307;86981;34495;16.1;6.4
25;2021-04-14;1750;1211;88731;35706;16.4;6.6
25;2021-04-15;1998;1325;90729;37031;16.8;6.9
25;2021-04-16;2085;992;92814;38023;17.2;7.0
25;2021-04-17;1105;413;93919;38436;17.4;7.1
25;2021-04-18;118;18;94037;38454;17.4;7.1
25;2021-04-19;1326;1249;95363;39703;17.7;7.4
25;2021-04-20;1615;1461;96978;41164;18.0;7.6
25;2021-04-21;1716;1627;98694;42791;18.3;7.9
25;2021-04-22;1858;1706;100552;44497;18.6;8.2
25;2021-04-23;1901;1758;102453;46255;19.0;8.6
25;2021-04-24;1281;705;103734;46960;19.2;8.7
25;2021-04-25;139;113;103873;47073;19.3;8.7
25;2021-04-26;1723;1678;105596;48751;19.6;9.0
25;2021-04-27;2803;1523;108399;50274;20.1;9.3
25;2021-04-28;2425;1551;110824;51825;20.5;9.6
25;2021-04-29;2649;1831;113473;53656;21.0;9.9
25;2021-04-30;3105;1577;116578;55233;21.6;10.2
25;2021-05-01;1789;329;118367;55562;21.9;10.3
25;2021-05-02;442;21;118809;55583;22.0;10.3
25;2021-05-03;2901;834;121710;56417;22.6;10.5
25;2021-05-04;2644;1882;124354;58299;23.1;10.8
25;2021-05-05;2598;1661;126952;59960;23.5;11.1
25;2021-05-06;2927;2166;129879;62126;24.1;11.5
25;2021-05-07;3063;2124;132942;64250;24.6;11.9
25;2021-05-08;1334;227;134276;64477;24.9;12.0
25;2021-05-09;244;87;134520;64564;24.9;12.0
25;2021-05-10;3132;1638;137652;66202;25.5;12.3
25;2021-05-11;3748;2035;141400;68237;26.2;12.6
25;2021-05-12;3686;1788;145086;70025;26.9;13.0
25;2021-05-13;3519;597;148605;70622;27.5;13.1
25;2021-05-14;4483;1303;153088;71925;28.4;13.3
25;2021-05-15;3278;703;156366;72628;29.0;13.5
25;2021-05-16;722;92;157088;72720;29.1;13.5
25;2021-05-17;4090;1089;161178;73809;29.9;13.7
25;2021-05-18;5204;1182;166382;74991;30.8;13.9
25;2021-05-19;5247;1127;171629;76118;31.8;14.1
25;2021-05-20;5132;1448;176761;77566;32.8;14.4
25;2021-05-21;5766;1970;182527;79536;33.8;14.7
25;2021-05-22;3176;722;185703;80258;34.4;14.9
25;2021-05-23;781;154;186484;80412;34.6;14.9
25;2021-05-24;1528;149;188012;80561;34.9;14.9
25;2021-05-25;3514;1644;191526;82205;35.5;15.2
25;2021-05-26;3976;1556;195502;83761;36.2;15.5
25;2021-05-27;4516;1897;200018;85658;37.1;15.9
25;2021-05-28;3990;2650;204008;88308;37.8;16.4
25;2021-05-29;2014;1020;206022;89328;38.2;16.6
25;2021-05-30;174;96;206196;89424;38.2;16.6
25;2021-05-31;2673;1711;208869;91135;38.7;16.9
25;2021-06-01;2729;2157;211598;93292;39.2;17.3
25;2021-06-02;2609;2248;214207;95540;39.7;17.7
25;2021-06-03;3274;2044;217481;97584;40.3;18.1
25;2021-06-04;3206;2407;220687;99991;40.9;18.5
25;2021-06-05;1488;1393;222175;101384;41.2;18.8
25;2021-06-06;985;256;223160;101640;41.4;18.8
25;2021-06-07;2784;2570;225944;104210;41.9;19.3
25;2021-06-08;2604;2759;228548;106969;42.4;19.8
25;2021-06-09;2381;2762;230929;109731;42.8;20.3
25;2021-06-10;2323;2651;233252;112382;43.2;20.8
25;2021-06-11;2712;3308;235964;115690;43.7;21.4
25;2021-06-12;1571;1860;237535;117550;44.0;21.8
25;2021-06-13;496;254;238031;117804;44.1;21.8
25;2021-06-14;1421;3758;239452;121562;44.4;22.5
25;2021-06-15;1641;3565;241093;125127;44.7;23.2
25;2021-06-16;1951;3266;243044;128393;45.1;23.8
25;2021-06-17;1472;3325;244516;131718;45.3;24.4
25;2021-06-18;2278;4294;246794;136012;45.7;25.2
25;2021-06-19;1350;1977;248144;137989;46.0;25.6
25;2021-06-20;57;239;248201;138228;46.0;25.6
25;2021-06-21;1131;4138;249332;142366;46.2;26.4
25;2021-06-22;1140;4676;250472;147042;46.4;27.3
25;2021-06-23;1392;4075;251864;151117;46.7;28.0
25;2021-06-24;1177;4079;253041;155196;46.9;28.8
25;2021-06-25;1634;5608;254675;160804;47.2;29.8
25;2021-06-26;625;3381;255300;164185;47.3;30.4
25;2021-06-27;450;877;255750;165062;47.4;30.6
25;2021-06-28;907;4473;256657;169535;47.6;31.4
25;2021-06-29;1121;5466;257778;175001;47.8;32.4
25;2021-06-30;1309;5367;259087;180368;48.0;33.4
25;2021-07-01;1694;5226;260781;185594;48.3;34.4
25;2021-07-02;1740;5059;262521;190653;48.7;35.3
25;2021-07-03;1032;2694;263553;193347;48.9;35.8
25;2021-07-04;409;722;263962;194069;48.9;36.0
25;2021-07-05;1293;2575;265255;196644;49.2;36.5
25;2021-07-06;1566;4742;266821;201386;49.5;37.3
25;2021-07-07;1569;4507;268390;205893;49.8;38.2
25;2021-07-08;1536;3932;269926;209825;50.0;38.9
25;2021-07-09;1726;4585;271652;214410;50.4;39.7
25;2021-07-10;779;2369;272431;216779;50.5;40.2
25;2021-07-11;126;306;272557;217085;50.5;40.2
25;2021-07-12;1388;3856;273945;220941;50.8;41.0
25;2021-07-13;2459;4773;276404;225714;51.2;41.8
25;2021-07-14;376;561;276780;226275;51.3;41.9
25;2021-07-15;2391;3656;279171;229931;51.8;42.6
25;2021-07-16;3465;3828;282636;233759;52.4;43.3
25;2021-07-17;2192;2024;284828;235783;52.8;43.7
25;2021-07-18;803;1294;285631;237077;52.9;43.9
25;2021-07-19;2527;4197;288158;241274;53.4;44.7
25;2021-07-20;3357;3709;291515;244983;54.0;45.4
25;2021-07-21;3276;3363;294791;248346;54.6;46.0
25;2021-07-22;3310;2966;298101;251312;55.3;46.6
25;2021-07-23;3545;3343;301646;254655;55.9;47.2
25;2021-07-24;1401;2264;303047;256919;56.2;47.6
25;2021-07-25;672;702;303719;257621;56.3;47.8
25;2021-07-26;3038;3010;306757;260631;56.9;48.3
25;2021-07-27;3808;2096;310565;262727;57.6;48.7
25;2021-07-28;3658;2091;314223;264818;58.2;49.1
25;2021-07-29;4302;2077;318525;266895;59.0;49.5
25;2021-07-30;4218;2463;322743;269358;59.8;49.9
25;2021-07-31;1814;1462;324557;270820;60.2;50.2
25;2021-08-01;1341;188;325898;271008;60.4;50.2
25;2021-08-02;2708;2206;328606;273214;60.9;50.6
25;2021-08-03;2806;2188;331412;275402;61.4;51.1
25;2021-08-04;2907;1408;334319;276810;62.0;51.3
25;2021-08-05;2175;1697;336494;278507;62.4;51.6
26;2020-12-27;0;0;0;0;0.0;0.0
26;2020-12-28;0;0;0;0;0.0;0.0
26;2020-12-29;0;0;0;0;0.0;0.0
26;2020-12-30;0;0;0;0;0.0;0.0
26;2020-12-31;0;0;0;0;0.0;0.0
26;2021-01-01;0;0;0;0;0.0;0.0
26;2021-01-02;0;0;0;0;0.0;0.0
26;2021-01-03;0;0;0;0;0.0;0.0
26;2021-01-04;0;0;0;0;0.0;0.0
26;2021-01-05;0;0;0;0;0.0;0.0
26;2021-01-06;0;0;0;0;0.0;0.0
26;2021-01-07;168;0;168;0;0.0;0.0
26;2021-01-08;125;0;293;0;0.1;0.0
26;2021-01-09;2;0;295;0;0.1;0.0
26;2021-01-10;0;0;295;0;0.1;0.0
26;2021-01-11;266;1;561;1;0.1;0.0
26;2021-01-12;175;1;736;2;0.1;0.0
26;2021-01-13;416;1;1152;3;0.2;0.0
26;2021-01-14;487;0;1639;3;0.3;0.0
26;2021-01-15;562;1;2201;4;0.4;0.0
26;2021-01-16;250;1;2451;5;0.5;0.0
26;2021-01-17;0;0;2451;5;0.5;0.0
26;2021-01-18;636;1;3087;6;0.6;0.0
26;2021-01-19;782;4;3869;10;0.7;0.0
26;2021-01-20;742;0;4611;10;0.9;0.0
26;2021-01-21;806;5;5417;15;1.0;0.0
26;2021-01-22;787;4;6204;19;1.2;0.0
26;2021-01-23;563;2;6767;21;1.3;0.0
26;2021-01-24;24;0;6791;21;1.3;0.0
26;2021-01-25;697;0;7488;21;1.4;0.0
26;2021-01-26;801;3;8289;24;1.6;0.0
26;2021-01-27;822;9;9111;33;1.8;0.0
26;2021-01-28;1328;169;10439;202;2.0;0.0
26;2021-01-29;970;65;11409;267;2.2;0.1
26;2021-01-30;605;5;12014;272;2.3;0.1
26;2021-01-31;24;0;12038;272;2.3;0.1
26;2021-02-01;707;189;12745;461;2.4;0.1
26;2021-02-02;1274;202;14019;663;2.7;0.1
26;2021-02-03;1232;257;15251;920;2.9;0.2
26;2021-02-04;985;452;16236;1372;3.1;0.3
26;2021-02-05;671;335;16907;1707;3.2;0.3
26;2021-02-06;408;241;17315;1948;3.3;0.4
26;2021-02-07;57;2;17372;1950;3.3;0.4
26;2021-02-08;544;416;17916;2366;3.4;0.5
26;2021-02-09;617;478;18533;2844;3.6;0.5
26;2021-02-10;664;339;19197;3183;3.7;0.6
26;2021-02-11;753;329;19950;3512;3.8;0.7
26;2021-02-12;589;454;20539;3966;3.9;0.8
26;2021-02-13;388;338;20927;4304;4.0;0.8
26;2021-02-14;36;0;20963;4304;4.0;0.8
26;2021-02-15;413;531;21376;4835;4.1;0.9
26;2021-02-16;294;560;21670;5395;4.2;1.0
26;2021-02-17;195;742;21865;6137;4.2;1.2
26;2021-02-18;337;900;22202;7037;4.3;1.4
26;2021-02-19;341;808;22543;7845;4.3;1.5
26;2021-02-20;95;491;22638;8336;4.3;1.6
26;2021-02-21;3;24;22641;8360;4.3;1.6
26;2021-02-22;144;719;22785;9079;4.4;1.7
26;2021-02-23;397;998;23182;10077;4.5;1.9
26;2021-02-24;342;1223;23524;11300;4.5;2.2
26;2021-02-25;731;1069;24255;12369;4.7;2.4
26;2021-02-26;925;636;25180;13005;4.8;2.5
26;2021-02-27;279;512;25459;13517;4.9;2.6
26;2021-02-28;3;30;25462;13547;4.9;2.6
26;2021-03-01;457;660;25919;14207;5.0;2.7
26;2021-03-02;741;633;26660;14840;5.1;2.9
26;2021-03-03;730;687;27390;15527;5.3;3.0
26;2021-03-04;1043;581;28433;16108;5.5;3.1
26;2021-03-05;1709;518;30142;16626;5.8;3.2
26;2021-03-06;2772;494;32914;17120;6.3;3.3
26;2021-03-07;2987;198;35901;17318;6.9;3.3
26;2021-03-08;908;651;36809;17969;7.1;3.5
26;2021-03-09;1322;550;38131;18519;7.3;3.6
26;2021-03-10;1219;513;39350;19032;7.6;3.7
26;2021-03-11;1608;648;40958;19680;7.9;3.8
26;2021-03-12;2216;469;43174;20149;8.3;3.9
26;2021-03-13;1885;342;45059;20491;8.7;3.9
26;2021-03-14;68;39;45127;20530;8.7;3.9
26;2021-03-15;1652;245;46779;20775;9.0;4.0
26;2021-03-16;1232;510;48011;21285;9.2;4.1
26;2021-03-17;1369;304;49380;21589;9.5;4.1
26;2021-03-18;1587;283;50967;21872;9.8;4.2
26;2021-03-19;2441;345;53408;22217;10.3;4.3
26;2021-03-20;1289;148;54697;22365;10.5;4.3
26;2021-03-21;61;20;54758;22385;10.5;4.3
26;2021-03-22;1845;191;56603;22576;10.9;4.3
26;2021-03-23;2474;268;59077;22844;11.3;4.4
26;2021-03-24;2551;243;61628;23087;11.8;4.4
26;2021-03-25;3040;333;64668;23420;12.4;4.5
26;2021-03-26;3047;346;67715;23766;13.0;4.6
26;2021-03-27;1244;153;68959;23919;13.2;4.6
26;2021-03-28;93;7;69052;23926;13.3;4.6
26;2021-03-29;1908;405;70960;24331;13.6;4.7
26;2021-03-30;2381;538;73341;24869;14.1;4.8
26;2021-03-31;2229;578;75570;25447;14.5;4.9
26;2021-04-01;2275;776;77845;26223;15.0;5.0
26;2021-04-02;2214;981;80059;27204;15.4;5.2
26;2021-04-03;552;1203;80611;28407;15.5;5.5
26;2021-04-04;215;887;80826;29294;15.5;5.6
26;2021-04-05;554;54;81380;29348;15.6;5.6
26;2021-04-06;1486;831;82866;30179;15.9;5.8
26;2021-04-07;1791;900;84657;31079;16.3;6.0
26;2021-04-08;2997;924;87654;32003;16.8;6.1
26;2021-04-09;3414;1000;91068;33003;17.5;6.3
26;2021-04-10;1355;918;92423;33921;17.8;6.5
26;2021-04-11;89;35;92512;33956;17.8;6.5
26;2021-04-12;1713;1126;94225;35082;18.1;6.7
26;2021-04-13;2795;1445;97020;36527;18.6;7.0
26;2021-04-14;2207;1468;99227;37995;19.1;7.3
26;2021-04-15;2275;1578;101502;39573;19.5;7.6
26;2021-04-16;2270;1584;103772;41157;19.9;7.9
26;2021-04-17;1097;841;104869;41998;20.1;8.1
26;2021-04-18;35;52;104904;42050;20.2;8.1
26;2021-04-19;1546;1571;106450;43621;20.4;8.4
26;2021-04-20;1798;1727;108248;45348;20.8;8.7
26;2021-04-21;2011;1507;110259;46855;21.2;9.0
26;2021-04-22;2288;1604;112547;48459;21.6;9.3
26;2021-04-23;2009;1634;114556;50093;22.0;9.6
26;2021-04-24;1654;844;116210;50937;22.3;9.8
26;2021-04-25;629;92;116839;51029;22.4;9.8
26;2021-04-26;1376;1601;118215;52630;22.7;10.1
26;2021-04-27;1986;1685;120201;54315;23.1;10.4
26;2021-04-28;1867;1540;122068;55855;23.4;10.7
26;2021-04-29;2866;1885;124934;57740;24.0;11.1
26;2021-04-30;2622;1761;127556;59501;24.5;11.4
26;2021-05-01;1538;382;129094;59883;24.8;11.5
26;2021-05-02;1085;116;130179;59999;25.0;11.5
26;2021-05-03;2201;1785;132380;61784;25.4;11.9
26;2021-05-04;2610;2351;134990;64135;25.9;12.3
26;2021-05-05;2773;2192;137763;66327;26.5;12.7
26;2021-05-06;3320;2212;141083;68539;27.1;13.2
26;2021-05-07;2855;2259;143938;70798;27.7;13.6
26;2021-05-08;1954;625;145892;71423;28.0;13.7
26;2021-05-09;712;124;146604;71547;28.2;13.7
26;2021-05-10;3020;1824;149624;73371;28.7;14.1
26;2021-05-11;4442;2190;154066;75561;29.6;14.5
26;2021-05-12;4825;1688;158891;77249;30.5;14.8
26;2021-05-13;4364;607;163255;77856;31.4;15.0
26;2021-05-14;4643;1545;167898;79401;32.3;15.3
26;2021-05-15;4468;629;172366;80030;33.1;15.4
26;2021-05-16;3629;340;175995;80370;33.8;15.4
26;2021-05-17;3657;1485;179652;81855;34.5;15.7
26;2021-05-18;4476;1743;184128;83598;35.4;16.1
26;2021-05-19;4482;1446;188610;85044;36.2;16.3
26;2021-05-20;4680;1743;193290;86787;37.1;16.7
26;2021-05-21;4727;1797;198017;88584;38.0;17.0
26;2021-05-22;3188;687;201205;89271;38.7;17.1
26;2021-05-23;1597;184;202802;89455;39.0;17.2
26;2021-05-24;3788;743;206590;90198;39.7;17.3
26;2021-05-25;3590;2336;210180;92534;40.4;17.8
26;2021-05-26;4180;2264;214360;94798;41.2;18.2
26;2021-05-27;4217;2463;218577;97261;42.0;18.7
26;2021-05-28;3775;2769;222352;100030;42.7;19.2
26;2021-05-29;3087;1643;225439;101673;43.3;19.5
26;2021-05-30;322;71;225761;101744;43.4;19.5
26;2021-05-31;3080;1851;228841;103595;44.0;19.9
26;2021-06-01;3108;2304;231949;105899;44.6;20.3
26;2021-06-02;2868;2214;234817;108113;45.1;20.8
26;2021-06-03;2850;2490;237667;110603;45.7;21.2
26;2021-06-04;2660;2905;240327;113508;46.2;21.8
26;2021-06-05;1801;1694;242128;115202;46.5;22.1
26;2021-06-06;8;0;242136;115202;46.5;22.1
26;2021-06-07;2347;2426;244483;117628;47.0;22.6
26;2021-06-08;2454;2293;246937;119921;47.4;23.0
26;2021-06-09;2094;2383;249031;122304;47.8;23.5
26;2021-06-10;1976;2761;251007;125065;48.2;24.0
26;2021-06-11;1896;3272;252903;128337;48.6;24.7
26;2021-06-12;1218;1792;254121;130129;48.8;25.0
26;2021-06-13;96;214;254217;130343;48.8;25.0
26;2021-06-14;1415;3496;255632;133839;49.1;25.7
26;2021-06-15;1584;3961;257216;137800;49.4;26.5
26;2021-06-16;1787;3465;259003;141265;49.8;27.1
26;2021-06-17;1511;3167;260514;144432;50.0;27.7
26;2021-06-18;1798;4367;262312;148799;50.4;28.6
26;2021-06-19;933;3181;263245;151980;50.6;29.2
26;2021-06-20;264;875;263509;152855;50.6;29.4
26;2021-06-21;1006;4550;264515;157405;50.8;30.2
26;2021-06-22;1061;5121;265576;162526;51.0;31.2
26;2021-06-23;1167;5073;266743;167599;51.2;32.2
26;2021-06-24;1262;4539;268005;172138;51.5;33.1
26;2021-06-25;1014;5543;269019;177681;51.7;34.1
26;2021-06-26;662;3822;269681;181503;51.8;34.9
26;2021-06-27;300;1272;269981;182775;51.9;35.1
26;2021-06-28;776;4755;270757;187530;52.0;36.0
26;2021-06-29;1098;4960;271855;192490;52.2;37.0
26;2021-06-30;1412;4887;273267;197377;52.5;37.9
26;2021-07-01;1637;4394;274904;201771;52.8;38.8
26;2021-07-02;1329;5164;276233;206935;53.1;39.8
26;2021-07-03;768;3330;277001;210265;53.2;40.4
26;2021-07-04;332;631;277333;210896;53.3;40.5
26;2021-07-05;884;4676;278217;215572;53.4;41.4
26;2021-07-06;1268;4206;279485;219778;53.7;42.2
26;2021-07-07;1407;3798;280892;223576;54.0;42.9
26;2021-07-08;2364;3330;283256;226906;54.4;43.6
26;2021-07-09;1556;4794;284812;231700;54.7;44.5
26;2021-07-10;907;2917;285719;234617;54.9;45.1
26;2021-07-11;334;351;286053;234968;55.0;45.1
26;2021-07-12;1110;4219;287163;239187;55.2;45.9
26;2021-07-13;2295;4341;289458;243528;55.6;46.8
26;2021-07-14;1056;815;290514;244343;55.8;46.9
26;2021-07-15;3158;3653;293672;247996;56.4;47.6
26;2021-07-16;2946;3689;296618;251685;57.0;48.3
26;2021-07-17;1869;1804;298487;253489;57.3;48.7
26;2021-07-18;17;24;298504;253513;57.3;48.7
26;2021-07-19;2712;3261;301216;256774;57.9;49.3
26;2021-07-20;3690;3361;304906;260135;58.6;50.0
26;2021-07-21;3568;3091;308474;263226;59.3;50.6
26;2021-07-22;4103;2951;312577;266177;60.0;51.1
26;2021-07-23;3842;3384;316419;269561;60.8;51.8
26;2021-07-24;2338;1344;318757;270905;61.2;52.0
26;2021-07-25;607;91;319364;270996;61.4;52.1
26;2021-07-26;3414;2571;322778;273567;62.0;52.6
26;2021-07-27;4797;2599;327575;276166;62.9;53.1
26;2021-07-28;4511;2365;332086;278531;63.8;53.5
26;2021-07-29;3885;2872;335971;281403;64.5;54.1
26;2021-07-30;3471;2664;339442;284067;65.2;54.6
26;2021-07-31;1141;1002;340583;285069;65.4;54.8
26;2021-08-01;402;104;340985;285173;65.5;54.8
26;2021-08-02;2932;2346;343917;287519;66.1;55.2
26;2021-08-03;3282;2273;347199;289792;66.7;55.7
26;2021-08-04;3954;1989;351153;291781;67.5;56.1
26;2021-08-05;3113;2180;354266;293961;68.1;56.5
27;2020-12-27;0;0;0;0;0.0;0.0
27;2020-12-28;0;0;0;0;0.0;0.0
27;2020-12-29;1;0;1;0;0.0;0.0
27;2020-12-30;0;0;1;0;0.0;0.0
27;2020-12-31;0;0;1;0;0.0;0.0
27;2021-01-01;0;0;1;0;0.0;0.0
27;2021-01-02;0;0;1;0;0.0;0.0
27;2021-01-03;2;0;3;0;0.0;0.0
27;2021-01-04;0;0;3;0;0.0;0.0
27;2021-01-05;15;0;18;0;0.0;0.0
27;2021-01-06;161;0;179;0;0.0;0.0
27;2021-01-07;370;0;549;0;0.1;0.0
27;2021-01-08;441;0;990;0;0.2;0.0
27;2021-01-09;72;1;1062;1;0.2;0.0
27;2021-01-10;101;0;1163;1;0.2;0.0
27;2021-01-11;382;0;1545;1;0.3;0.0
27;2021-01-12;409;2;1954;3;0.3;0.0
27;2021-01-13;839;1;2793;4;0.5;0.0
27;2021-01-14;1626;26;4419;30;0.7;0.0
27;2021-01-15;1220;5;5639;35;0.9;0.0
27;2021-01-16;332;2;5971;37;1.0;0.0
27;2021-01-17;205;0;6176;37;1.0;0.0
27;2021-01-18;798;2;6974;39;1.2;0.0
27;2021-01-19;773;2;7747;41;1.3;0.0
27;2021-01-20;870;0;8617;41;1.4;0.0
27;2021-01-21;654;1;9271;42;1.5;0.0
27;2021-01-22;778;4;10049;46;1.7;0.0
27;2021-01-23;350;0;10399;46;1.7;0.0
27;2021-01-24;169;6;10568;52;1.8;0.0
27;2021-01-25;635;16;11203;68;1.9;0.0
27;2021-01-26;461;17;11664;85;1.9;0.0
27;2021-01-27;506;105;12170;190;2.0;0.0
27;2021-01-28;516;297;12686;487;2.1;0.1
27;2021-01-29;507;109;13193;596;2.2;0.1
27;2021-01-30;242;31;13435;627;2.2;0.1
27;2021-01-31;27;24;13462;651;2.2;0.1
27;2021-02-01;348;196;13810;847;2.3;0.1
27;2021-02-02;307;282;14117;1129;2.4;0.2
27;2021-02-03;488;402;14605;1531;2.4;0.3
27;2021-02-04;719;890;15324;2421;2.6;0.4
27;2021-02-05;662;1155;15986;3576;2.7;0.6
27;2021-02-06;125;223;16111;3799;2.7;0.6
27;2021-02-07;25;42;16136;3841;2.7;0.6
27;2021-02-08;310;379;16446;4220;2.7;0.7
27;2021-02-09;341;560;16787;4780;2.8;0.8
27;2021-02-10;302;528;17089;5308;2.8;0.9
27;2021-02-11;318;461;17407;5769;2.9;1.0
27;2021-02-12;229;548;17636;6317;2.9;1.1
27;2021-02-13;152;134;17788;6451;3.0;1.1
27;2021-02-14;6;96;17794;6547;3.0;1.1
27;2021-02-15;388;601;18182;7148;3.0;1.2
27;2021-02-16;295;735;18477;7883;3.1;1.3
27;2021-02-17;247;641;18724;8524;3.1;1.4
27;2021-02-18;363;683;19087;9207;3.2;1.5
27;2021-02-19;219;692;19306;9899;3.2;1.6
27;2021-02-20;129;251;19435;10150;3.2;1.7
27;2021-02-21;12;140;19447;10290;3.2;1.7
27;2021-02-22;483;566;19930;10856;3.3;1.8
27;2021-02-23;496;629;20426;11485;3.4;1.9
27;2021-02-24;543;652;20969;12137;3.5;2.0
27;2021-02-25;843;759;21812;12896;3.6;2.1
27;2021-02-26;954;691;22766;13587;3.8;2.3
27;2021-02-27;406;159;23172;13746;3.9;2.3
27;2021-02-28;173;32;23345;13778;3.9;2.3
27;2021-03-01;484;443;23829;14221;4.0;2.4
27;2021-03-02;765;363;24594;14584;4.1;2.4
27;2021-03-03;851;364;25445;14948;4.2;2.5
27;2021-03-04;883;234;26328;15182;4.4;2.5
27;2021-03-05;1303;234;27631;15416;4.6;2.6
27;2021-03-06;1636;104;29267;15520;4.9;2.6
27;2021-03-07;620;10;29887;15530;5.0;2.6
27;2021-03-08;1204;307;31091;15837;5.2;2.6
27;2021-03-09;1822;262;32913;16099;5.5;2.7
27;2021-03-10;2115;346;35028;16445;5.8;2.7
27;2021-03-11;2147;222;37175;16667;6.2;2.8
27;2021-03-12;2818;191;39993;16858;6.7;2.8
27;2021-03-13;1919;116;41912;16974;7.0;2.8
27;2021-03-14;655;13;42567;16987;7.1;2.8
27;2021-03-15;1550;209;44117;17196;7.3;2.9
27;2021-03-16;1483;231;45600;17427;7.6;2.9
27;2021-03-17;1851;339;47451;17766;7.9;3.0
27;2021-03-18;1684;339;49135;18105;8.2;3.0
27;2021-03-19;1830;167;50965;18272;8.5;3.0
27;2021-03-20;900;39;51865;18311;8.6;3.0
27;2021-03-21;258;3;52123;18314;8.7;3.0
27;2021-03-22;1234;544;53357;18858;8.9;3.1
27;2021-03-23;1626;460;54983;19318;9.2;3.2
27;2021-03-24;1522;472;56505;19790;9.4;3.3
27;2021-03-25;2163;502;58668;20292;9.8;3.4
27;2021-03-26;2530;439;61198;20731;10.2;3.5
27;2021-03-27;1568;198;62766;20929;10.4;3.5
27;2021-03-28;1149;49;63915;20978;10.6;3.5
27;2021-03-29;1376;824;65291;21802;10.9;3.6
27;2021-03-30;1391;846;66682;22648;11.1;3.8
27;2021-03-31;1488;876;68170;23524;11.3;3.9
27;2021-04-01;1956;808;70126;24332;11.7;4.1
27;2021-04-02;1999;1181;72125;25513;12.0;4.2
27;2021-04-03;1562;736;73687;26249;12.3;4.4
27;2021-04-04;977;172;74664;26421;12.4;4.4
27;2021-04-05;282;6;74946;26427;12.5;4.4
27;2021-04-06;1414;1802;76360;28229;12.7;4.7
27;2021-04-07;1321;1745;77681;29974;12.9;5.0
27;2021-04-08;1682;1671;79363;31645;13.2;5.3
27;2021-04-09;2947;1553;82310;33198;13.7;5.5
27;2021-04-10;2034;981;84344;34179;14.0;5.7
27;2021-04-11;946;210;85290;34389;14.2;5.7
27;2021-04-12;2436;1507;87726;35896;14.6;6.0
27;2021-04-13;2392;1549;90118;37445;15.0;6.2
27;2021-04-14;2085;1622;92203;39067;15.3;6.5
27;2021-04-15;1877;1659;94080;40726;15.7;6.8
27;2021-04-16;2752;1112;96832;41838;16.1;7.0
27;2021-04-17;2169;492;99001;42330;16.5;7.0
27;2021-04-18;453;16;99454;42346;16.6;7.0
27;2021-04-19;1712;1173;101166;43519;16.8;7.2
27;2021-04-20;2386;1299;103552;44818;17.2;7.5
27;2021-04-21;2209;1078;105761;45896;17.6;7.6
27;2021-04-22;2179;1410;107940;47306;18.0;7.9
27;2021-04-23;2448;1175;110388;48481;18.4;8.1
27;2021-04-24;3258;1136;113646;49617;18.9;8.3
27;2021-04-25;1128;1049;114774;50666;19.1;8.4
27;2021-04-26;1921;1141;116695;51807;19.4;8.6
27;2021-04-27;2525;1086;119220;52893;19.8;8.8
27;2021-04-28;2390;1309;121610;54202;20.2;9.0
27;2021-04-29;2492;1467;124102;55669;20.7;9.3
27;2021-04-30;2370;1608;126472;57277;21.1;9.5
27;2021-05-01;2637;884;129109;58161;21.5;9.7
27;2021-05-02;1953;892;131062;59053;21.8;9.8
27;2021-05-03;3065;872;134127;59925;22.3;10.0
27;2021-05-04;2781;1642;136908;61567;22.8;10.2
27;2021-05-05;2817;1649;139725;63216;23.3;10.5
27;2021-05-06;3184;1290;142909;64506;23.8;10.7
27;2021-05-07;3323;1999;146232;66505;24.3;11.1
27;2021-05-08;2795;1326;149027;67831;24.8;11.3
27;2021-05-09;1697;297;150724;68128;25.1;11.3
27;2021-05-10;2952;2269;153676;70397;25.6;11.7
27;2021-05-11;3354;1754;157030;72151;26.1;12.0
27;2021-05-12;3462;1726;160492;73877;26.7;12.3
27;2021-05-13;1892;253;162384;74130;27.0;12.3
27;2021-05-14;3882;1786;166266;75916;27.7;12.6
27;2021-05-15;6601;952;172867;76868;28.8;12.8
27;2021-05-16;3668;435;176535;77303;29.4;12.9
27;2021-05-17;2773;1157;179308;78460;29.9;13.1
27;2021-05-18;3845;1287;183153;79747;30.5;13.3
27;2021-05-19;3967;1147;187120;80894;31.2;13.5
27;2021-05-20;3872;1164;190992;82058;31.8;13.7
27;2021-05-21;3967;1799;194959;83857;32.5;14.0
27;2021-05-22;4366;799;199325;84656;33.2;14.1
27;2021-05-23;800;173;200125;84829;33.3;14.1
27;2021-05-24;1490;339;201615;85168;33.6;14.2
27;2021-05-25;3514;1606;205129;86774;34.1;14.4
27;2021-05-26;3856;1738;208985;88512;34.8;14.7
27;2021-05-27;3787;1487;212772;89999;35.4;15.0
27;2021-05-28;3398;2629;216170;92628;36.0;15.4
27;2021-05-29;4824;2294;220994;94922;36.8;15.8
27;2021-05-30;1119;248;222113;95170;37.0;15.8
27;2021-05-31;3464;2274;225577;97444;37.6;16.2
27;2021-06-01;3813;2245;229390;99689;38.2;16.6
27;2021-06-02;3340;2184;232730;101873;38.7;17.0
27;2021-06-03;4429;2126;237159;103999;39.5;17.3
27;2021-06-04;3603;2973;240762;106972;40.1;17.8
27;2021-06-05;3213;3346;243975;110318;40.6;18.4
27;2021-06-06;2004;1008;245979;111326;40.9;18.5
27;2021-06-07;2565;2355;248544;113681;41.4;18.9
27;2021-06-08;3122;2375;251666;116056;41.9;19.3
27;2021-06-09;2301;2469;253967;118525;42.3;19.7
27;2021-06-10;2431;2039;256398;120564;42.7;20.1
27;2021-06-11;2889;3767;259287;124331;43.2;20.7
27;2021-06-12;1984;4189;261271;128520;43.5;21.4
27;2021-06-13;1082;2685;262353;131205;43.7;21.8
27;2021-06-14;1995;3114;264348;134319;44.0;22.4
27;2021-06-15;2687;3020;267035;137339;44.5;22.9
27;2021-06-16;2503;3260;269538;140599;44.9;23.4
27;2021-06-17;2297;3285;271835;143884;45.3;24.0
27;2021-06-18;2744;4420;274579;148304;45.7;24.7
27;2021-06-19;1861;3386;276440;151690;46.0;25.3
27;2021-06-20;608;710;277048;152400;46.1;25.4
27;2021-06-21;1703;3492;278751;155892;46.4;26.0
27;2021-06-22;2383;3721;281134;159613;46.8;26.6
27;2021-06-23;2072;3566;283206;163179;47.1;27.2
27;2021-06-24;2255;3411;285461;166590;47.5;27.7
27;2021-06-25;1934;4458;287395;171048;47.8;28.5
27;2021-06-26;883;5353;288278;176401;48.0;29.4
27;2021-06-27;377;1425;288655;177826;48.1;29.6
27;2021-06-28;1127;3405;289782;181231;48.2;30.2
27;2021-06-29;1699;4368;291481;185599;48.5;30.9
27;2021-06-30;2114;4097;293595;189696;48.9;31.6
27;2021-07-01;2224;3903;295819;193599;49.2;32.2
27;2021-07-02;1583;4614;297402;198213;49.5;33.0
27;2021-07-03;1302;4771;298704;202984;49.7;33.8
27;2021-07-04;506;1405;299210;204389;49.8;34.0
27;2021-07-05;1419;3527;300629;207916;50.0;34.6
27;2021-07-06;1368;4183;301997;212099;50.3;35.3
27;2021-07-07;1754;4899;303751;216998;50.6;36.1
27;2021-07-08;2084;4344;305835;221342;50.9;36.8
27;2021-07-09;1982;5283;307817;226625;51.2;37.7
27;2021-07-10;1165;4176;308982;230801;51.4;38.4
27;2021-07-11;424;1141;309406;231942;51.5;38.6
27;2021-07-12;1240;4378;310646;236320;51.7;39.3
27;2021-07-13;2756;5352;313402;241672;52.2;40.2
27;2021-07-14;1515;1749;314917;243421;52.4;40.5
27;2021-07-15;3028;5467;317945;248888;52.9;41.4
27;2021-07-16;3799;5284;321744;254172;53.6;42.3
27;2021-07-17;2722;3876;324466;258048;54.0;43.0
27;2021-07-18;550;1262;325016;259310;54.1;43.2
27;2021-07-19;3677;3786;328693;263096;54.7;43.8
27;2021-07-20;3428;3586;332121;266682;55.3;44.4
27;2021-07-21;4231;3893;336352;270575;56.0;45.0
27;2021-07-22;4727;3690;341079;274265;56.8;45.7
27;2021-07-23;3567;3390;344646;277655;57.4;46.2
27;2021-07-24;3105;2321;347751;279976;57.9;46.6
27;2021-07-25;491;545;348242;280521;58.0;46.7
27;2021-07-26;3052;3179;351294;283700;58.5;47.2
27;2021-07-27;3568;3098;354862;286798;59.1;47.7
27;2021-07-28;3567;3234;358429;290032;59.7;48.3
27;2021-07-29;4570;3488;362999;293520;60.4;48.9
27;2021-07-30;3787;3134;366786;296654;61.1;49.4
27;2021-07-31;3043;2562;369829;299216;61.6;49.8
27;2021-08-01;536;496;370365;299712;61.7;49.9
27;2021-08-02;3308;2562;373673;302274;62.2;50.3
27;2021-08-03;3410;2766;377083;305040;62.8;50.8
27;2021-08-04;3014;2324;380097;307364;63.3;51.2
27;2021-08-05;2639;2346;382736;309710;63.7;51.6
28;2020-12-27;0;0;0;0;0.0;0.0
28;2020-12-28;0;0;0;0;0.0;0.0
28;2020-12-29;0;0;0;0;0.0;0.0
28;2020-12-30;0;0;0;0;0.0;0.0
28;2020-12-31;0;0;0;0;0.0;0.0
28;2021-01-01;1;0;1;0;0.0;0.0
28;2021-01-02;0;0;1;0;0.0;0.0
28;2021-01-03;0;0;1;0;0.0;0.0
28;2021-01-04;0;0;1;0;0.0;0.0
28;2021-01-05;5;0;6;0;0.0;0.0
28;2021-01-06;84;0;90;0;0.0;0.0
28;2021-01-07;102;0;192;0;0.0;0.0
28;2021-01-08;134;2;326;2;0.1;0.0
28;2021-01-09;78;0;404;2;0.1;0.0
28;2021-01-10;1;0;405;2;0.1;0.0
28;2021-01-11;204;0;609;2;0.1;0.0
28;2021-01-12;265;2;874;4;0.2;0.0
28;2021-01-13;398;3;1272;7;0.3;0.0
28;2021-01-14;449;5;1721;12;0.4;0.0
28;2021-01-15;374;3;2095;15;0.5;0.0
28;2021-01-16;206;2;2301;17;0.5;0.0
28;2021-01-17;21;0;2322;17;0.5;0.0
28;2021-01-18;372;2;2694;19;0.6;0.0
28;2021-01-19;503;3;3197;22;0.7;0.0
28;2021-01-20;636;1;3833;23;0.9;0.0
28;2021-01-21;797;3;4630;26;1.1;0.0
28;2021-01-22;477;1;5107;27;1.2;0.0
28;2021-01-23;353;0;5460;27;1.3;0.0
28;2021-01-24;1;0;5461;27;1.3;0.0
28;2021-01-25;455;3;5916;30;1.4;0.0
28;2021-01-26;718;4;6634;34;1.5;0.0
28;2021-01-27;1212;48;7846;82;1.8;0.0
28;2021-01-28;1585;91;9431;173;2.2;0.0
28;2021-01-29;896;99;10327;272;2.4;0.1
28;2021-01-30;248;54;10575;326;2.5;0.1
28;2021-01-31;3;22;10578;348;2.5;0.1
28;2021-02-01;324;124;10902;472;2.5;0.1
28;2021-02-02;368;240;11270;712;2.6;0.2
28;2021-02-03;473;259;11743;971;2.7;0.2
28;2021-02-04;525;279;12268;1250;2.9;0.3
28;2021-02-05;436;226;12704;1476;3.0;0.3
28;2021-02-06;199;128;12903;1604;3.0;0.4
28;2021-02-07;0;0;12903;1604;3.0;0.4
28;2021-02-08;331;250;13234;1854;3.1;0.4
28;2021-02-09;281;347;13515;2201;3.1;0.5
28;2021-02-10;440;402;13955;2603;3.2;0.6
28;2021-02-11;562;489;14517;3092;3.4;0.7
28;2021-02-12;453;434;14970;3526;3.5;0.8
28;2021-02-13;181;193;15151;3719;3.5;0.9
28;2021-02-14;0;2;15151;3721;3.5;0.9
28;2021-02-15;280;475;15431;4196;3.6;1.0
28;2021-02-16;395;711;15826;4907;3.7;1.1
28;2021-02-17;581;1148;16407;6055;3.8;1.4
28;2021-02-18;665;1399;17072;7454;4.0;1.7
28;2021-02-19;546;764;17618;8218;4.1;1.9
28;2021-02-20;114;145;17732;8363;4.1;1.9
28;2021-02-21;7;33;17739;8396;4.1;2.0
28;2021-02-22;224;520;17963;8916;4.2;2.1
28;2021-02-23;203;379;18166;9295;4.2;2.2
28;2021-02-24;244;479;18410;9774;4.3;2.3
28;2021-02-25;574;452;18984;10226;4.4;2.4
28;2021-02-26;764;377;19748;10603;4.6;2.5
28;2021-02-27;265;86;20013;10689;4.7;2.5
28;2021-02-28;23;17;20036;10706;4.7;2.5
28;2021-03-01;291;215;20327;10921;4.7;2.5
28;2021-03-02;397;277;20724;11198;4.8;2.6
28;2021-03-03;369;401;21093;11599;4.9;2.7
28;2021-03-04;718;487;21811;12086;5.1;2.8
28;2021-03-05;1319;416;23130;12502;5.4;2.9
28;2021-03-06;1998;82;25128;12584;5.9;2.9
28;2021-03-07;974;25;26102;12609;6.1;2.9
28;2021-03-08;398;309;26500;12918;6.2;3.0
28;2021-03-09;980;356;27480;13274;6.4;3.1
28;2021-03-10;1357;538;28837;13812;6.7;3.2
28;2021-03-11;1533;696;30370;14508;7.1;3.4
28;2021-03-12;2257;635;32627;15143;7.6;3.5
28;2021-03-13;1235;131;33862;15274;7.9;3.6
28;2021-03-14;518;17;34380;15291;8.0;3.6
28;2021-03-15;756;230;35136;15521;8.2;3.6
28;2021-03-16;714;221;35850;15742;8.3;3.7
28;2021-03-17;747;288;36597;16030;8.5;3.7
28;2021-03-18;1199;278;37796;16308;8.8;3.8
28;2021-03-19;1558;329;39354;16637;9.2;3.9
28;2021-03-20;639;19;39993;16656;9.3;3.9
28;2021-03-21;28;7;40021;16663;9.3;3.9
28;2021-03-22;767;323;40788;16986;9.5;4.0
28;2021-03-23;1025;193;41813;17179;9.7;4.0
28;2021-03-24;1311;276;43124;17455;10.0;4.1
28;2021-03-25;1797;285;44921;17740;10.5;4.1
28;2021-03-26;2083;339;47004;18079;10.9;4.2
28;2021-03-27;402;38;47406;18117;11.0;4.2
28;2021-03-28;12;0;47418;18117;11.0;4.2
28;2021-03-29;1140;350;48558;18467;11.3;4.3
28;2021-03-30;1712;245;50270;18712;11.7;4.4
28;2021-03-31;2017;476;52287;19188;12.2;4.5
28;2021-04-01;1794;586;54081;19774;12.6;4.6
28;2021-04-02;1584;1318;55665;21092;13.0;4.9
28;2021-04-03;607;1072;56272;22164;13.1;5.2
28;2021-04-04;33;302;56305;22466;13.1;5.2
28;2021-04-05;40;3;56345;22469;13.1;5.2
28;2021-04-06;1225;461;57570;22930;13.4;5.3
28;2021-04-07;1891;1001;59461;23931;13.8;5.6
28;2021-04-08;2076;1069;61537;25000;14.3;5.8
28;2021-04-09;3235;914;64772;25914;15.1;6.0
28;2021-04-10;1582;194;66354;26108;15.5;6.1
28;2021-04-11;140;451;66494;26559;15.5;6.2
28;2021-04-12;1673;555;68167;27114;15.9;6.3
28;2021-04-13;1875;667;70042;27781;16.3;6.5
28;2021-04-14;2772;899;72814;28680;17.0;6.7
28;2021-04-15;2554;1132;75368;29812;17.6;6.9
28;2021-04-16;2552;800;77920;30612;18.1;7.1
28;2021-04-17;2308;129;80228;30741;18.7;7.2
28;2021-04-18;45;8;80273;30749;18.7;7.2
28;2021-04-19;1578;646;81851;31395;19.1;7.3
28;2021-04-20;1841;587;83692;31982;19.5;7.4
28;2021-04-21;2678;958;86370;32940;20.1;7.7
28;2021-04-22;1782;1207;88152;34147;20.5;8.0
28;2021-04-23;2323;1101;90475;35248;21.1;8.2
28;2021-04-24;3654;129;94129;35377;21.9;8.2
28;2021-04-25;1011;31;95140;35408;22.2;8.2
28;2021-04-26;1331;923;96471;36331;22.5;8.5
28;2021-04-27;1435;1273;97906;37604;22.8;8.8
28;2021-04-28;2369;1819;100275;39423;23.4;9.2
28;2021-04-29;2129;1487;102404;40910;23.8;9.5
28;2021-04-30;2973;1217;105377;42127;24.5;9.8
28;2021-05-01;127;120;105504;42247;24.6;9.8
28;2021-05-02;2;65;105506;42312;24.6;9.9
28;2021-05-03;1046;1016;106552;43328;24.8;10.1
28;2021-05-04;1360;1668;107912;44996;25.1;10.5
28;2021-05-05;2830;1646;110742;46642;25.8;10.9
28;2021-05-06;2456;1473;113198;48115;26.4;11.2
28;2021-05-07;2310;1933;115508;50048;26.9;11.7
28;2021-05-08;1077;116;116585;50164;27.1;11.7
28;2021-05-09;105;610;116690;50774;27.2;11.8
28;2021-05-10;1306;1891;117996;52665;27.5;12.3
28;2021-05-11;2028;2343;120024;55008;27.9;12.8
28;2021-05-12;2620;3229;122644;58237;28.6;13.6
28;2021-05-13;289;452;122933;58689;28.6;13.7
28;2021-05-14;1898;1617;124831;60306;29.1;14.0
28;2021-05-15;1436;1674;126267;61980;29.4;14.4
28;2021-05-16;1987;128;128254;62108;29.9;14.5
28;2021-05-17;2875;1495;131129;63603;30.5;14.8
28;2021-05-18;3379;1377;134508;64980;31.3;15.1
28;2021-05-19;5074;1281;139582;66261;32.5;15.4
28;2021-05-20;4151;1229;143733;67490;33.5;15.7
28;2021-05-21;3466;1578;147199;69068;34.3;16.1
28;2021-05-22;724;1160;147923;70228;34.4;16.4
28;2021-05-23;1957;137;149880;70365;34.9;16.4
28;2021-05-24;1428;394;151308;70759;35.2;16.5
28;2021-05-25;1878;1408;153186;72167;35.7;16.8
28;2021-05-26;2765;1343;155951;73510;36.3;17.1
28;2021-05-27;2755;1229;158706;74739;37.0;17.4
28;2021-05-28;3082;1733;161788;76472;37.7;17.8
28;2021-05-29;1868;873;163656;77345;38.1;18.0
28;2021-05-30;16;47;163672;77392;38.1;18.0
28;2021-05-31;2014;937;165686;78329;38.6;18.2
28;2021-06-01;2133;1663;167819;79992;39.1;18.6
28;2021-06-02;2071;2455;169890;82447;39.6;19.2
28;2021-06-03;2497;1564;172387;84011;40.1;19.6
28;2021-06-04;2610;2359;174997;86370;40.8;20.1
28;2021-06-05;1910;2527;176907;88897;41.2;20.7
28;2021-06-06;1060;1042;177967;89939;41.4;20.9
28;2021-06-07;3573;1572;181540;91511;42.3;21.3
28;2021-06-08;3194;1516;184734;93027;43.0;21.7
28;2021-06-09;3675;2129;188409;95156;43.9;22.2
28;2021-06-10;3140;1263;191549;96419;44.6;22.5
28;2021-06-11;3795;2131;195344;98550;45.5;22.9
28;2021-06-12;1301;561;196645;99111;45.8;23.1
28;2021-06-13;385;107;197030;99218;45.9;23.1
28;2021-06-14;2208;1996;199238;101214;46.4;23.6
28;2021-06-15;2091;2222;201329;103436;46.9;24.1
28;2021-06-16;2509;3981;203838;107417;47.5;25.0
28;2021-06-17;1925;3133;205763;110550;47.9;25.7
28;2021-06-18;2470;3784;208233;114334;48.5;26.6
28;2021-06-19;776;1611;209009;115945;48.7;27.0
28;2021-06-20;23;24;209032;115969;48.7;27.0
28;2021-06-21;1683;1988;210715;117957;49.1;27.5
28;2021-06-22;1368;2107;212083;120064;49.4;28.0
28;2021-06-23;1779;3165;213862;123229;49.8;28.7
28;2021-06-24;733;930;214595;124159;50.0;28.9
28;2021-06-25;1891;3022;216486;127181;50.4;29.6
28;2021-06-26;310;2116;216796;129297;50.5;30.1
28;2021-06-27;588;1284;217384;130581;50.6;30.4
28;2021-06-28;1227;3655;218611;134236;50.9;31.3
28;2021-06-29;1342;3798;219953;138034;51.2;32.1
28;2021-06-30;1492;4252;221445;142286;51.6;33.1
28;2021-07-01;1277;3462;222722;145748;51.9;33.9
28;2021-07-02;1311;4653;224033;150401;52.2;35.0
28;2021-07-03;1131;2369;225164;152770;52.4;35.6
28;2021-07-04;146;1325;225310;154095;52.5;35.9
28;2021-07-05;1361;2510;226671;156605;52.8;36.5
28;2021-07-06;1505;2868;228176;159473;53.1;37.1
28;2021-07-07;1637;4142;229813;163615;53.5;38.1
28;2021-07-08;1467;3236;231280;166851;53.9;38.9
28;2021-07-09;1391;4525;232671;171376;54.2;39.9
28;2021-07-10;526;2209;233197;173585;54.3;40.4
28;2021-07-11;1;1;233198;173586;54.3;40.4
28;2021-07-12;1526;3935;234724;177521;54.7;41.3
28;2021-07-13;2260;4138;236984;181659;55.2;42.3
28;2021-07-14;1330;1394;238314;183053;55.5;42.6
28;2021-07-15;2976;3975;241290;187028;56.2;43.6
28;2021-07-16;2438;4763;243728;191791;56.8;44.7
28;2021-07-17;1264;2425;244992;194216;57.1;45.2
28;2021-07-18;371;942;245363;195158;57.1;45.4
28;2021-07-19;1794;4338;247157;199496;57.6;46.5
28;2021-07-20;2465;4085;249622;203581;58.1;47.4
28;2021-07-21;2954;4280;252576;207861;58.8;48.4
28;2021-07-22;3633;3420;256209;211281;59.7;49.2
28;2021-07-23;2941;3994;259150;215275;60.3;50.1
28;2021-07-24;1692;1467;260842;216742;60.7;50.5
28;2021-07-25;68;60;260910;216802;60.8;50.5
28;2021-07-26;2921;3371;263831;220173;61.4;51.3
28;2021-07-27;3870;2606;267701;222779;62.3;51.9
28;2021-07-28;3937;2719;271638;225498;63.3;52.5
28;2021-07-29;4451;2075;276089;227573;64.3;53.0
28;2021-07-30;3782;2829;279871;230402;65.2;53.7
28;2021-07-31;761;824;280632;231226;65.4;53.8
28;2021-08-01;377;63;281009;231289;65.4;53.9
28;2021-08-02;1783;1514;282792;232803;65.9;54.2
28;2021-08-03;2676;2156;285468;234959;66.5;54.7
28;2021-08-04;1919;2286;287387;237245;66.9;55.2
28;2021-08-05;1629;1716;289016;238961;67.3;55.6
29;2020-12-27;0;0;0;0;0.0;0.0
29;2020-12-28;0;0;0;0;0.0;0.0
29;2020-12-29;0;0;0;0;0.0;0.0
29;2020-12-30;0;0;0;0;0.0;0.0
29;2020-12-31;0;0;0;0;0.0;0.0
29;2021-01-01;1;0;1;0;0.0;0.0
29;2021-01-02;0;0;1;0;0.0;0.0
29;2021-01-03;1;0;2;0;0.0;0.0
29;2021-01-04;30;0;32;0;0.0;0.0
29;2021-01-05;31;0;63;0;0.0;0.0
29;2021-01-06;43;0;106;0;0.0;0.0
29;2021-01-07;136;0;242;0;0.0;0.0
29;2021-01-08;408;0;650;0;0.1;0.0
29;2021-01-09;1;0;651;0;0.1;0.0
29;2021-01-10;2;0;653;0;0.1;0.0
29;2021-01-11;666;0;1319;0;0.1;0.0
29;2021-01-12;1120;0;2439;0;0.3;0.0
29;2021-01-13;1097;2;3536;2;0.4;0.0
29;2021-01-14;894;4;4430;6;0.5;0.0
29;2021-01-15;1218;9;5648;15;0.6;0.0
29;2021-01-16;168;1;5816;16;0.6;0.0
29;2021-01-17;112;1;5928;17;0.7;0.0
29;2021-01-18;838;3;6766;20;0.7;0.0
29;2021-01-19;1285;0;8051;20;0.9;0.0
29;2021-01-20;2392;2;10443;22;1.2;0.0
29;2021-01-21;5560;1;16003;23;1.8;0.0
29;2021-01-22;3750;4;19753;27;2.2;0.0
29;2021-01-23;537;0;20290;27;2.2;0.0
29;2021-01-24;200;1;20490;28;2.3;0.0
29;2021-01-25;573;7;21063;35;2.3;0.0
29;2021-01-26;950;34;22013;69;2.4;0.0
29;2021-01-27;1285;54;23298;123;2.6;0.0
29;2021-01-28;801;136;24099;259;2.7;0.0
29;2021-01-29;777;205;24876;464;2.7;0.1
29;2021-01-30;281;4;25157;468;2.8;0.1
29;2021-01-31;80;5;25237;473;2.8;0.1
29;2021-02-01;429;450;25666;923;2.8;0.1
29;2021-02-02;876;825;26542;1748;2.9;0.2
29;2021-02-03;811;894;27353;2642;3.0;0.3
29;2021-02-04;865;642;28218;3284;3.1;0.4
29;2021-02-05;675;585;28893;3869;3.2;0.4
29;2021-02-06;243;102;29136;3971;3.2;0.4
29;2021-02-07;78;105;29214;4076;3.2;0.4
29;2021-02-08;383;448;29597;4524;3.3;0.5
29;2021-02-09;863;853;30460;5377;3.4;0.6
29;2021-02-10;1147;1019;31607;6396;3.5;0.7
29;2021-02-11;1790;4164;33397;10560;3.7;1.2
29;2021-02-12;2318;2504;35715;13064;3.9;1.4
29;2021-02-13;638;414;36353;13478;4.0;1.5
29;2021-02-14;12;229;36365;13707;4.0;1.5
29;2021-02-15;265;948;36630;14655;4.0;1.6
29;2021-02-16;884;1061;37514;15716;4.1;1.7
29;2021-02-17;801;860;38315;16576;4.2;1.8
29;2021-02-18;1529;849;39844;17425;4.4;1.9
29;2021-02-19;1412;1005;41256;18430;4.6;2.0
29;2021-02-20;204;367;41460;18797;4.6;2.1
29;2021-02-21;160;169;41620;18966;4.6;2.1
29;2021-02-22;773;564;42393;19530;4.7;2.2
29;2021-02-23;1270;910;43663;20440;4.8;2.3
29;2021-02-24;1468;838;45131;21278;5.0;2.3
29;2021-02-25;2507;907;47638;22185;5.3;2.4
29;2021-02-26;2672;714;50310;22899;5.5;2.5
29;2021-02-27;1284;280;51594;23179;5.7;2.6
29;2021-02-28;199;72;51793;23251;5.7;2.6
29;2021-03-01;944;484;52737;23735;5.8;2.6
29;2021-03-02;1811;800;54548;24535;6.0;2.7
29;2021-03-03;2089;1018;56637;25553;6.2;2.8
29;2021-03-04;2840;1553;59477;27106;6.6;3.0
29;2021-03-05;3538;1677;63015;28783;7.0;3.2
29;2021-03-06;2000;437;65015;29220;7.2;3.2
29;2021-03-07;412;83;65427;29303;7.2;3.2
29;2021-03-08;1274;592;66701;29895;7.4;3.3
29;2021-03-09;2605;978;69306;30873;7.6;3.4
29;2021-03-10;2426;872;71732;31745;7.9;3.5
29;2021-03-11;4516;1001;76248;32746;8.4;3.6
29;2021-03-12;5268;961;81516;33707;9.0;3.7
29;2021-03-13;2820;406;84336;34113;9.3;3.8
29;2021-03-14;365;3;84701;34116;9.3;3.8
29;2021-03-15;2051;270;86752;34386;9.6;3.8
29;2021-03-16;1821;761;88573;35147;9.8;3.9
29;2021-03-17;1859;722;90432;35869;10.0;4.0
29;2021-03-18;1863;1039;92295;36908;10.2;4.1
29;2021-03-19;3261;881;95556;37789;10.5;4.2
29;2021-03-20;1912;222;97468;38011;10.8;4.2
29;2021-03-21;132;11;97600;38022;10.8;4.2
29;2021-03-22;1645;554;99245;38576;10.9;4.3
29;2021-03-23;3442;1032;102687;39608;11.3;4.4
29;2021-03-24;3776;1024;106463;40632;11.7;4.5
29;2021-03-25;4814;1068;111277;41700;12.3;4.6
29;2021-03-26;5419;1162;116696;42862;12.9;4.7
29;2021-03-27;2428;329;119124;43191;13.1;4.8
29;2021-03-28;198;50;119322;43241;13.2;4.8
29;2021-03-29;2040;821;121362;44062;13.4;4.9
29;2021-03-30;3972;1324;125334;45386;13.8;5.0
29;2021-03-31;3933;1148;129267;46534;14.3;5.1
29;2021-04-01;5018;1146;134285;47680;14.8;5.3
29;2021-04-02;4766;1170;139051;48850;15.3;5.4
29;2021-04-03;2500;537;141551;49387;15.6;5.4
29;2021-04-04;146;31;141697;49418;15.6;5.5
29;2021-04-05;972;331;142669;49749;15.7;5.5
29;2021-04-06;3193;1235;145862;50984;16.1;5.6
29;2021-04-07;3651;939;149513;51923;16.5;5.7
29;2021-04-08;5289;2057;154802;53980;17.1;6.0
29;2021-04-09;6749;1564;161551;55544;17.8;6.1
29;2021-04-10;3496;702;165047;56246;18.2;6.2
29;2021-04-11;120;80;165167;56326;18.2;6.2
29;2021-04-12;3850;1484;169017;57810;18.6;6.4
29;2021-04-13;5860;1749;174877;59559;19.3;6.6
29;2021-04-14;4757;1742;179634;61301;19.8;6.8
29;2021-04-15;7162;1729;186796;63030;20.6;7.0
29;2021-04-16;6704;1350;193500;64380;21.3;7.1
29;2021-04-17;3826;968;197326;65348;21.8;7.2
29;2021-04-18;489;40;197815;65388;21.8;7.2
29;2021-04-19;3878;1462;201693;66850;22.2;7.4
29;2021-04-20;4397;2132;206090;68982;22.7;7.6
29;2021-04-21;4371;2192;210461;71174;23.2;7.9
29;2021-04-22;6644;2854;217105;74028;23.9;8.2
29;2021-04-23;6042;2192;223147;76220;24.6;8.4
29;2021-04-24;4005;1315;227152;77535;25.1;8.6
29;2021-04-25;433;169;227585;77704;25.1;8.6
29;2021-04-26;5261;1875;232846;79579;25.7;8.8
29;2021-04-27;5334;3194;238180;82773;26.3;9.1
29;2021-04-28;5354;2893;243534;85666;26.9;9.4
29;2021-04-29;6586;3344;250120;89010;27.6;9.8
29;2021-04-30;6260;3910;256380;92920;28.3;10.2
29;2021-05-01;1983;978;258363;93898;28.5;10.4
29;2021-05-02;1249;195;259612;94093;28.6;10.4
29;2021-05-03;4537;2287;264149;96380;29.1;10.6
29;2021-05-04;4112;3737;268261;100117;29.6;11.0
29;2021-05-05;4515;3406;272776;103523;30.1;11.4
29;2021-05-06;6237;3713;279013;107236;30.8;11.8
29;2021-05-07;5983;4617;284996;111853;31.4;12.3
29;2021-05-08;2092;566;287088;112419;31.7;12.4
29;2021-05-09;1724;137;288812;112556;31.9;12.4
29;2021-05-10;4762;3768;293574;116324;32.4;12.8
29;2021-05-11;4714;4999;298288;121323;32.9;13.4
29;2021-05-12;5025;4380;303313;125703;33.5;13.9
29;2021-05-13;3439;1501;306752;127204;33.8;14.0
29;2021-05-14;5648;4003;312400;131207;34.5;14.5
29;2021-05-15;4044;2316;316444;133523;34.9;14.7
29;2021-05-16;1587;293;318031;133816;35.1;14.8
29;2021-05-17;5562;3132;323593;136948;35.7;15.1
29;2021-05-18;5734;3095;329327;140043;36.3;15.4
29;2021-05-19;6204;2967;335531;143010;37.0;15.8
29;2021-05-20;7174;4564;342705;147574;37.8;16.3
29;2021-05-21;7216;3812;349921;151386;38.6;16.7
29;2021-05-22;5335;2130;355256;153516;39.2;16.9
29;2021-05-23;1630;65;356886;153581;39.4;16.9
29;2021-05-24;3486;534;360372;154115;39.8;17.0
29;2021-05-25;5830;3037;366202;157152;40.4;17.3
29;2021-05-26;5893;2996;372095;160148;41.0;17.7
29;2021-05-27;6824;3986;378919;164134;41.8;18.1
29;2021-05-28;6539;4451;385458;168585;42.5;18.6
29;2021-05-29;4383;2803;389841;171388;43.0;18.9
29;2021-05-30;1115;361;390956;171749;43.1;18.9
29;2021-05-31;6385;3456;397341;175205;43.8;19.3
29;2021-06-01;6604;4351;403945;179556;44.6;19.8
29;2021-06-02;6160;4130;410105;183686;45.2;20.3
29;2021-06-03;7695;4521;417800;188207;46.1;20.8
29;2021-06-04;6813;6164;424613;194371;46.8;21.4
29;2021-06-05;5351;3035;429964;197406;47.4;21.8
29;2021-06-06;1284;538;431248;197944;47.6;21.8
29;2021-06-07;4659;5563;435907;203507;48.1;22.4
29;2021-06-08;7173;5209;443080;208716;48.9;23.0
29;2021-06-09;6409;4752;449489;213468;49.6;23.5
29;2021-06-10;7777;5066;457266;218534;50.4;24.1
29;2021-06-11;8476;5875;465742;224409;51.4;24.8
29;2021-06-12;6569;2810;472311;227219;52.1;25.1
29;2021-06-13;2352;1371;474663;228590;52.4;25.2
29;2021-06-14;4032;6303;478695;234893;52.8;25.9
29;2021-06-15;5472;6168;484167;241061;53.4;26.6
29;2021-06-16;5562;5629;489729;246690;54.0;27.2
29;2021-06-17;6358;6301;496087;252991;54.7;27.9
29;2021-06-18;6113;7488;502200;260479;55.4;28.7
29;2021-06-19;4622;3526;506822;264005;55.9;29.1
29;2021-06-20;891;1454;507713;265459;56.0;29.3
29;2021-06-21;3756;6494;511469;271953;56.4;30.0
29;2021-06-22;4489;6423;515958;278376;56.9;30.7
29;2021-06-23;4668;6129;520626;284505;57.4;31.4
29;2021-06-24;4801;6745;525427;291250;58.0;32.1
29;2021-06-25;3594;7529;529021;298779;58.4;33.0
29;2021-06-26;2122;4094;531143;302873;58.6;33.4
29;2021-06-27;965;1632;532108;304505;58.7;33.6
29;2021-06-28;2832;6867;534940;311372;59.0;34.3
29;2021-06-29;2784;7729;537724;319101;59.3;35.2
29;2021-06-30;3029;7512;540753;326613;59.6;36.0
29;2021-07-01;3754;8421;544507;335034;60.1;37.0
29;2021-07-02;3598;9674;548105;344708;60.5;38.0
29;2021-07-03;2319;6060;550424;350768;60.7;38.7
29;2021-07-04;810;1770;551234;352538;60.8;38.9
29;2021-07-05;1903;7163;553137;359701;61.0;39.7
29;2021-07-06;1527;8016;554664;367717;61.2;40.6
29;2021-07-07;1688;7044;556352;374761;61.4;41.3
29;2021-07-08;2433;8214;558785;382975;61.6;42.2
29;2021-07-09;2558;9088;561343;392063;61.9;43.2
29;2021-07-10;1910;6111;563253;398174;62.1;43.9
29;2021-07-11;443;1065;563696;399239;62.2;44.0
29;2021-07-12;1964;8387;565660;407626;62.4;45.0
29;2021-07-13;2731;8659;568391;416285;62.7;45.9
29;2021-07-14;2066;3364;570457;419649;62.9;46.3
29;2021-07-15;3818;9733;574275;429382;63.3;47.4
29;2021-07-16;4566;9198;578841;438580;63.9;48.4
29;2021-07-17;3212;6113;582053;444693;64.2;49.1
29;2021-07-18;660;1078;582713;445771;64.3;49.2
29;2021-07-19;3123;7558;585836;453329;64.6;50.0
29;2021-07-20;3511;9443;589347;462772;65.0;51.0
29;2021-07-21;3616;7729;592963;470501;65.4;51.9
29;2021-07-22;3375;8540;596338;479041;65.8;52.8
29;2021-07-23;4011;10714;600349;489755;66.2;54.0
29;2021-07-24;2519;5954;602868;495709;66.5;54.7
29;2021-07-25;649;2363;603517;498072;66.6;54.9
29;2021-07-26;3351;7280;606868;505352;66.9;55.7
29;2021-07-27;3683;7111;610551;512463;67.3;56.5
29;2021-07-28;4170;6035;614721;518498;67.8;57.2
29;2021-07-29;5625;6352;620346;524850;68.4;57.9
29;2021-07-30;5368;6519;625714;531369;69.0;58.6
29;2021-07-31;2915;4927;628629;536296;69.3;59.2
29;2021-08-01;649;922;629278;537218;69.4;59.3
29;2021-08-02;4269;5216;633547;542434;69.9;59.8
29;2021-08-03;5465;4400;639012;546834;70.5;60.3
29;2021-08-04;5696;3596;644708;550430;71.1;60.7
29;2021-08-05;6545;4092;651253;554522;71.8;61.2
2A;2020-12-27;0;0;0;0;0.0;0.0
2A;2020-12-28;0;0;0;0;0.0;0.0
2A;2020-12-29;0;0;0;0;0.0;0.0
2A;2020-12-30;0;0;0;0;0.0;0.0
2A;2020-12-31;0;0;0;0;0.0;0.0
2A;2021-01-01;0;0;0;0;0.0;0.0
2A;2021-01-02;1;0;1;0;0.0;0.0
2A;2021-01-03;0;0;1;0;0.0;0.0
2A;2021-01-04;0;0;1;0;0.0;0.0
2A;2021-01-05;0;0;1;0;0.0;0.0
2A;2021-01-06;6;0;7;0;0.0;0.0
2A;2021-01-07;122;1;129;1;0.1;0.0
2A;2021-01-08;113;0;242;1;0.1;0.0
2A;2021-01-09;39;0;281;1;0.2;0.0
2A;2021-01-10;33;0;314;1;0.2;0.0
2A;2021-01-11;76;0;390;1;0.2;0.0
2A;2021-01-12;85;0;475;1;0.3;0.0
2A;2021-01-13;111;0;586;1;0.4;0.0
2A;2021-01-14;192;1;778;2;0.5;0.0
2A;2021-01-15;149;0;927;2;0.6;0.0
2A;2021-01-16;157;1;1084;3;0.7;0.0
2A;2021-01-17;84;1;1168;4;0.7;0.0
2A;2021-01-18;200;2;1368;6;0.8;0.0
2A;2021-01-19;486;0;1854;6;1.1;0.0
2A;2021-01-20;352;0;2206;6;1.4;0.0
2A;2021-01-21;451;1;2657;7;1.6;0.0
2A;2021-01-22;367;0;3024;7;1.9;0.0
2A;2021-01-23;183;0;3207;7;2.0;0.0
2A;2021-01-24;118;1;3325;8;2.0;0.0
2A;2021-01-25;213;0;3538;8;2.2;0.0
2A;2021-01-26;402;6;3940;14;2.4;0.0
2A;2021-01-27;324;5;4264;19;2.6;0.0
2A;2021-01-28;335;80;4599;99;2.8;0.1
2A;2021-01-29;341;64;4940;163;3.0;0.1
2A;2021-01-30;124;40;5064;203;3.1;0.1
2A;2021-01-31;92;12;5156;215;3.2;0.1
2A;2021-02-01;230;53;5386;268;3.3;0.2
2A;2021-02-02;287;118;5673;386;3.5;0.2
2A;2021-02-03;265;74;5938;460;3.7;0.3
2A;2021-02-04;256;121;6194;581;3.8;0.4
2A;2021-02-05;267;107;6461;688;4.0;0.4
2A;2021-02-06;121;59;6582;747;4.1;0.5
2A;2021-02-07;67;57;6649;804;4.1;0.5
2A;2021-02-08;91;209;6740;1013;4.1;0.6
2A;2021-02-09;127;301;6867;1314;4.2;0.8
2A;2021-02-10;158;236;7025;1550;4.3;1.0
2A;2021-02-11;296;369;7321;1919;4.5;1.2
2A;2021-02-12;345;305;7666;2224;4.7;1.4
2A;2021-02-13;224;59;7890;2283;4.9;1.4
2A;2021-02-14;133;77;8023;2360;4.9;1.5
2A;2021-02-15;190;182;8213;2542;5.1;1.6
2A;2021-02-16;380;320;8593;2862;5.3;1.8
2A;2021-02-17;283;166;8876;3028;5.5;1.9
2A;2021-02-18;334;199;9210;3227;5.7;2.0
2A;2021-02-19;146;300;9356;3527;5.8;2.2
2A;2021-02-20;243;138;9599;3665;5.9;2.3
2A;2021-02-21;58;55;9657;3720;5.9;2.3
2A;2021-02-22;77;215;9734;3935;6.0;2.4
2A;2021-02-23;122;290;9856;4225;6.1;2.6
2A;2021-02-24;71;297;9927;4522;6.1;2.8
2A;2021-02-25;105;266;10032;4788;6.2;2.9
2A;2021-02-26;123;273;10155;5061;6.3;3.1
2A;2021-02-27;308;69;10463;5130;6.4;3.2
2A;2021-02-28;69;66;10532;5196;6.5;3.2
2A;2021-03-01;116;152;10648;5348;6.6;3.3
2A;2021-03-02;197;266;10845;5614;6.7;3.5
2A;2021-03-03;238;256;11083;5870;6.8;3.6
2A;2021-03-04;508;228;11591;6098;7.1;3.8
2A;2021-03-05;971;288;12562;6386;7.7;3.9
2A;2021-03-06;1164;75;13726;6461;8.5;4.0
2A;2021-03-07;1020;45;14746;6506;9.1;4.0
2A;2021-03-08;931;88;15677;6594;9.7;4.1
2A;2021-03-09;936;151;16613;6745;10.2;4.2
2A;2021-03-10;629;136;17242;6881;10.6;4.2
2A;2021-03-11;723;281;17965;7162;11.1;4.4
2A;2021-03-12;560;318;18525;7480;11.4;4.6
2A;2021-03-13;612;198;19137;7678;11.8;4.7
2A;2021-03-14;311;126;19448;7804;12.0;4.8
2A;2021-03-15;374;203;19822;8007;12.2;4.9
2A;2021-03-16;497;368;20319;8375;12.5;5.2
2A;2021-03-17;699;273;21018;8648;12.9;5.3
2A;2021-03-18;446;305;21464;8953;13.2;5.5
2A;2021-03-19;487;156;21951;9109;13.5;5.6
2A;2021-03-20;1080;261;23031;9370;14.2;5.8
2A;2021-03-21;696;52;23727;9422;14.6;5.8
2A;2021-03-22;345;67;24072;9489;14.8;5.8
2A;2021-03-23;517;57;24589;9546;15.1;5.9
2A;2021-03-24;862;91;25451;9637;15.7;5.9
2A;2021-03-25;930;139;26381;9776;16.2;6.0
2A;2021-03-26;1076;163;27457;9939;16.9;6.1
2A;2021-03-27;1188;199;28645;10138;17.6;6.2
2A;2021-03-28;241;99;28886;10237;17.8;6.3
2A;2021-03-29;282;138;29168;10375;18.0;6.4
2A;2021-03-30;382;235;29550;10610;18.2;6.5
2A;2021-03-31;446;226;29996;10836;18.5;6.7
2A;2021-04-01;637;452;30633;11288;18.9;6.9
2A;2021-04-02;902;784;31535;12072;19.4;7.4
2A;2021-04-03;646;982;32181;13054;19.8;8.0
2A;2021-04-04;578;784;32759;13838;20.2;8.5
2A;2021-04-05;524;698;33283;14536;20.5;8.9
2A;2021-04-06;550;557;33833;15093;20.8;9.3
2A;2021-04-07;786;424;34619;15517;21.3;9.6
2A;2021-04-08;1049;355;35668;15872;22.0;9.8
2A;2021-04-09;934;394;36602;16266;22.5;10.0
2A;2021-04-10;1056;380;37658;16646;23.2;10.2
2A;2021-04-11;362;256;38020;16902;23.4;10.4
2A;2021-04-12;668;342;38688;17244;23.8;10.6
2A;2021-04-13;328;380;39016;17624;24.0;10.9
2A;2021-04-14;1046;587;40062;18211;24.7;11.2
2A;2021-04-15;1042;524;41104;18735;25.3;11.5
2A;2021-04-16;871;395;41975;19130;25.8;11.8
2A;2021-04-17;1366;938;43341;20068;26.7;12.4
2A;2021-04-18;982;944;44323;21012;27.3;12.9
2A;2021-04-19;269;343;44592;21355;27.5;13.1
2A;2021-04-20;353;344;44945;21699;27.7;13.4
2A;2021-04-21;730;733;45675;22432;28.1;13.8
2A;2021-04-22;895;649;46570;23081;28.7;14.2
2A;2021-04-23;987;776;47557;23857;29.3;14.7
2A;2021-04-24;1748;978;49305;24835;30.4;15.3
2A;2021-04-25;977;305;50282;25140;31.0;15.5
2A;2021-04-26;307;227;50589;25367;31.1;15.6
2A;2021-04-27;344;349;50933;25716;31.4;15.8
2A;2021-04-28;1669;423;52602;26139;32.4;16.1
2A;2021-04-29;1054;359;53656;26498;33.0;16.3
2A;2021-04-30;1130;1059;54786;27557;33.7;17.0
2A;2021-05-01;970;575;55756;28132;34.3;17.3
2A;2021-05-02;675;706;56431;28838;34.7;17.8
2A;2021-05-03;582;576;57013;29414;35.1;18.1
2A;2021-05-04;751;535;57764;29949;35.6;18.4
2A;2021-05-05;1008;983;58772;30932;36.2;19.0
2A;2021-05-06;905;912;59677;31844;36.7;19.6
2A;2021-05-07;1155;835;60832;32679;37.5;20.1
2A;2021-05-08;422;500;61254;33179;37.7;20.4
2A;2021-05-09;783;638;62037;33817;38.2;20.8
2A;2021-05-10;453;740;62490;34557;38.5;21.3
2A;2021-05-11;651;415;63141;34972;38.9;21.5
2A;2021-05-12;919;488;64060;35460;39.4;21.8
2A;2021-05-13;919;138;64979;35598;40.0;21.9
2A;2021-05-14;798;682;65777;36280;40.5;22.3
2A;2021-05-15;781;648;66558;36928;41.0;22.7
2A;2021-05-16;737;499;67295;37427;41.4;23.0
2A;2021-05-17;583;561;67878;37988;41.8;23.4
2A;2021-05-18;615;475;68493;38463;42.2;23.7
2A;2021-05-19;788;481;69281;38944;42.7;24.0
2A;2021-05-20;692;540;69973;39484;43.1;24.3
2A;2021-05-21;535;481;70508;39965;43.4;24.6
2A;2021-05-22;442;309;70950;40274;43.7;24.8
2A;2021-05-23;533;284;71483;40558;44.0;25.0
2A;2021-05-24;125;33;71608;40591;44.1;25.0
2A;2021-05-25;415;503;72023;41094;44.3;25.3
2A;2021-05-26;426;1166;72449;42260;44.6;26.0
2A;2021-05-27;435;1111;72884;43371;44.9;26.7
2A;2021-05-28;297;915;73181;44286;45.1;27.3
2A;2021-05-29;336;900;73517;45186;45.3;27.8
2A;2021-05-30;182;506;73699;45692;45.4;28.1
2A;2021-05-31;189;413;73888;46105;45.5;28.4
2A;2021-06-01;338;729;74226;46834;45.7;28.8
2A;2021-06-02;283;939;74509;47773;45.9;29.4
2A;2021-06-03;304;848;74813;48621;46.1;29.9
2A;2021-06-04;272;1093;75085;49714;46.2;30.6
2A;2021-06-05;319;1442;75404;51156;46.4;31.5
2A;2021-06-06;173;909;75577;52065;46.5;32.1
2A;2021-06-07;170;661;75747;52726;46.6;32.5
2A;2021-06-08;321;705;76068;53431;46.8;32.9
2A;2021-06-09;297;1318;76365;54749;47.0;33.7
2A;2021-06-10;329;856;76694;55605;47.2;34.2
2A;2021-06-11;279;1021;76973;56626;47.4;34.9
2A;2021-06-12;228;663;77201;57289;47.5;35.3
2A;2021-06-13;188;797;77389;58086;47.6;35.8
2A;2021-06-14;251;921;77640;59007;47.8;36.3
2A;2021-06-15;217;507;77857;59514;47.9;36.6
2A;2021-06-16;211;776;78068;60290;48.1;37.1
2A;2021-06-17;233;592;78301;60882;48.2;37.5
2A;2021-06-18;244;914;78545;61796;48.4;38.0
2A;2021-06-19;207;690;78752;62486;48.5;38.5
2A;2021-06-20;149;692;78901;63178;48.6;38.9
2A;2021-06-21;179;791;79080;63969;48.7;39.4
2A;2021-06-22;235;842;79315;64811;48.8;39.9
2A;2021-06-23;216;567;79531;65378;49.0;40.3
2A;2021-06-24;148;371;79679;65749;49.1;40.5
2A;2021-06-25;167;473;79846;66222;49.2;40.8
2A;2021-06-26;202;872;80048;67094;49.3;41.3
2A;2021-06-27;173;794;80221;67888;49.4;41.8
2A;2021-06-28;194;704;80415;68592;49.5;42.2
2A;2021-06-29;213;689;80628;69281;49.6;42.7
2A;2021-06-30;241;493;80869;69774;49.8;43.0
2A;2021-07-01;208;485;81077;70259;49.9;43.3
2A;2021-07-02;179;370;81256;70629;50.0;43.5
2A;2021-07-03;211;618;81467;71247;50.2;43.9
2A;2021-07-04;176;664;81643;71911;50.3;44.3
2A;2021-07-05;162;235;81805;72146;50.4;44.4
2A;2021-07-06;248;389;82053;72535;50.5;44.7
2A;2021-07-07;428;611;82481;73146;50.8;45.0
2A;2021-07-08;587;703;83068;73849;51.1;45.5
2A;2021-07-09;374;424;83442;74273;51.4;45.7
2A;2021-07-10;281;345;83723;74618;51.5;45.9
2A;2021-07-11;91;163;83814;74781;51.6;46.0
2A;2021-07-12;308;348;84122;75129;51.8;46.3
2A;2021-07-13;1177;532;85299;75661;52.5;46.6
2A;2021-07-14;1617;328;86916;75989;53.5;46.8
2A;2021-07-15;1424;830;88340;76819;54.4;47.3
2A;2021-07-16;1157;464;89497;77283;55.1;47.6
2A;2021-07-17;1094;336;90591;77619;55.8;47.8
2A;2021-07-18;632;133;91223;77752;56.2;47.9
2A;2021-07-19;911;430;92134;78182;56.7;48.1
2A;2021-07-20;1267;468;93401;78650;57.5;48.4
2A;2021-07-21;1420;707;94821;79357;58.4;48.9
2A;2021-07-22;1375;759;96196;80116;59.2;49.3
2A;2021-07-23;1424;455;97620;80571;60.1;49.6
2A;2021-07-24;872;287;98492;80858;60.6;49.8
2A;2021-07-25;446;68;98938;80926;60.9;49.8
2A;2021-07-26;1167;495;100105;81421;61.6;50.1
2A;2021-07-27;1253;504;101358;81925;62.4;50.4
2A;2021-07-28;1195;582;102553;82507;63.1;50.8
2A;2021-07-29;1207;649;103760;83156;63.9;51.2
2A;2021-07-30;924;601;104684;83757;64.5;51.6
2A;2021-07-31;526;335;105210;84092;64.8;51.8
2A;2021-08-01;545;117;105755;84209;65.1;51.8
2A;2021-08-02;440;485;106195;84694;65.4;52.1
2A;2021-08-03;793;879;106988;85573;65.9;52.7
2A;2021-08-04;718;1154;107706;86727;66.3;53.4
2A;2021-08-05;852;1340;108558;88067;66.8;54.2
2B;2020-12-27;0;0;0;0;0.0;0.0
2B;2020-12-28;0;0;0;0;0.0;0.0
2B;2020-12-29;0;0;0;0;0.0;0.0
2B;2020-12-30;0;0;0;0;0.0;0.0
2B;2020-12-31;0;0;0;0;0.0;0.0
2B;2021-01-01;0;0;0;0;0.0;0.0
2B;2021-01-02;0;0;0;0;0.0;0.0
2B;2021-01-03;0;0;0;0;0.0;0.0
2B;2021-01-04;2;0;2;0;0.0;0.0
2B;2021-01-05;0;0;2;0;0.0;0.0
2B;2021-01-06;48;1;50;1;0.0;0.0
2B;2021-01-07;210;0;260;1;0.1;0.0
2B;2021-01-08;196;0;456;1;0.3;0.0
2B;2021-01-09;39;0;495;1;0.3;0.0
2B;2021-01-10;1;0;496;1;0.3;0.0
2B;2021-01-11;75;0;571;1;0.3;0.0
2B;2021-01-12;128;1;699;2;0.4;0.0
2B;2021-01-13;93;0;792;2;0.4;0.0
2B;2021-01-14;72;0;864;2;0.5;0.0
2B;2021-01-15;258;0;1122;2;0.6;0.0
2B;2021-01-16;43;0;1165;2;0.6;0.0
2B;2021-01-17;8;0;1173;2;0.6;0.0
2B;2021-01-18;271;0;1444;2;0.8;0.0
2B;2021-01-19;499;0;1943;2;1.1;0.0
2B;2021-01-20;461;2;2404;4;1.3;0.0
2B;2021-01-21;357;0;2761;4;1.5;0.0
2B;2021-01-22;370;0;3131;4;1.7;0.0
2B;2021-01-23;60;0;3191;4;1.8;0.0
2B;2021-01-24;29;0;3220;4;1.8;0.0
2B;2021-01-25;210;2;3430;6;1.9;0.0
2B;2021-01-26;388;1;3818;7;2.1;0.0
2B;2021-01-27;342;48;4160;55;2.3;0.0
2B;2021-01-28;365;148;4525;203;2.5;0.1
2B;2021-01-29;288;163;4813;366;2.6;0.2
2B;2021-01-30;80;33;4893;399;2.7;0.2
2B;2021-01-31;60;0;4953;399;2.7;0.2
2B;2021-02-01;231;93;5184;492;2.8;0.3
2B;2021-02-02;357;78;5541;570;3.0;0.3
2B;2021-02-03;519;92;6060;662;3.3;0.4
2B;2021-02-04;458;175;6518;837;3.6;0.5
2B;2021-02-05;393;95;6911;932;3.8;0.5
2B;2021-02-06;87;14;6998;946;3.8;0.5
2B;2021-02-07;59;0;7057;946;3.9;0.5
2B;2021-02-08;230;156;7287;1102;4.0;0.6
2B;2021-02-09;586;314;7873;1416;4.3;0.8
2B;2021-02-10;485;195;8358;1611;4.6;0.9
2B;2021-02-11;382;128;8740;1739;4.8;1.0
2B;2021-02-12;299;125;9039;1864;5.0;1.0
2B;2021-02-13;77;13;9116;1877;5.0;1.0
2B;2021-02-14;62;1;9178;1878;5.0;1.0
2B;2021-02-15;190;128;9368;2006;5.1;1.1
2B;2021-02-16;253;285;9621;2291;5.3;1.3
2B;2021-02-17;312;317;9933;2608;5.4;1.4
2B;2021-02-18;215;347;10148;2955;5.6;1.6
2B;2021-02-19;164;308;10312;3263;5.7;1.8
2B;2021-02-20;32;63;10344;3326;5.7;1.8
2B;2021-02-21;27;29;10371;3355;5.7;1.8
2B;2021-02-22;133;190;10504;3545;5.8;1.9
2B;2021-02-23;230;359;10734;3904;5.9;2.1
2B;2021-02-24;228;312;10962;4216;6.0;2.3
2B;2021-02-25;245;341;11207;4557;6.1;2.5
2B;2021-02-26;299;283;11506;4840;6.3;2.7
2B;2021-02-27;60;84;11566;4924;6.3;2.7
2B;2021-02-28;1;57;11567;4981;6.3;2.7
2B;2021-03-01;246;261;11813;5242;6.5;2.9
2B;2021-03-02;351;390;12164;5632;6.7;3.1
2B;2021-03-03;297;437;12461;6069;6.8;3.3
2B;2021-03-04;447;409;12908;6478;7.1;3.6
2B;2021-03-05;618;386;13526;6864;7.4;3.8
2B;2021-03-06;682;98;14208;6962;7.8;3.8
2B;2021-03-07;361;59;14569;7021;8.0;3.9
2B;2021-03-08;301;239;14870;7260;8.2;4.0
2B;2021-03-09;383;505;15253;7765;8.4;4.3
2B;2021-03-10;630;447;15883;8212;8.7;4.5
2B;2021-03-11;584;355;16467;8567;9.0;4.7
2B;2021-03-12;965;226;17432;8793;9.6;4.8
2B;2021-03-13;510;110;17942;8903;9.8;4.9
2B;2021-03-14;226;61;18168;8964;10.0;4.9
2B;2021-03-15;514;200;18682;9164;10.3;5.0
2B;2021-03-16;570;276;19252;9440;10.6;5.2
2B;2021-03-17;529;264;19781;9704;10.9;5.3
2B;2021-03-18;550;228;20331;9932;11.2;5.4
2B;2021-03-19;804;194;21135;10126;11.6;5.6
2B;2021-03-20;655;36;21790;10162;12.0;5.6
2B;2021-03-21;429;35;22219;10197;12.2;5.6
2B;2021-03-22;546;125;22765;10322;12.5;5.7
2B;2021-03-23;788;264;23553;10586;12.9;5.8
2B;2021-03-24;831;218;24384;10804;13.4;5.9
2B;2021-03-25;824;165;25208;10969;13.8;6.0
2B;2021-03-26;958;192;26166;11161;14.4;6.1
2B;2021-03-27;1089;36;27255;11197;15.0;6.1
2B;2021-03-28;830;123;28085;11320;15.4;6.2
2B;2021-03-29;745;180;28830;11500;15.8;6.3
2B;2021-03-30;970;324;29800;11824;16.4;6.5
2B;2021-03-31;981;266;30781;12090;16.9;6.6
2B;2021-04-01;1002;231;31783;12321;17.4;6.8
2B;2021-04-02;965;414;32748;12735;18.0;7.0
2B;2021-04-03;1246;151;33994;12886;18.7;7.1
2B;2021-04-04;197;60;34191;12946;18.8;7.1
2B;2021-04-05;108;113;34299;13059;18.8;7.2
2B;2021-04-06;1033;361;35332;13420;19.4;7.4
2B;2021-04-07;1230;430;36562;13850;20.1;7.6
2B;2021-04-08;1128;409;37690;14259;20.7;7.8
2B;2021-04-09;1168;566;38858;14825;21.3;8.1
2B;2021-04-10;1351;262;40209;15087;22.1;8.3
2B;2021-04-11;812;65;41021;15152;22.5;8.3
2B;2021-04-12;852;561;41873;15713;23.0;8.6
2B;2021-04-13;1061;631;42934;16344;23.6;9.0
2B;2021-04-14;1044;493;43978;16837;24.1;9.2
2B;2021-04-15;885;517;44863;17354;24.6;9.5
2B;2021-04-16;911;649;45774;18003;25.1;9.9
2B;2021-04-17;386;446;46160;18449;25.3;10.1
2B;2021-04-18;252;340;46412;18789;25.5;10.3
2B;2021-04-19;822;438;47234;19227;25.9;10.5
2B;2021-04-20;898;848;48132;20075;26.4;11.0
2B;2021-04-21;1055;608;49187;20683;27.0;11.3
2B;2021-04-22;937;731;50124;21414;27.5;11.7
2B;2021-04-23;661;629;50785;22043;27.9;12.1
2B;2021-04-24;287;772;51072;22815;28.0;12.5
2B;2021-04-25;285;477;51357;23292;28.2;12.8
2B;2021-04-26;708;920;52065;24212;28.6;13.3
2B;2021-04-27;965;875;53030;25087;29.1;13.8
2B;2021-04-28;918;861;53948;25948;29.6;14.2
2B;2021-04-29;921;868;54869;26816;30.1;14.7
2B;2021-04-30;1132;831;56001;27647;30.7;15.2
2B;2021-05-01;459;1115;56460;28762;31.0;15.8
2B;2021-05-02;335;245;56795;29007;31.2;15.9
2B;2021-05-03;1019;495;57814;29502;31.7;16.2
2B;2021-05-04;809;1152;58623;30654;32.2;16.8
2B;2021-05-05;804;1375;59427;32029;32.6;17.6
2B;2021-05-06;1288;904;60715;32933;33.3;18.1
2B;2021-05-07;1062;987;61777;33920;33.9;18.6
2B;2021-05-08;459;856;62236;34776;34.1;19.1
2B;2021-05-09;394;683;62630;35459;34.4;19.5
2B;2021-05-10;926;797;63556;36256;34.9;19.9
2B;2021-05-11;933;1162;64489;37418;35.4;20.5
2B;2021-05-12;857;891;65346;38309;35.9;21.0
2B;2021-05-13;1027;377;66373;38686;36.4;21.2
2B;2021-05-14;718;579;67091;39265;36.8;21.5
2B;2021-05-15;702;353;67793;39618;37.2;21.7
2B;2021-05-16;299;180;68092;39798;37.4;21.8
2B;2021-05-17;1002;406;69094;40204;37.9;22.1
2B;2021-05-18;991;382;70085;40586;38.5;22.3
2B;2021-05-19;771;416;70856;41002;38.9;22.5
2B;2021-05-20;672;359;71528;41361;39.2;22.7
2B;2021-05-21;705;502;72233;41863;39.6;23.0
2B;2021-05-22;574;391;72807;42254;39.9;23.2
2B;2021-05-23;168;46;72975;42300;40.0;23.2
2B;2021-05-24;40;115;73015;42415;40.1;23.3
2B;2021-05-25;548;353;73563;42768;40.4;23.5
2B;2021-05-26;544;789;74107;43557;40.7;23.9
2B;2021-05-27;407;1131;74514;44688;40.9;24.5
2B;2021-05-28;554;906;75068;45594;41.2;25.0
2B;2021-05-29;312;353;75380;45947;41.4;25.2
2B;2021-05-30;46;45;75426;45992;41.4;25.2
2B;2021-05-31;376;832;75802;46824;41.6;25.7
2B;2021-06-01;414;1039;76216;47863;41.8;26.3
2B;2021-06-02;364;991;76580;48854;42.0;26.8
2B;2021-06-03;498;808;77078;49662;42.3;27.2
2B;2021-06-04;343;1255;77421;50917;42.5;27.9
2B;2021-06-05;258;494;77679;51411;42.6;28.2
2B;2021-06-06;51;129;77730;51540;42.6;28.3
2B;2021-06-07;280;948;78010;52488;42.8;28.8
2B;2021-06-08;399;1170;78409;53658;43.0;29.4
2B;2021-06-09;518;1178;78927;54836;43.3;30.1
2B;2021-06-10;367;939;79294;55775;43.5;30.6
2B;2021-06-11;432;1274;79726;57049;43.7;31.3
2B;2021-06-12;151;545;79877;57594;43.8;31.6
2B;2021-06-13;25;59;79902;57653;43.8;31.6
2B;2021-06-14;195;1116;80097;58769;43.9;32.2
2B;2021-06-15;345;1220;80442;59989;44.1;32.9
2B;2021-06-16;380;937;80822;60926;44.3;33.4
2B;2021-06-17;399;1047;81221;61973;44.6;34.0
2B;2021-06-18;346;959;81567;62932;44.8;34.5
2B;2021-06-19;142;328;81709;63260;44.8;34.7
2B;2021-06-20;44;194;81753;63454;44.9;34.8
2B;2021-06-21;264;961;82017;64415;45.0;35.3
2B;2021-06-22;314;1113;82331;65528;45.2;36.0
2B;2021-06-23;209;872;82540;66400;45.3;36.4
2B;2021-06-24;335;756;82875;67156;45.5;36.8
2B;2021-06-25;212;1076;83087;68232;45.6;37.4
2B;2021-06-26;105;551;83192;68783;45.6;37.7
2B;2021-06-27;32;215;83224;68998;45.7;37.9
2B;2021-06-28;328;952;83552;69950;45.8;38.4
2B;2021-06-29;270;987;83822;70937;46.0;38.9
2B;2021-06-30;377;948;84199;71885;46.2;39.4
2B;2021-07-01;225;508;84424;72393;46.3;39.7
2B;2021-07-02;212;559;84636;72952;46.4;40.0
2B;2021-07-03;91;396;84727;73348;46.5;40.2
2B;2021-07-04;2;0;84729;73348;46.5;40.2
2B;2021-07-05;265;663;84994;74011;46.6;40.6
2B;2021-07-06;447;707;85441;74718;46.9;41.0
2B;2021-07-07;373;908;85814;75626;47.1;41.5
2B;2021-07-08;182;347;85996;75973;47.2;41.7
2B;2021-07-09;244;372;86240;76345;47.3;41.9
2B;2021-07-10;194;198;86434;76543;47.4;42.0
2B;2021-07-11;13;14;86447;76557;47.4;42.0
2B;2021-07-12;492;741;86939;77298;47.7;42.4
2B;2021-07-13;819;1012;87758;78310;48.2;43.0
2B;2021-07-14;338;97;88096;78407;48.3;43.0
2B;2021-07-15;1260;577;89356;78984;49.0;43.3
2B;2021-07-16;1106;556;90462;79540;49.6;43.6
2B;2021-07-17;707;312;91169;79852;50.0;43.8
2B;2021-07-18;179;46;91348;79898;50.1;43.8
2B;2021-07-19;839;697;92187;80595;50.6;44.2
2B;2021-07-20;1197;678;93384;81273;51.2;44.6
2B;2021-07-21;1376;717;94760;81990;52.0;45.0
2B;2021-07-22;1317;599;96077;82589;52.7;45.3
2B;2021-07-23;1311;493;97388;83082;53.4;45.6
2B;2021-07-24;529;315;97917;83397;53.7;45.8
2B;2021-07-25;203;71;98120;83468;53.8;45.8
2B;2021-07-26;911;630;99031;84098;54.3;46.1
2B;2021-07-27;1564;696;100595;84794;55.2;46.5
2B;2021-07-28;1158;620;101753;85414;55.8;46.9
2B;2021-07-29;1130;441;102883;85855;56.4;47.1
2B;2021-07-30;756;339;103639;86194;56.9;47.3
2B;2021-07-31;534;228;104173;86422;57.2;47.4
2B;2021-08-01;229;56;104402;86478;57.3;47.4
2B;2021-08-02;784;464;105186;86942;57.7;47.7
2B;2021-08-03;1121;773;106307;87715;58.3;48.1
2B;2021-08-04;788;443;107095;88158;58.8;48.4
2B;2021-08-05;982;541;108077;88699;59.3;48.7
30;2020-12-27;0;0;0;0;0.0;0.0
30;2020-12-28;0;0;0;0;0.0;0.0
30;2020-12-29;0;0;0;0;0.0;0.0
30;2020-12-30;0;0;0;0;0.0;0.0
30;2020-12-31;0;0;0;0;0.0;0.0
30;2021-01-01;0;0;0;0;0.0;0.0
30;2021-01-02;0;0;0;0;0.0;0.0
30;2021-01-03;0;0;0;0;0.0;0.0
30;2021-01-04;1;0;1;0;0.0;0.0
30;2021-01-05;3;0;4;0;0.0;0.0
30;2021-01-06;128;0;132;0;0.0;0.0
30;2021-01-07;312;0;444;0;0.1;0.0
30;2021-01-08;531;0;975;0;0.1;0.0
30;2021-01-09;270;0;1245;0;0.2;0.0
30;2021-01-10;0;0;1245;0;0.2;0.0
30;2021-01-11;537;1;1782;1;0.2;0.0
30;2021-01-12;798;3;2580;4;0.3;0.0
30;2021-01-13;639;0;3219;4;0.4;0.0
30;2021-01-14;649;5;3868;9;0.5;0.0
30;2021-01-15;756;2;4624;11;0.6;0.0
30;2021-01-16;313;0;4937;11;0.7;0.0
30;2021-01-17;3;0;4940;11;0.7;0.0
30;2021-01-18;937;5;5877;16;0.8;0.0
30;2021-01-19;1735;7;7612;23;1.0;0.0
30;2021-01-20;1303;2;8915;25;1.2;0.0
30;2021-01-21;1225;2;10140;27;1.4;0.0
30;2021-01-22;1074;5;11214;32;1.5;0.0
30;2021-01-23;633;2;11847;34;1.6;0.0
30;2021-01-24;0;0;11847;34;1.6;0.0
30;2021-01-25;830;4;12677;38;1.7;0.0
30;2021-01-26;1056;15;13733;53;1.8;0.0
30;2021-01-27;979;112;14712;165;2.0;0.0
30;2021-01-28;712;274;15424;439;2.1;0.1
30;2021-01-29;668;447;16092;886;2.1;0.1
30;2021-01-30;471;288;16563;1174;2.2;0.2
30;2021-01-31;3;7;16566;1181;2.2;0.2
30;2021-02-01;813;436;17379;1617;2.3;0.2
30;2021-02-02;1874;672;19253;2289;2.6;0.3
30;2021-02-03;1183;488;20436;2777;2.7;0.4
30;2021-02-04;968;662;21404;3439;2.9;0.5
30;2021-02-05;598;764;22002;4203;2.9;0.6
30;2021-02-06;291;262;22293;4465;3.0;0.6
30;2021-02-07;2;8;22295;4473;3.0;0.6
30;2021-02-08;574;738;22869;5211;3.1;0.7
30;2021-02-09;981;1006;23850;6217;3.2;0.8
30;2021-02-10;986;1100;24836;7317;3.3;1.0
30;2021-02-11;927;1038;25763;8355;3.4;1.1
30;2021-02-12;616;993;26379;9348;3.5;1.2
30;2021-02-13;435;388;26814;9736;3.6;1.3
30;2021-02-14;1;21;26815;9757;3.6;1.3
30;2021-02-15;448;622;27263;10379;3.6;1.4
30;2021-02-16;459;849;27722;11228;3.7;1.5
30;2021-02-17;682;625;28404;11853;3.8;1.6
30;2021-02-18;796;528;29200;12381;3.9;1.7
30;2021-02-19;573;672;29773;13053;4.0;1.7
30;2021-02-20;223;227;29996;13280;4.0;1.8
30;2021-02-21;5;3;30001;13283;4.0;1.8
30;2021-02-22;501;764;30502;14047;4.1;1.9
30;2021-02-23;974;1467;31476;15514;4.2;2.1
30;2021-02-24;926;1191;32402;16705;4.3;2.2
30;2021-02-25;1207;893;33609;17598;4.5;2.4
30;2021-02-26;1338;599;34947;18197;4.7;2.4
30;2021-02-27;564;546;35511;18743;4.7;2.5
30;2021-02-28;1;7;35512;18750;4.7;2.5
30;2021-03-01;1339;830;36851;19580;4.9;2.6
30;2021-03-02;1710;910;38561;20490;5.2;2.7
30;2021-03-03;2306;758;40867;21248;5.5;2.8
30;2021-03-04;2635;868;43502;22116;5.8;3.0
30;2021-03-05;2757;608;46259;22724;6.2;3.0
30;2021-03-06;2997;360;49256;23084;6.6;3.1
30;2021-03-07;1859;41;51115;23125;6.8;3.1
30;2021-03-08;1546;780;52661;23905;7.0;3.2
30;2021-03-09;2275;867;54936;24772;7.3;3.3
30;2021-03-10;2352;650;57288;25422;7.7;3.4
30;2021-03-11;3055;680;60343;26102;8.1;3.5
30;2021-03-12;3112;382;63455;26484;8.5;3.5
30;2021-03-13;2224;290;65679;26774;8.8;3.6
30;2021-03-14;83;3;65762;26777;8.8;3.6
30;2021-03-15;1567;563;67329;27340;9.0;3.7
30;2021-03-16;1299;1065;68628;28405;9.2;3.8
30;2021-03-17;1454;643;70082;29048;9.4;3.9
30;2021-03-18;1644;713;71726;29761;9.6;4.0
30;2021-03-19;2249;541;73975;30302;9.9;4.0
30;2021-03-20;1399;140;75374;30442;10.1;4.1
30;2021-03-21;57;8;75431;30450;10.1;4.1
30;2021-03-22;2394;716;77825;31166;10.4;4.2
30;2021-03-23;3508;798;81333;31964;10.9;4.3
30;2021-03-24;3634;802;84967;32766;11.4;4.4
30;2021-03-25;4403;839;89370;33605;11.9;4.5
30;2021-03-26;4359;628;93729;34233;12.5;4.6
30;2021-03-27;1970;374;95699;34607;12.8;4.6
30;2021-03-28;35;29;95734;34636;12.8;4.6
30;2021-03-29;2813;1650;98547;36286;13.2;4.8
30;2021-03-30;3780;1873;102327;38159;13.7;5.1
30;2021-03-31;3505;1638;105832;39797;14.1;5.3
30;2021-04-01;4014;1455;109846;41252;14.7;5.5
30;2021-04-02;3599;1228;113445;42480;15.2;5.7
30;2021-04-03;1061;1223;114506;43703;15.3;5.8
30;2021-04-04;29;188;114535;43891;15.3;5.9
30;2021-04-05;764;284;115299;44175;15.4;5.9
30;2021-04-06;3040;1573;118339;45748;15.8;6.1
30;2021-04-07;2716;1628;121055;47376;16.2;6.3
30;2021-04-08;3917;1481;124972;48857;16.7;6.5
30;2021-04-09;4884;1514;129856;50371;17.3;6.7
30;2021-04-10;2426;1171;132282;51542;17.7;6.9
30;2021-04-11;949;56;133231;51598;17.8;6.9
30;2021-04-12;3147;1485;136378;53083;18.2;7.1
30;2021-04-13;4018;1929;140396;55012;18.8;7.3
30;2021-04-14;3378;1536;143774;56548;19.2;7.6
30;2021-04-15;3831;1456;147605;58004;19.7;7.7
30;2021-04-16;3704;1523;151309;59527;20.2;8.0
30;2021-04-17;1492;948;152801;60475;20.4;8.1
30;2021-04-18;959;66;153760;60541;20.5;8.1
30;2021-04-19;2449;2296;156209;62837;20.9;8.4
30;2021-04-20;2814;2825;159023;65662;21.2;8.8
30;2021-04-21;2599;2564;161622;68226;21.6;9.1
30;2021-04-22;3523;2315;165145;70541;22.1;9.4
30;2021-04-23;3576;2301;168721;72842;22.5;9.7
30;2021-04-24;1346;1230;170067;74072;22.7;9.9
30;2021-04-25;748;90;170815;74162;22.8;9.9
30;2021-04-26;2014;2385;172829;76547;23.1;10.2
30;2021-04-27;2950;2605;175779;79152;23.5;10.6
30;2021-04-28;2837;2480;178616;81632;23.9;10.9
30;2021-04-29;3615;2308;182231;83940;24.3;11.2
30;2021-04-30;3407;2022;185638;85962;24.8;11.5
30;2021-05-01;1749;605;187387;86567;25.0;11.6
30;2021-05-02;663;245;188050;86812;25.1;11.6
30;2021-05-03;3756;2498;191806;89310;25.6;11.9
30;2021-05-04;3980;3520;195786;92830;26.2;12.4
30;2021-05-05;3936;3125;199722;95955;26.7;12.8
30;2021-05-06;4194;3354;203916;99309;27.2;13.3
30;2021-05-07;4077;3054;207993;102363;27.8;13.7
30;2021-05-08;1605;719;209598;103082;28.0;13.8
30;2021-05-09;372;612;209970;103694;28.1;13.9
30;2021-05-10;2915;3114;212885;106808;28.4;14.3
30;2021-05-11;5386;3652;218271;110460;29.2;14.8
30;2021-05-12;5303;3214;223574;113674;29.9;15.2
30;2021-05-13;3231;1025;226805;114699;30.3;15.3
30;2021-05-14;4890;2450;231695;117149;31.0;15.7
30;2021-05-15;3408;1203;235103;118352;31.4;15.8
30;2021-05-16;397;339;235500;118691;31.5;15.9
30;2021-05-17;3798;3033;239298;121724;32.0;16.3
30;2021-05-18;4823;3034;244121;124758;32.6;16.7
30;2021-05-19;4773;2545;248894;127303;33.3;17.0
30;2021-05-20;5010;2574;253904;129877;33.9;17.4
30;2021-05-21;4889;2467;258793;132344;34.6;17.7
30;2021-05-22;3157;1290;261950;133634;35.0;17.9
30;2021-05-23;288;345;262238;133979;35.0;17.9
30;2021-05-24;783;768;263021;134747;35.1;18.0
30;2021-05-25;2658;3162;265679;137909;35.5;18.4
30;2021-05-26;2887;2564;268566;140473;35.9;18.8
30;2021-05-27;3760;2717;272326;143190;36.4;19.1
30;2021-05-28;3326;3288;275652;146478;36.8;19.6
30;2021-05-29;1687;1803;277339;148281;37.1;19.8
30;2021-05-30;360;589;277699;148870;37.1;19.9
30;2021-05-31;2833;2295;280532;151165;37.5;20.2
30;2021-06-01;3657;2794;284189;153959;38.0;20.6
30;2021-06-02;3314;2446;287503;156405;38.4;20.9
30;2021-06-03;4131;3348;291634;159753;39.0;21.3
30;2021-06-04;3902;3399;295536;163152;39.5;21.8
30;2021-06-05;1907;1313;297443;164465;39.7;22.0
30;2021-06-06;683;263;298126;164728;39.8;22.0
30;2021-06-07;4723;2521;302849;167249;40.5;22.3
30;2021-06-08;4831;3322;307680;170571;41.1;22.8
30;2021-06-09;4145;2982;311825;173553;41.7;23.2
30;2021-06-10;4603;3350;316428;176903;42.3;23.6
30;2021-06-11;4583;3809;321011;180712;42.9;24.1
30;2021-06-12;2482;1706;323493;182418;43.2;24.4
30;2021-06-13;494;340;323987;182758;43.3;24.4
30;2021-06-14;2469;4704;326456;187462;43.6;25.0
30;2021-06-15;3200;5305;329656;192767;44.0;25.8
30;2021-06-16;3109;4645;332765;197412;44.5;26.4
30;2021-06-17;3924;4365;336689;201777;45.0;27.0
30;2021-06-18;3709;4692;340398;206469;45.5;27.6
30;2021-06-19;1440;2001;341838;208470;45.7;27.9
30;2021-06-20;358;489;342196;208959;45.7;27.9
30;2021-06-21;2376;4905;344572;213864;46.0;28.6
30;2021-06-22;2362;5737;346934;219601;46.4;29.3
30;2021-06-23;2523;5335;349457;224936;46.7;30.1
30;2021-06-24;2337;4699;351794;229635;47.0;30.7
30;2021-06-25;2609;5599;354403;235234;47.4;31.4
30;2021-06-26;909;2936;355312;238170;47.5;31.8
30;2021-06-27;221;525;355533;238695;47.5;31.9
30;2021-06-28;1665;6017;357198;244712;47.7;32.7
30;2021-06-29;1836;6022;359034;250734;48.0;33.5
30;2021-06-30;1991;5256;361025;255990;48.2;34.2
30;2021-07-01;2978;4716;364003;260706;48.6;34.8
30;2021-07-02;2828;4619;366831;265325;49.0;35.4
30;2021-07-03;1149;3044;367980;268369;49.2;35.9
30;2021-07-04;115;391;368095;268760;49.2;35.9
30;2021-07-05;2019;4026;370114;272786;49.4;36.4
30;2021-07-06;2654;4970;372768;277756;49.8;37.1
30;2021-07-07;2537;4216;375305;281972;50.1;37.7
30;2021-07-08;2006;3424;377311;285396;50.4;38.1
30;2021-07-09;2400;5323;379711;290719;50.7;38.8
30;2021-07-10;1494;2159;381205;292878;50.9;39.1
30;2021-07-11;43;416;381248;293294;50.9;39.2
30;2021-07-12;2517;5151;383765;298445;51.3;39.9
30;2021-07-13;3280;6032;387045;304477;51.7;40.7
30;2021-07-14;493;544;387538;305021;51.8;40.8
30;2021-07-15;4103;5458;391641;310479;52.3;41.5
30;2021-07-16;4936;5703;396577;316182;53.0;42.2
30;2021-07-17;1693;2460;398270;318642;53.2;42.6
30;2021-07-18;145;602;398415;319244;53.2;42.7
30;2021-07-19;3353;6294;401768;325538;53.7;43.5
30;2021-07-20;4619;6496;406387;332034;54.3;44.4
30;2021-07-21;4036;5399;410423;337433;54.8;45.1
30;2021-07-22;4869;5710;415292;343143;55.5;45.8
30;2021-07-23;4954;5841;420246;348984;56.1;46.6
30;2021-07-24;2227;3258;422473;352242;56.4;47.1
30;2021-07-25;134;308;422607;352550;56.5;47.1
30;2021-07-26;4381;4106;426988;356656;57.0;47.7
30;2021-07-27;4817;4629;431805;361285;57.7;48.3
30;2021-07-28;4836;3986;436641;365271;58.3;48.8
30;2021-07-29;5887;4096;442528;369367;59.1;49.3
30;2021-07-30;5306;4361;447834;373728;59.8;49.9
30;2021-07-31;2624;1943;450458;375671;60.2;50.2
30;2021-08-01;712;303;451170;375974;60.3;50.2
30;2021-08-02;3627;3994;454797;379968;60.8;50.8
30;2021-08-03;4817;3909;459614;383877;61.4;51.3
30;2021-08-04;5193;3016;464807;386893;62.1;51.7
30;2021-08-05;4485;3707;469292;390600;62.7;52.2
31;2020-12-27;0;0;0;0;0.0;0.0
31;2020-12-28;1;0;1;0;0.0;0.0
31;2020-12-29;0;0;1;0;0.0;0.0
31;2020-12-30;0;0;1;0;0.0;0.0
31;2020-12-31;0;0;1;0;0.0;0.0
31;2021-01-01;4;0;5;0;0.0;0.0
31;2021-01-02;0;0;5;0;0.0;0.0
31;2021-01-03;2;0;7;0;0.0;0.0
31;2021-01-04;3;0;10;0;0.0;0.0
31;2021-01-05;50;0;60;0;0.0;0.0
31;2021-01-06;211;1;271;1;0.0;0.0
31;2021-01-07;284;1;555;2;0.0;0.0
31;2021-01-08;544;1;1099;3;0.1;0.0
31;2021-01-09;275;0;1374;3;0.1;0.0
31;2021-01-10;286;0;1660;3;0.1;0.0
31;2021-01-11;978;3;2638;6;0.2;0.0
31;2021-01-12;1192;0;3830;6;0.3;0.0
31;2021-01-13;1157;3;4987;9;0.4;0.0
31;2021-01-14;1176;17;6163;26;0.4;0.0
31;2021-01-15;1046;3;7209;29;0.5;0.0
31;2021-01-16;243;1;7452;30;0.5;0.0
31;2021-01-17;176;0;7628;30;0.5;0.0
31;2021-01-18;1609;4;9237;34;0.7;0.0
31;2021-01-19;2931;10;12168;44;0.9;0.0
31;2021-01-20;3663;10;15831;54;1.1;0.0
31;2021-01-21;2990;5;18821;59;1.3;0.0
31;2021-01-22;2271;5;21092;64;1.5;0.0
31;2021-01-23;728;1;21820;65;1.6;0.0
31;2021-01-24;212;1;22032;66;1.6;0.0
31;2021-01-25;1744;9;23776;75;1.7;0.0
31;2021-01-26;1838;64;25614;139;1.8;0.0
31;2021-01-27;1575;153;27189;292;1.9;0.0
31;2021-01-28;1382;303;28571;595;2.0;0.0
31;2021-01-29;1355;349;29926;944;2.1;0.1
31;2021-01-30;444;187;30370;1131;2.2;0.1
31;2021-01-31;61;210;30431;1341;2.2;0.1
31;2021-02-01;1156;733;31587;2074;2.3;0.1
31;2021-02-02;3033;804;34620;2878;2.5;0.2
31;2021-02-03;1917;779;36537;3657;2.6;0.3
31;2021-02-04;1806;843;38343;4500;2.7;0.3
31;2021-02-05;1340;576;39683;5076;2.8;0.4
31;2021-02-06;378;55;40061;5131;2.9;0.4
31;2021-02-07;37;41;40098;5172;2.9;0.4
31;2021-02-08;1114;666;41212;5838;2.9;0.4
31;2021-02-09;1675;1575;42887;7413;3.1;0.5
31;2021-02-10;1958;2473;44845;9886;3.2;0.7
31;2021-02-11;1814;1823;46659;11709;3.3;0.8
31;2021-02-12;1536;799;48195;12508;3.4;0.9
31;2021-02-13;503;230;48698;12738;3.5;0.9
31;2021-02-14;56;217;48754;12955;3.5;0.9
31;2021-02-15;443;1376;49197;14331;3.5;1.0
31;2021-02-16;467;1556;49664;15887;3.5;1.1
31;2021-02-17;471;1682;50135;17569;3.6;1.3
31;2021-02-18;477;1827;50612;19396;3.6;1.4
31;2021-02-19;392;1574;51004;20970;3.6;1.5
31;2021-02-20;69;531;51073;21501;3.6;1.5
31;2021-02-21;77;161;51150;21662;3.7;1.5
31;2021-02-22;432;1758;51582;23420;3.7;1.7
31;2021-02-23;867;3016;52449;26436;3.7;1.9
31;2021-02-24;653;2197;53102;28633;3.8;2.0
31;2021-02-25;1430;1840;54532;30473;3.9;2.2
31;2021-02-26;1712;1238;56244;31711;4.0;2.3
31;2021-02-27;637;406;56881;32117;4.1;2.3
31;2021-02-28;78;54;56959;32171;4.1;2.3
31;2021-03-01;871;1136;57830;33307;4.1;2.4
31;2021-03-02;1232;1669;59062;34976;4.2;2.5
31;2021-03-03;1356;1815;60418;36791;4.3;2.6
31;2021-03-04;2421;1507;62839;38298;4.5;2.7
31;2021-03-05;3053;1602;65892;39900;4.7;2.8
31;2021-03-06;2833;411;68725;40311;4.9;2.9
31;2021-03-07;5368;104;74093;40415;5.3;2.9
31;2021-03-08;1596;1098;75689;41513;5.4;3.0
31;2021-03-09;2776;1190;78465;42703;5.6;3.0
31;2021-03-10;2573;1091;81038;43794;5.8;3.1
31;2021-03-11;4377;1169;85415;44963;6.1;3.2
31;2021-03-12;5312;1192;90727;46155;6.5;3.3
31;2021-03-13;2835;504;93562;46659;6.7;3.3
31;2021-03-14;234;49;93796;46708;6.7;3.3
31;2021-03-15;2582;429;96378;47137;6.9;3.4
31;2021-03-16;1743;816;98121;47953;7.0;3.4
31;2021-03-17;1656;558;99777;48511;7.1;3.5
31;2021-03-18;1987;711;101764;49222;7.3;3.5
31;2021-03-19;3180;524;104944;49746;7.5;3.6
31;2021-03-20;1794;140;106738;49886;7.6;3.6
31;2021-03-21;210;35;106948;49921;7.6;3.6
31;2021-03-22;2577;365;109525;50286;7.8;3.6
31;2021-03-23;4053;319;113578;50605;8.1;3.6
31;2021-03-24;4352;289;117930;50894;8.4;3.6
31;2021-03-25;6040;521;123970;51415;8.8;3.7
31;2021-03-26;5465;514;129435;51929;9.2;3.7
31;2021-03-27;4347;203;133782;52132;9.5;3.7
31;2021-03-28;2290;46;136072;52178;9.7;3.7
31;2021-03-29;4205;429;140277;52607;10.0;3.8
31;2021-03-30;6591;547;146868;53154;10.5;3.8
31;2021-03-31;5642;369;152510;53523;10.9;3.8
31;2021-04-01;6961;548;159471;54071;11.4;3.9
31;2021-04-02;6101;581;165572;54652;11.8;3.9
31;2021-04-03;3924;150;169496;54802;12.1;3.9
31;2021-04-04;2058;111;171554;54913;12.2;3.9
31;2021-04-05;480;69;172034;54982;12.3;3.9
31;2021-04-06;4157;1146;176191;56128;12.6;4.0
31;2021-04-07;5982;976;182173;57104;13.0;4.1
31;2021-04-08;7563;1026;189736;58130;13.5;4.1
31;2021-04-09;8382;1246;198118;59376;14.1;4.2
31;2021-04-10;4714;542;202832;59918;14.5;4.3
31;2021-04-11;2066;139;204898;60057;14.6;4.3
31;2021-04-12;5995;1829;210893;61886;15.1;4.4
31;2021-04-13;8028;2021;218921;63907;15.6;4.6
31;2021-04-14;6648;1924;225569;65831;16.1;4.7
31;2021-04-15;7770;2232;233339;68063;16.7;4.9
31;2021-04-16;7178;2086;240517;70149;17.2;5.0
31;2021-04-17;4413;899;244930;71048;17.5;5.1
31;2021-04-18;2512;353;247442;71401;17.7;5.1
31;2021-04-19;5218;2024;252660;73425;18.0;5.2
31;2021-04-20;6071;2844;258731;76269;18.5;5.4
31;2021-04-21;5970;2790;264701;79059;18.9;5.6
31;2021-04-22;6381;3234;271082;82293;19.4;5.9
31;2021-04-23;6274;2574;277356;84867;19.8;6.1
31;2021-04-24;1615;3135;278971;88002;19.9;6.3
31;2021-04-25;685;2094;279656;90096;20.0;6.4
31;2021-04-26;3791;3222;283447;93318;20.2;6.7
31;2021-04-27;4517;3901;287964;97219;20.6;6.9
31;2021-04-28;4544;3503;292508;100722;20.9;7.2
31;2021-04-29;5180;4028;297688;104750;21.2;7.5
31;2021-04-30;5034;4131;302722;108881;21.6;7.8
31;2021-05-01;1488;3120;304210;112001;21.7;8.0
31;2021-05-02;1412;1981;305622;113982;21.8;8.1
31;2021-05-03;5653;2419;311275;116401;22.2;8.3
31;2021-05-04;4779;4736;316054;121137;22.6;8.6
31;2021-05-05;2986;5720;319040;126857;22.8;9.1
31;2021-05-06;3628;7382;322668;134239;23.0;9.6
31;2021-05-07;5257;7176;327925;141415;23.4;10.1
31;2021-05-08;3634;3101;331559;144516;23.7;10.3
31;2021-05-09;3759;2310;335318;146826;23.9;10.5
31;2021-05-10;5685;5475;341003;152301;24.3;10.9
31;2021-05-11;6649;6699;347652;159000;24.8;11.3
31;2021-05-12;6169;5918;353821;164918;25.3;11.8
31;2021-05-13;4644;2061;358465;166979;25.6;11.9
31;2021-05-14;6906;3980;365371;170959;26.1;12.2
31;2021-05-15;5142;1753;370513;172712;26.4;12.3
31;2021-05-16;3297;632;373810;173344;26.7;12.4
31;2021-05-17;5143;4148;378953;177492;27.1;12.7
31;2021-05-18;5587;4272;384540;181764;27.4;13.0
31;2021-05-19;5780;3763;390320;185527;27.9;13.2
31;2021-05-20;6474;4804;396794;190331;28.3;13.6
31;2021-05-21;5982;4605;402776;194936;28.8;13.9
31;2021-05-22;4081;1628;406857;196564;29.0;14.0
31;2021-05-23;3584;342;410441;196906;29.3;14.1
31;2021-05-24;3879;709;414320;197615;29.6;14.1
31;2021-05-25;6190;3609;420510;201224;30.0;14.4
31;2021-05-26;5601;4643;426111;205867;30.4;14.7
31;2021-05-27;4781;6196;430892;212063;30.8;15.1
31;2021-05-28;4114;6348;435006;218411;31.1;15.6
31;2021-05-29;1918;4030;436924;222441;31.2;15.9
31;2021-05-30;749;2362;437673;224803;31.2;16.0
31;2021-05-31;4395;5088;442068;229891;31.6;16.4
31;2021-06-01;5950;6562;448018;236453;32.0;16.9
31;2021-06-02;5790;6306;453808;242759;32.4;17.3
31;2021-06-03;7307;8143;461115;250902;32.9;17.9
31;2021-06-04;7535;7161;468650;258063;33.5;18.4
31;2021-06-05;9077;2773;477727;260836;34.1;18.6
31;2021-06-06;8108;1579;485835;262415;34.7;18.7
31;2021-06-07;7986;5466;493821;267881;35.2;19.1
31;2021-06-08;9099;6049;502920;273930;35.9;19.6
31;2021-06-09;8916;5519;511836;279449;36.5;19.9
31;2021-06-10;9776;6341;521612;285790;37.2;20.4
31;2021-06-11;10046;6638;531658;292428;38.0;20.9
31;2021-06-12;8792;3010;540450;295438;38.6;21.1
31;2021-06-13;8374;2005;548824;297443;39.2;21.2
31;2021-06-14;8424;6730;557248;304173;39.8;21.7
31;2021-06-15;9758;7431;567006;311604;40.5;22.2
31;2021-06-16;8726;5254;575732;316858;41.1;22.6
31;2021-06-17;8270;6595;584002;323453;41.7;23.1
31;2021-06-18;8542;7740;592544;331193;42.3;23.6
31;2021-06-19;7363;5429;599907;336622;42.8;24.0
31;2021-06-20;5570;3724;605477;340346;43.2;24.3
31;2021-06-21;5369;6912;610846;347258;43.6;24.8
31;2021-06-22;4971;8216;615817;355474;44.0;25.4
31;2021-06-23;5100;7268;620917;362742;44.3;25.9
31;2021-06-24;4623;8320;625540;371062;44.7;26.5
31;2021-06-25;5011;9306;630551;380368;45.0;27.2
31;2021-06-26;4281;6394;634832;386762;45.3;27.6
31;2021-06-27;3597;4101;638429;390863;45.6;27.9
31;2021-06-28;4096;6645;642525;397508;45.9;28.4
31;2021-06-29;3788;7560;646313;405068;46.1;28.9
31;2021-06-30;4263;7795;650576;412863;46.4;29.5
31;2021-07-01;4038;8463;654614;421326;46.7;30.1
31;2021-07-02;4101;9321;658715;430647;47.0;30.7
31;2021-07-03;4093;6106;662808;436753;47.3;31.2
31;2021-07-04;3203;4803;666011;441556;47.5;31.5
31;2021-07-05;4036;7089;670047;448645;47.8;32.0
31;2021-07-06;3843;8363;673890;457008;48.1;32.6
31;2021-07-07;3948;7964;677838;464972;48.4;33.2
31;2021-07-08;4022;8539;681860;473511;48.7;33.8
31;2021-07-09;4445;8789;686305;482300;49.0;34.4
31;2021-07-10;3913;5492;690218;487792;49.3;34.8
31;2021-07-11;3133;4125;693351;491917;49.5;35.1
31;2021-07-12;3808;8613;697159;500530;49.8;35.7
31;2021-07-13;6883;9414;704042;509944;50.3;36.4
31;2021-07-14;6127;3907;710169;513851;50.7;36.7
31;2021-07-15;8427;9404;718596;523255;51.3;37.4
31;2021-07-16;7718;9876;726314;533131;51.8;38.1
31;2021-07-17;8321;10509;734635;543640;52.4;38.8
31;2021-07-18;6605;9427;741240;553067;52.9;39.5
31;2021-07-19;4769;10778;746009;563845;53.3;40.2
31;2021-07-20;7106;11447;753115;575292;53.8;41.1
31;2021-07-21;6988;11513;760103;586805;54.3;41.9
31;2021-07-22;8129;11724;768232;598529;54.8;42.7
31;2021-07-23;7417;11772;775649;610301;55.4;43.6
31;2021-07-24;10252;10490;785901;620791;56.1;44.3
31;2021-07-25;7524;8763;793425;629554;56.6;44.9
31;2021-07-26;5494;9500;798919;639054;57.0;45.6
31;2021-07-27;7918;9150;806837;648204;57.6;46.3
31;2021-07-28;8630;8236;815467;656440;58.2;46.9
31;2021-07-29;8801;7990;824268;664430;58.8;47.4
31;2021-07-30;7625;7937;831893;672367;59.4;48.0
31;2021-07-31;5975;7361;837868;679728;59.8;48.5
31;2021-08-01;4396;4269;842264;683997;60.1;48.8
31;2021-08-02;5455;5386;847719;689383;60.5;49.2
31;2021-08-03;5835;5167;853554;694550;60.9;49.6
31;2021-08-04;5849;4767;859403;699317;61.3;49.9
31;2021-08-05;5490;7164;864893;706481;61.7;50.4
32;2020-12-27;0;0;0;0;0.0;0.0
32;2020-12-28;0;0;0;0;0.0;0.0
32;2020-12-29;0;0;0;0;0.0;0.0
32;2020-12-30;0;0;0;0;0.0;0.0
32;2020-12-31;0;0;0;0;0.0;0.0
32;2021-01-01;0;0;0;0;0.0;0.0
32;2021-01-02;0;0;0;0;0.0;0.0
32;2021-01-03;0;0;0;0;0.0;0.0
32;2021-01-04;3;0;3;0;0.0;0.0
32;2021-01-05;1;0;4;0;0.0;0.0
32;2021-01-06;2;0;6;0;0.0;0.0
32;2021-01-07;152;0;158;0;0.1;0.0
32;2021-01-08;70;0;228;0;0.1;0.0
32;2021-01-09;5;0;233;0;0.1;0.0
32;2021-01-10;0;0;233;0;0.1;0.0
32;2021-01-11;11;0;244;0;0.1;0.0
32;2021-01-12;96;0;340;0;0.2;0.0
32;2021-01-13;325;0;665;0;0.3;0.0
32;2021-01-14;377;3;1042;3;0.5;0.0
32;2021-01-15;448;0;1490;3;0.8;0.0
32;2021-01-16;16;2;1506;5;0.8;0.0
32;2021-01-17;1;0;1507;5;0.8;0.0
32;2021-01-18;344;1;1851;6;1.0;0.0
32;2021-01-19;418;0;2269;6;1.2;0.0
32;2021-01-20;358;0;2627;6;1.4;0.0
32;2021-01-21;582;0;3209;6;1.7;0.0
32;2021-01-22;371;0;3580;6;1.9;0.0
32;2021-01-23;180;0;3760;6;2.0;0.0
32;2021-01-24;4;0;3764;6;2.0;0.0
32;2021-01-25;463;1;4227;7;2.2;0.0
32;2021-01-26;604;0;4831;7;2.5;0.0
32;2021-01-27;705;4;5536;11;2.9;0.0
32;2021-01-28;686;16;6222;27;3.3;0.0
32;2021-01-29;460;52;6682;79;3.5;0.0
32;2021-01-30;260;0;6942;79;3.7;0.0
32;2021-01-31;4;5;6946;84;3.7;0.0
32;2021-02-01;288;58;7234;142;3.8;0.1
32;2021-02-02;639;139;7873;281;4.1;0.1
32;2021-02-03;338;200;8211;481;4.3;0.3
32;2021-02-04;424;278;8635;759;4.5;0.4
32;2021-02-05;348;360;8983;1119;4.7;0.6
32;2021-02-06;147;0;9130;1119;4.8;0.6
32;2021-02-07;0;36;9130;1155;4.8;0.6
32;2021-02-08;278;122;9408;1277;5.0;0.7
32;2021-02-09;309;229;9717;1506;5.1;0.8
32;2021-02-10;269;253;9986;1759;5.3;0.9
32;2021-02-11;380;318;10366;2077;5.5;1.1
32;2021-02-12;297;280;10663;2357;5.6;1.2
32;2021-02-13;249;1;10912;2358;5.7;1.2
32;2021-02-14;0;28;10912;2386;5.7;1.3
32;2021-02-15;25;212;10937;2598;5.8;1.4
32;2021-02-16;393;368;11330;2966;6.0;1.6
32;2021-02-17;190;474;11520;3440;6.1;1.8
32;2021-02-18;329;493;11849;3933;6.2;2.1
32;2021-02-19;183;281;12032;4214;6.3;2.2
32;2021-02-20;1;120;12033;4334;6.3;2.3
32;2021-02-21;0;0;12033;4334;6.3;2.3
32;2021-02-22;158;385;12191;4719;6.4;2.5
32;2021-02-23;431;565;12622;5284;6.6;2.8
32;2021-02-24;277;380;12899;5664;6.8;3.0
32;2021-02-25;480;519;13379;6183;7.0;3.3
32;2021-02-26;443;386;13822;6569;7.3;3.5
32;2021-02-27;157;246;13979;6815;7.4;3.6
32;2021-02-28;4;0;13983;6815;7.4;3.6
32;2021-03-01;51;299;14034;7114;7.4;3.7
32;2021-03-02;414;445;14448;7559;7.6;4.0
32;2021-03-03;275;292;14723;7851;7.7;4.1
32;2021-03-04;538;338;15261;8189;8.0;4.3
32;2021-03-05;436;249;15697;8438;8.3;4.4
32;2021-03-06;522;166;16219;8604;8.5;4.5
32;2021-03-07;25;5;16244;8609;8.5;4.5
32;2021-03-08;234;293;16478;8902;8.7;4.7
32;2021-03-09;642;330;17120;9232;9.0;4.9
32;2021-03-10;482;329;17602;9561;9.3;5.0
32;2021-03-11;853;293;18455;9854;9.7;5.2
32;2021-03-12;881;340;19336;10194;10.2;5.4
32;2021-03-13;490;248;19826;10442;10.4;5.5
32;2021-03-14;1;0;19827;10442;10.4;5.5
32;2021-03-15;265;25;20092;10467;10.6;5.5
32;2021-03-16;313;307;20405;10774;10.7;5.7
32;2021-03-17;149;156;20554;10930;10.8;5.8
32;2021-03-18;374;308;20928;11238;11.0;5.9
32;2021-03-19;403;183;21331;11421;11.2;6.0
32;2021-03-20;136;33;21467;11454;11.3;6.0
32;2021-03-21;0;0;21467;11454;11.3;6.0
32;2021-03-22;340;169;21807;11623;11.5;6.1
32;2021-03-23;559;399;22366;12022;11.8;6.3
32;2021-03-24;643;271;23009;12293;12.1;6.5
32;2021-03-25;896;417;23905;12710;12.6;6.7
32;2021-03-26;657;294;24562;13004;12.9;6.8
32;2021-03-27;165;3;24727;13007;13.0;6.8
32;2021-03-28;1;1;24728;13008;13.0;6.8
32;2021-03-29;371;48;25099;13056;13.2;6.9
32;2021-03-30;766;289;25865;13345;13.6;7.0
32;2021-03-31;654;172;26519;13517;14.0;7.1
32;2021-04-01;1238;320;27757;13837;14.6;7.3
32;2021-04-02;575;167;28332;14004;14.9;7.4
32;2021-04-03;114;0;28446;14004;15.0;7.4
32;2021-04-04;0;0;28446;14004;15.0;7.4
32;2021-04-05;0;0;28446;14004;15.0;7.4
32;2021-04-06;2644;307;31090;14311;16.4;7.5
32;2021-04-07;1178;202;32268;14513;17.0;7.6
32;2021-04-08;1737;405;34005;14918;17.9;7.8
32;2021-04-09;882;217;34887;15135;18.4;8.0
32;2021-04-10;808;29;35695;15164;18.8;8.0
32;2021-04-11;14;0;35709;15164;18.8;8.0
32;2021-04-12;477;22;36186;15186;19.0;8.0
32;2021-04-13;2468;382;38654;15568;20.3;8.2
32;2021-04-14;1227;264;39881;15832;21.0;8.3
32;2021-04-15;1702;391;41583;16223;21.9;8.5
32;2021-04-16;638;282;42221;16505;22.2;8.7
32;2021-04-17;781;37;43002;16542;22.6;8.7
32;2021-04-18;13;1;43015;16543;22.6;8.7
32;2021-04-19;502;44;43517;16587;22.9;8.7
32;2021-04-20;2471;388;45988;16975;24.2;8.9
32;2021-04-21;1009;299;46997;17274;24.7;9.1
32;2021-04-22;1662;320;48659;17594;25.6;9.3
32;2021-04-23;546;158;49205;17752;25.9;9.3
32;2021-04-24;1391;54;50596;17806;26.6;9.4
32;2021-04-25;0;11;50596;17817;26.6;9.4
32;2021-04-26;387;360;50983;18177;26.8;9.6
32;2021-04-27;2549;550;53532;18727;28.2;9.9
32;2021-04-28;970;354;54502;19081;28.7;10.0
32;2021-04-29;1010;885;55512;19966;29.2;10.5
32;2021-04-30;453;361;55965;20327;29.4;10.7
32;2021-05-01;2605;95;58570;20422;30.8;10.7
32;2021-05-02;0;0;58570;20422;30.8;10.7
32;2021-05-03;170;321;58740;20743;30.9;10.9
32;2021-05-04;794;2497;59534;23240;31.3;12.2
32;2021-05-05;2360;1094;61894;24334;32.6;12.8
32;2021-05-06;516;1662;62410;25996;32.8;13.7
32;2021-05-07;2285;538;64695;26534;34.0;14.0
32;2021-05-08;71;517;64766;27051;34.1;14.2
32;2021-05-09;21;179;64787;27230;34.1;14.3
32;2021-05-10;1990;550;66777;27780;35.1;14.6
32;2021-05-11;653;2275;67430;30055;35.5;15.8
32;2021-05-12;2312;1138;69742;31193;36.7;16.4
32;2021-05-13;281;1414;70023;32607;36.8;17.2
32;2021-05-14;2222;326;72245;32933;38.0;17.3
32;2021-05-15;134;712;72379;33645;38.1;17.7
32;2021-05-16;1;0;72380;33645;38.1;17.7
32;2021-05-17;353;170;72733;33815;38.3;17.8
32;2021-05-18;1642;297;74375;34112;39.1;17.9
32;2021-05-19;2472;274;76847;34386;40.4;18.1
32;2021-05-20;2887;470;79734;34856;42.0;18.3
32;2021-05-21;2533;499;82267;35355;43.3;18.6
32;2021-05-22;335;111;82602;35466;43.5;18.7
32;2021-05-23;2;13;82604;35479;43.5;18.7
32;2021-05-24;2;0;82606;35479;43.5;18.7
32;2021-05-25;1982;372;84588;35851;44.5;18.9
32;2021-05-26;2545;555;87133;36406;45.8;19.2
32;2021-05-27;2877;625;90010;37031;47.4;19.5
32;2021-05-28;2310;766;92320;37797;48.6;19.9
32;2021-05-29;372;311;92692;38108;48.8;20.1
32;2021-05-30;4;6;92696;38114;48.8;20.1
32;2021-05-31;1412;624;94108;38738;49.5;20.4
32;2021-06-01;564;2888;94672;41626;49.8;21.9
32;2021-06-02;1578;1354;96250;42980;50.6;22.6
32;2021-06-03;396;2086;96646;45066;50.9;23.7
32;2021-06-04;1838;830;98484;45896;51.8;24.2
32;2021-06-05;208;1663;98692;47559;51.9;25.0
32;2021-06-06;8;14;98700;47573;51.9;25.0
32;2021-06-07;103;418;98803;47991;52.0;25.3
32;2021-06-08;662;2540;99465;50531;52.3;26.6
32;2021-06-09;1191;1052;100656;51583;53.0;27.1
32;2021-06-10;683;1220;101339;52803;53.3;27.8
32;2021-06-11;927;663;102266;53466;53.8;28.1
32;2021-06-12;151;2679;102417;56145;53.9;29.5
32;2021-06-13;1;1;102418;56146;53.9;29.5
32;2021-06-14;529;208;102947;56354;54.2;29.7
32;2021-06-15;1731;1024;104678;57378;55.1;30.2
32;2021-06-16;849;2776;105527;60154;55.5;31.7
32;2021-06-17;860;828;106387;60982;56.0;32.1
32;2021-06-18;314;2722;106701;63704;56.1;33.5
32;2021-06-19;914;436;107615;64140;56.6;33.8
32;2021-06-20;5;13;107620;64153;56.6;33.8
32;2021-06-21;67;1994;107687;66147;56.7;34.8
32;2021-06-22;1042;966;108729;67113;57.2;35.3
32;2021-06-23;513;2182;109242;69295;57.5;36.5
32;2021-06-24;525;517;109767;69812;57.8;36.7
32;2021-06-25;490;2357;110257;72169;58.0;38.0
32;2021-06-26;108;171;110365;72340;58.1;38.1
32;2021-06-27;2;5;110367;72345;58.1;38.1
32;2021-06-28;628;602;110995;72947;58.4;38.4
32;2021-06-29;801;1984;111796;74931;58.8;39.4
32;2021-06-30;757;2723;112553;77654;59.2;40.9
32;2021-07-01;537;2639;113090;80293;59.5;42.3
32;2021-07-02;639;2336;113729;82629;59.8;43.5
32;2021-07-03;480;509;114209;83138;60.1;43.7
32;2021-07-04;1;12;114210;83150;60.1;43.8
32;2021-07-05;71;392;114281;83542;60.1;44.0
32;2021-07-06;872;2079;115153;85621;60.6;45.1
32;2021-07-07;778;2754;115931;88375;61.0;46.5
32;2021-07-08;475;2266;116406;90641;61.3;47.7
32;2021-07-09;613;2226;117019;92867;61.6;48.9
32;2021-07-10;536;520;117555;93387;61.9;49.1
32;2021-07-11;0;5;117555;93392;61.9;49.1
32;2021-07-12;525;1240;118080;94632;62.1;49.8
32;2021-07-13;1696;1814;119776;96446;63.0;50.8
32;2021-07-14;482;33;120258;96479;63.3;50.8
32;2021-07-15;2089;880;122347;97359;64.4;51.2
32;2021-07-16;1164;1908;123511;99267;65.0;52.2
32;2021-07-17;77;127;123588;99394;65.0;52.3
32;2021-07-18;2;5;123590;99399;65.0;52.3
32;2021-07-19;1991;144;125581;99543;66.1;52.4
32;2021-07-20;2026;1255;127607;100798;67.1;53.0
32;2021-07-21;1606;1682;129213;102480;68.0;53.9
32;2021-07-22;1942;496;131155;102976;69.0;54.2
32;2021-07-23;1401;1722;132556;104698;69.8;55.1
32;2021-07-24;138;119;132694;104817;69.8;55.2
32;2021-07-25;34;10;132728;104827;69.8;55.2
32;2021-07-26;1069;1060;133797;105887;70.4;55.7
32;2021-07-27;1717;2091;135514;107978;71.3;56.8
32;2021-07-28;687;974;136201;108952;71.7;57.3
32;2021-07-29;1679;1597;137880;110549;72.6;58.2
32;2021-07-30;358;348;138238;110897;72.7;58.4
32;2021-07-31;185;347;138423;111244;72.8;58.5
32;2021-08-01;17;4;138440;111248;72.8;58.5
32;2021-08-02;79;75;138519;111323;72.9;58.6
32;2021-08-03;1174;1782;139693;113105;73.5;59.5
32;2021-08-04;625;653;140318;113758;73.8;59.9
32;2021-08-05;1092;1931;141410;115689;74.4;60.9
33;2020-12-27;2;0;2;0;0.0;0.0
33;2020-12-28;1;0;3;0;0.0;0.0
33;2020-12-29;0;0;3;0;0.0;0.0
33;2020-12-30;0;0;3;0;0.0;0.0
33;2020-12-31;0;0;3;0;0.0;0.0
33;2021-01-01;0;0;3;0;0.0;0.0
33;2021-01-02;1;0;4;0;0.0;0.0
33;2021-01-03;0;0;4;0;0.0;0.0
33;2021-01-04;1;0;5;0;0.0;0.0
33;2021-01-05;0;0;5;0;0.0;0.0
33;2021-01-06;134;0;139;0;0.0;0.0
33;2021-01-07;1305;1;1444;1;0.1;0.0
33;2021-01-08;1199;2;2643;3;0.2;0.0
33;2021-01-09;296;1;2939;4;0.2;0.0
33;2021-01-10;229;0;3168;4;0.2;0.0
33;2021-01-11;626;0;3794;4;0.2;0.0
33;2021-01-12;1416;2;5210;6;0.3;0.0
33;2021-01-13;1313;8;6523;14;0.4;0.0
33;2021-01-14;1280;13;7803;27;0.5;0.0
33;2021-01-15;1605;10;9408;37;0.6;0.0
33;2021-01-16;566;8;9974;45;0.6;0.0
33;2021-01-17;406;4;10380;49;0.6;0.0
33;2021-01-18;1206;10;11586;59;0.7;0.0
33;2021-01-19;2922;4;14508;63;0.9;0.0
33;2021-01-20;3396;9;17904;72;1.1;0.0
33;2021-01-21;2855;5;20759;77;1.3;0.0
33;2021-01-22;2322;8;23081;85;1.4;0.0
33;2021-01-23;847;0;23928;85;1.5;0.0
33;2021-01-24;526;2;24454;87;1.5;0.0
33;2021-01-25;2168;61;26622;148;1.6;0.0
33;2021-01-26;2231;160;28853;308;1.8;0.0
33;2021-01-27;2249;210;31102;518;1.9;0.0
33;2021-01-28;2153;442;33255;960;2.0;0.1
33;2021-01-29;1817;692;35072;1652;2.1;0.1
33;2021-01-30;702;174;35774;1826;2.2;0.1
33;2021-01-31;387;156;36161;1982;2.2;0.1
33;2021-02-01;1456;652;37617;2634;2.3;0.2
33;2021-02-02;2642;1107;40259;3741;2.5;0.2
33;2021-02-03;2907;866;43166;4607;2.6;0.3
33;2021-02-04;4030;1351;47196;5958;2.9;0.4
33;2021-02-05;2187;1166;49383;7124;3.0;0.4
33;2021-02-06;642;201;50025;7325;3.1;0.4
33;2021-02-07;218;232;50243;7557;3.1;0.5
33;2021-02-08;1260;760;51503;8317;3.2;0.5
33;2021-02-09;1321;1691;52824;10008;3.2;0.6
33;2021-02-10;1261;1753;54085;11761;3.3;0.7
33;2021-02-11;1292;1448;55377;13209;3.4;0.8
33;2021-02-12;1115;1261;56492;14470;3.5;0.9
33;2021-02-13;199;294;56691;14764;3.5;0.9
33;2021-02-14;44;247;56735;15011;3.5;0.9
33;2021-02-15;689;1731;57424;16742;3.5;1.0
33;2021-02-16;804;2053;58228;18795;3.6;1.2
33;2021-02-17;667;2047;58895;20842;3.6;1.3
33;2021-02-18;898;2266;59793;23108;3.7;1.4
33;2021-02-19;915;2024;60708;25132;3.7;1.5
33;2021-02-20;77;659;60785;25791;3.7;1.6
33;2021-02-21;37;464;60822;26255;3.7;1.6
33;2021-02-22;703;1894;61525;28149;3.8;1.7
33;2021-02-23;1234;2747;62759;30896;3.8;1.9
33;2021-02-24;1386;2532;64145;33428;3.9;2.0
33;2021-02-25;2828;3762;66973;37190;4.1;2.3
33;2021-02-26;4053;2329;71026;39519;4.3;2.4
33;2021-02-27;1359;726;72385;40245;4.4;2.5
33;2021-02-28;123;521;72508;40766;4.4;2.5
33;2021-03-01;1531;1852;74039;42618;4.5;2.6
33;2021-03-02;2325;1748;76364;44366;4.7;2.7
33;2021-03-03;2301;1708;78665;46074;4.8;2.8
33;2021-03-04;3932;1671;82597;47745;5.1;2.9
33;2021-03-05;5754;1746;88351;49491;5.4;3.0
33;2021-03-06;3412;556;91763;50047;5.6;3.1
33;2021-03-07;740;158;92503;50205;5.7;3.1
33;2021-03-08;2710;1154;95213;51359;5.8;3.1
33;2021-03-09;4396;1337;99609;52696;6.1;3.2
33;2021-03-10;5115;1236;104724;53932;6.4;3.3
33;2021-03-11;7537;1225;112261;55157;6.9;3.4
33;2021-03-12;10106;1157;122367;56314;7.5;3.4
33;2021-03-13;5149;205;127516;56519;7.8;3.5
33;2021-03-14;712;22;128228;56541;7.9;3.5
33;2021-03-15;4436;682;132664;57223;8.1;3.5
33;2021-03-16;3580;874;136244;58097;8.3;3.6
33;2021-03-17;3634;939;139878;59036;8.6;3.6
33;2021-03-18;4030;1405;143908;60441;8.8;3.7
33;2021-03-19;6265;1017;150173;61458;9.2;3.8
33;2021-03-20;3363;99;153536;61557;9.4;3.8
33;2021-03-21;460;28;153996;61585;9.4;3.8
33;2021-03-22;4898;441;158894;62026;9.7;3.8
33;2021-03-23;6315;605;165209;62631;10.1;3.8
33;2021-03-24;7074;526;172283;63157;10.5;3.9
33;2021-03-25;8832;647;181115;63804;11.1;3.9
33;2021-03-26;10032;846;191147;64650;11.7;4.0
33;2021-03-27;3618;82;194765;64732;11.9;4.0
33;2021-03-28;577;33;195342;64765;12.0;4.0
33;2021-03-29;6762;699;202104;65464;12.4;4.0
33;2021-03-30;8092;1035;210196;66499;12.9;4.1
33;2021-03-31;7577;1063;217773;67562;13.3;4.1
33;2021-04-01;8812;1183;226585;68745;13.9;4.2
33;2021-04-02;8402;1549;234987;70294;14.4;4.3
33;2021-04-03;2831;522;237818;70816;14.6;4.3
33;2021-04-04;216;160;238034;70976;14.6;4.3
33;2021-04-05;687;122;238721;71098;14.6;4.4
33;2021-04-06;6051;2701;244772;73799;15.0;4.5
33;2021-04-07;7416;2562;252188;76361;15.4;4.7
33;2021-04-08;10319;2776;262507;79137;16.1;4.8
33;2021-04-09;12682;3080;275189;82217;16.8;5.0
33;2021-04-10;5346;1393;280535;83610;17.2;5.1
33;2021-04-11;1001;355;281536;83965;17.2;5.1
33;2021-04-12;7419;3277;288955;87242;17.7;5.3
33;2021-04-13;9311;3474;298266;90716;18.3;5.6
33;2021-04-14;9034;3639;307300;94355;18.8;5.8
33;2021-04-15;10087;3865;317387;98220;19.4;6.0
33;2021-04-16;9714;4231;327101;102451;20.0;6.3
33;2021-04-17;4652;1657;331753;104108;20.3;6.4
33;2021-04-18;928;414;332681;104522;20.4;6.4
33;2021-04-19;5613;3840;338294;108362;20.7;6.6
33;2021-04-20;7288;4255;345582;112617;21.2;6.9
33;2021-04-21;6592;4350;352174;116967;21.6;7.2
33;2021-04-22;7342;4469;359516;121436;22.0;7.4
33;2021-04-23;7694;4802;367210;126238;22.5;7.7
33;2021-04-24;4496;1800;371706;128038;22.8;7.8
33;2021-04-25;1651;418;373357;128456;22.9;7.9
33;2021-04-26;5259;5082;378616;133538;23.2;8.2
33;2021-04-27;6568;5595;385184;139133;23.6;8.5
33;2021-04-28;6771;5564;391955;144697;24.0;8.9
33;2021-04-29;8415;6224;400370;150921;24.5;9.2
33;2021-04-30;8735;6142;409105;157063;25.0;9.6
33;2021-05-01;2896;513;412001;157576;25.2;9.6
33;2021-05-02;1834;345;413835;157921;25.3;9.7
33;2021-05-03;7012;5221;420847;163142;25.8;10.0
33;2021-05-04;6826;6665;427673;169807;26.2;10.4
33;2021-05-05;7138;7568;434811;177375;26.6;10.9
33;2021-05-06;8706;8240;443517;185615;27.2;11.4
33;2021-05-07;8604;8908;452121;194523;27.7;11.9
33;2021-05-08;3541;1597;455662;196120;27.9;12.0
33;2021-05-09;1115;968;456777;197088;28.0;12.1
33;2021-05-10;6873;7288;463650;204376;28.4;12.5
33;2021-05-11;8639;7817;472289;212193;28.9;13.0
33;2021-05-12;9167;6689;481456;218882;29.5;13.4
33;2021-05-13;5207;2108;486663;220990;29.8;13.5
33;2021-05-14;8129;5360;494792;226350;30.3;13.9
33;2021-05-15;5176;2875;499968;229225;30.6;14.0
33;2021-05-16;1839;804;501807;230029;30.7;14.1
33;2021-05-17;8854;5094;510661;235123;31.3;14.4
33;2021-05-18;10610;4873;521271;239996;31.9;14.7
33;2021-05-19;10902;4780;532173;244776;32.6;15.0
33;2021-05-20;10903;5585;543076;250361;33.2;15.3
33;2021-05-21;10915;6258;553991;256619;33.9;15.7
33;2021-05-22;5115;2752;559106;259371;34.2;15.9
33;2021-05-23;1743;383;560849;259754;34.3;15.9
33;2021-05-24;5410;996;566259;260750;34.7;16.0
33;2021-05-25;9383;5767;575642;266517;35.2;16.3
33;2021-05-26;9680;6027;585322;272544;35.8;16.7
33;2021-05-27;10903;7718;596225;280262;36.5;17.2
33;2021-05-28;10066;9538;606291;289800;37.1;17.7
33;2021-05-29;5040;4111;611331;293911;37.4;18.0
33;2021-05-30;1701;665;613032;294576;37.5;18.0
33;2021-05-31;8554;6426;621586;301002;38.1;18.4
33;2021-06-01;11800;8722;633386;309724;38.8;19.0
33;2021-06-02;11710;8219;645096;317943;39.5;19.5
33;2021-06-03;12702;9190;657798;327133;40.3;20.0
33;2021-06-04;12929;10953;670727;338086;41.1;20.7
33;2021-06-05;5269;5064;675996;343150;41.4;21.0
33;2021-06-06;2523;1191;678519;344341;41.5;21.1
33;2021-06-07;9757;8490;688276;352831;42.1;21.6
33;2021-06-08;11930;9454;700206;362285;42.9;22.2
33;2021-06-09;11768;8533;711974;370818;43.6;22.7
33;2021-06-10;12945;8384;724919;379202;44.4;23.2
33;2021-06-11;12506;11180;737425;390382;45.1;23.9
33;2021-06-12;6181;4475;743606;394857;45.5;24.2
33;2021-06-13;2614;1282;746220;396139;45.7;24.3
33;2021-06-14;8577;10150;754797;406289;46.2;24.9
33;2021-06-15;12052;10269;766849;416558;46.9;25.5
33;2021-06-16;12041;8858;778890;425416;47.7;26.0
33;2021-06-17;13067;9611;791957;435027;48.5;26.6
33;2021-06-18;11785;11438;803742;446465;49.2;27.3
33;2021-06-19;5606;4815;809348;451280;49.5;27.6
33;2021-06-20;2942;1473;812290;452753;49.7;27.7
33;2021-06-21;7857;10157;820147;462910;50.2;28.3
33;2021-06-22;9042;11084;829189;473994;50.8;29.0
33;2021-06-23;8636;10839;837825;484833;51.3;29.7
33;2021-06-24;9719;9980;847544;494813;51.9;30.3
33;2021-06-25;8018;13705;855562;508518;52.4;31.1
33;2021-06-26;4334;5918;859896;514436;52.6;31.5
33;2021-06-27;2465;1959;862361;516395;52.8;31.6
33;2021-06-28;4863;12776;867224;529171;53.1;32.4
33;2021-06-29;6422;13646;873646;542817;53.5;33.2
33;2021-06-30;6651;13381;880297;556198;53.9;34.1
33;2021-07-01;7988;11806;888285;568004;54.4;34.8
33;2021-07-02;6766;15112;895051;583116;54.8;35.7
33;2021-07-03;3171;6775;898222;589891;55.0;36.1
33;2021-07-04;2061;2379;900283;592270;55.1;36.3
33;2021-07-05;4315;12908;904598;605178;55.4;37.0
33;2021-07-06;6090;14600;910688;619778;55.8;37.9
33;2021-07-07;6675;13050;917363;632828;56.2;38.7
33;2021-07-08;7892;12743;925255;645571;56.6;39.5
33;2021-07-09;6324;15111;931579;660682;57.0;40.4
33;2021-07-10;3073;7155;934652;667837;57.2;40.9
33;2021-07-11;1839;2297;936491;670134;57.3;41.0
33;2021-07-12;3887;14717;940378;684851;57.6;41.9
33;2021-07-13;7092;16111;947470;700962;58.0;42.9
33;2021-07-14;3658;5312;951128;706274;58.2;43.2
33;2021-07-15;7523;15966;958651;722240;58.7;44.2
33;2021-07-16;8477;15145;967128;737385;59.2;45.1
33;2021-07-17;3083;6431;970211;743816;59.4;45.5
33;2021-07-18;1677;3204;971888;747020;59.5;45.7
33;2021-07-19;5774;15106;977662;762126;59.9;46.7
33;2021-07-20;7360;16130;985022;778256;60.3;47.6
33;2021-07-21;8299;14532;993321;792788;60.8;48.5
33;2021-07-22;9283;15107;1002604;807895;61.4;49.5
33;2021-07-23;9566;16348;1012170;824243;62.0;50.5
33;2021-07-24;3791;7548;1015961;831791;62.2;50.9
33;2021-07-25;2079;2658;1018040;834449;62.3;51.1
33;2021-07-26;6883;13408;1024923;847857;62.7;51.9
33;2021-07-27;9962;13384;1034885;861241;63.4;52.7
33;2021-07-28;10844;11949;1045729;873190;64.0;53.5
33;2021-07-29;11587;11878;1057316;885068;64.7;54.2
33;2021-07-30;11279;12187;1068595;897255;65.4;54.9
33;2021-07-31;4702;5629;1073297;902884;65.7;55.3
33;2021-08-01;2454;1941;1075751;904825;65.9;55.4
33;2021-08-02;8302;9863;1084053;914688;66.4;56.0
33;2021-08-03;11421;8983;1095474;923671;67.1;56.5
33;2021-08-04;11765;7311;1107239;930982;67.8;57.0
33;2021-08-05;11765;7964;1119004;938946;68.5;57.5
34;2020-12-27;1;0;1;0;0.0;0.0
34;2020-12-28;1;0;2;0;0.0;0.0
34;2020-12-29;0;0;2;0;0.0;0.0
34;2020-12-30;0;0;2;0;0.0;0.0
34;2020-12-31;0;0;2;0;0.0;0.0
34;2021-01-01;1;0;3;0;0.0;0.0
34;2021-01-02;2;0;5;0;0.0;0.0
34;2021-01-03;0;0;5;0;0.0;0.0
34;2021-01-04;21;0;26;0;0.0;0.0
34;2021-01-05;106;2;132;2;0.0;0.0
34;2021-01-06;198;1;330;3;0.0;0.0
34;2021-01-07;363;0;693;3;0.1;0.0
34;2021-01-08;606;0;1299;3;0.1;0.0
34;2021-01-09;244;0;1543;3;0.1;0.0
34;2021-01-10;93;1;1636;4;0.1;0.0
34;2021-01-11;560;1;2196;5;0.2;0.0
34;2021-01-12;1006;1;3202;6;0.3;0.0
34;2021-01-13;1098;6;4300;12;0.4;0.0
34;2021-01-14;1952;13;6252;25;0.5;0.0
34;2021-01-15;1468;5;7720;30;0.7;0.0
34;2021-01-16;331;7;8051;37;0.7;0.0
34;2021-01-17;233;1;8284;38;0.7;0.0
34;2021-01-18;1124;4;9408;42;0.8;0.0
34;2021-01-19;1609;7;11017;49;0.9;0.0
34;2021-01-20;2061;8;13078;57;1.1;0.0
34;2021-01-21;4209;10;17287;67;1.5;0.0
34;2021-01-22;2549;8;19836;75;1.7;0.0
34;2021-01-23;598;1;20434;76;1.7;0.0
34;2021-01-24;2;0;20436;76;1.7;0.0
34;2021-01-25;1242;5;21678;81;1.8;0.0
34;2021-01-26;1458;21;23136;102;2.0;0.0
34;2021-01-27;1466;23;24602;125;2.1;0.0
34;2021-01-28;1392;124;25994;249;2.2;0.0
34;2021-01-29;1258;138;27252;387;2.3;0.0
34;2021-01-30;479;25;27731;412;2.4;0.0
34;2021-01-31;4;0;27735;412;2.4;0.0
34;2021-02-01;1028;251;28763;663;2.4;0.1
34;2021-02-02;1456;444;30219;1107;2.6;0.1
34;2021-02-03;2648;527;32867;1634;2.8;0.1
34;2021-02-04;2304;886;35171;2520;3.0;0.2
34;2021-02-05;1887;1184;37058;3704;3.2;0.3
34;2021-02-06;491;241;37549;3945;3.2;0.3
34;2021-02-07;31;108;37580;4053;3.2;0.3
34;2021-02-08;860;1067;38440;5120;3.3;0.4
34;2021-02-09;1031;1312;39471;6432;3.4;0.5
34;2021-02-10;1288;1511;40759;7943;3.5;0.7
34;2021-02-11;1778;2711;42537;10654;3.6;0.9
34;2021-02-12;1915;1648;44452;12302;3.8;1.0
34;2021-02-13;353;514;44805;12816;3.8;1.1
34;2021-02-14;21;287;44826;13103;3.8;1.1
34;2021-02-15;671;1213;45497;14316;3.9;1.2
34;2021-02-16;666;1533;46163;15849;3.9;1.3
34;2021-02-17;711;1528;46874;17377;4.0;1.5
34;2021-02-18;836;1500;47710;18877;4.1;1.6
34;2021-02-19;817;1230;48527;20107;4.1;1.7
34;2021-02-20;301;485;48828;20592;4.2;1.8
34;2021-02-21;64;18;48892;20610;4.2;1.8
34;2021-02-22;629;1316;49521;21926;4.2;1.9
34;2021-02-23;560;1485;50081;23411;4.3;2.0
34;2021-02-24;931;2338;51012;25749;4.3;2.2
34;2021-02-25;1603;2282;52615;28031;4.5;2.4
34;2021-02-26;1849;1623;54464;29654;4.6;2.5
34;2021-02-27;701;434;55165;30088;4.7;2.6
34;2021-02-28;86;64;55251;30152;4.7;2.6
34;2021-03-01;928;1164;56179;31316;4.8;2.7
34;2021-03-02;1588;1287;57767;32603;4.9;2.8
34;2021-03-03;1830;1412;59597;34015;5.1;2.9
34;2021-03-04;2858;1623;62455;35638;5.3;3.0
34;2021-03-05;3685;1542;66140;37180;5.6;3.2
34;2021-03-06;2642;205;68782;37385;5.8;3.2
34;2021-03-07;1242;78;70024;37463;6.0;3.2
34;2021-03-08;2777;1015;72801;38478;6.2;3.3
34;2021-03-09;4012;1455;76813;39933;6.5;3.4
34;2021-03-10;3991;1334;80804;41267;6.9;3.5
34;2021-03-11;5426;1293;86230;42560;7.3;3.6
34;2021-03-12;6491;921;92721;43481;7.9;3.7
34;2021-03-13;3133;176;95854;43657;8.1;3.7
34;2021-03-14;1000;54;96854;43711;8.2;3.7
34;2021-03-15;3297;560;100151;44271;8.5;3.8
34;2021-03-16;2911;658;103062;44929;8.8;3.8
34;2021-03-17;3303;729;106365;45658;9.0;3.9
34;2021-03-18;3444;912;109809;46570;9.3;4.0
34;2021-03-19;4690;786;114499;47356;9.7;4.0
34;2021-03-20;3139;60;117638;47416;10.0;4.0
34;2021-03-21;1993;54;119631;47470;10.2;4.0
34;2021-03-22;3682;465;123313;47935;10.5;4.1
34;2021-03-23;4955;532;128268;48467;10.9;4.1
34;2021-03-24;5213;641;133481;49108;11.3;4.2
34;2021-03-25;7194;709;140675;49817;12.0;4.2
34;2021-03-26;7166;565;147841;50382;12.6;4.3
34;2021-03-27;2369;75;150210;50457;12.8;4.3
34;2021-03-28;698;15;150908;50472;12.8;4.3
34;2021-03-29;4178;757;155086;51229;13.2;4.4
34;2021-03-30;5217;967;160303;52196;13.6;4.4
34;2021-03-31;5064;1193;165367;53389;14.1;4.5
34;2021-04-01;7028;1003;172395;54392;14.7;4.6
34;2021-04-02;5817;1173;178212;55565;15.2;4.7
34;2021-04-03;1137;85;179349;55650;15.2;4.7
34;2021-04-04;163;5;179512;55655;15.3;4.7
34;2021-04-05;431;26;179943;55681;15.3;4.7
34;2021-04-06;3130;2453;183073;58134;15.6;4.9
34;2021-04-07;3384;2642;186457;60776;15.9;5.2
34;2021-04-08;5247;2819;191704;63595;16.3;5.4
34;2021-04-09;8069;2483;199773;66078;17.0;5.6
34;2021-04-10;3165;1363;202938;67441;17.3;5.7
34;2021-04-11;1713;804;204651;68245;17.4;5.8
34;2021-04-12;4481;2519;209132;70764;17.8;6.0
34;2021-04-13;5235;3055;214367;73819;18.2;6.3
34;2021-04-14;5614;3228;219981;77047;18.7;6.6
34;2021-04-15;6990;3157;226971;80204;19.3;6.8
34;2021-04-16;6569;3153;233540;83357;19.9;7.1
34;2021-04-17;2373;2066;235913;85423;20.1;7.3
34;2021-04-18;988;1719;236901;87142;20.1;7.4
34;2021-04-19;3418;3127;240319;90269;20.4;7.7
34;2021-04-20;3762;3669;244081;93938;20.8;8.0
34;2021-04-21;4239;3717;248320;97655;21.1;8.3
34;2021-04-22;4482;4612;252802;102267;21.5;8.7
34;2021-04-23;5364;3518;258166;105785;22.0;9.0
34;2021-04-24;3161;1574;261327;107359;22.2;9.1
34;2021-04-25;1919;643;263246;108002;22.4;9.2
34;2021-04-26;4216;3475;267462;111477;22.7;9.5
34;2021-04-27;5124;4017;272586;115494;23.2;9.8
34;2021-04-28;5762;3545;278348;119039;23.7;10.1
34;2021-04-29;6417;3940;284765;122979;24.2;10.5
34;2021-04-30;7868;3292;292633;126271;24.9;10.7
34;2021-05-01;2401;501;295034;126772;25.1;10.8
34;2021-05-02;3258;320;298292;127092;25.4;10.8
34;2021-05-03;6574;2891;304866;129983;25.9;11.1
34;2021-05-04;7112;3797;311978;133780;26.5;11.4
34;2021-05-05;6499;4532;318477;138312;27.1;11.8
34;2021-05-06;6941;5209;325418;143521;27.7;12.2
34;2021-05-07;6923;5674;332341;149195;28.3;12.7
34;2021-05-08;3604;1167;335945;150362;28.6;12.8
34;2021-05-09;2179;1287;338124;151649;28.7;12.9
34;2021-05-10;5862;4798;343986;156447;29.2;13.3
34;2021-05-11;7414;5322;351400;161769;29.9;13.8
34;2021-05-12;7747;4463;359147;166232;30.5;14.1
34;2021-05-13;6120;776;365267;167008;31.1;14.2
34;2021-05-14;7482;3733;372749;170741;31.7;14.5
34;2021-05-15;4865;1685;377614;172426;32.1;14.7
34;2021-05-16;4947;456;382561;172882;32.5;14.7
34;2021-05-17;8692;1982;391253;174864;33.3;14.9
34;2021-05-18;9136;1967;400389;176831;34.0;15.0
34;2021-05-19;8624;1802;409013;178633;34.8;15.2
34;2021-05-20;8866;2504;417879;181137;35.5;15.4
34;2021-05-21;8780;3220;426659;184357;36.3;15.7
34;2021-05-22;5787;1149;432446;185506;36.8;15.8
34;2021-05-23;3881;545;436327;186051;37.1;15.8
34;2021-05-24;1896;852;438223;186903;37.3;15.9
34;2021-05-25;7139;3811;445362;190714;37.9;16.2
34;2021-05-26;8318;3022;453680;193736;38.6;16.5
34;2021-05-27;8316;4298;461996;198034;39.3;16.8
34;2021-05-28;8046;5442;470042;203476;40.0;17.3
34;2021-05-29;4003;3108;474045;206584;40.3;17.6
34;2021-05-30;1987;1392;476032;207976;40.5;17.7
34;2021-05-31;5878;5250;481910;213226;41.0;18.1
34;2021-06-01;6944;6108;488854;219334;41.6;18.6
34;2021-06-02;6130;5811;494984;225145;42.1;19.1
34;2021-06-03;7707;6492;502691;231637;42.7;19.7
34;2021-06-04;7656;7591;510347;239228;43.4;20.3
34;2021-06-05;4138;3672;514485;242900;43.7;20.7
34;2021-06-06;3268;1867;517753;244767;44.0;20.8
34;2021-06-07;4415;6762;522168;251529;44.4;21.4
34;2021-06-08;5858;6818;528026;258347;44.9;22.0
34;2021-06-09;5822;6826;533848;265173;45.4;22.5
34;2021-06-10;6314;6870;540162;272043;45.9;23.1
34;2021-06-11;5396;9271;545558;281314;46.4;23.9
34;2021-06-12;3169;4724;548727;286038;46.7;24.3
34;2021-06-13;1079;1906;549806;287944;46.7;24.5
34;2021-06-14;3443;7818;553249;295762;47.0;25.1
34;2021-06-15;3946;8785;557195;304547;47.4;25.9
34;2021-06-16;4602;7849;561797;312396;47.8;26.6
34;2021-06-17;4211;7954;566008;320350;48.1;27.2
34;2021-06-18;4342;9325;570350;329675;48.5;28.0
34;2021-06-19;2735;4404;573085;334079;48.7;28.4
34;2021-06-20;887;2871;573972;336950;48.8;28.6
34;2021-06-21;2168;8554;576140;345504;49.0;29.4
34;2021-06-22;2970;9408;579110;354912;49.2;30.2
34;2021-06-23;3513;8973;582623;363885;49.5;30.9
34;2021-06-24;3545;8674;586168;372559;49.8;31.7
34;2021-06-25;3359;10427;589527;382986;50.1;32.6
34;2021-06-26;1639;6191;591166;389177;50.3;33.1
34;2021-06-27;306;4271;591472;393448;50.3;33.5
34;2021-06-28;2259;9432;593731;402880;50.5;34.3
34;2021-06-29;2669;10287;596400;413167;50.7;35.1
34;2021-06-30;3264;9551;599664;422718;51.0;35.9
34;2021-07-01;3420;9435;603084;432153;51.3;36.7
34;2021-07-02;3352;9730;606436;441883;51.6;37.6
34;2021-07-03;1668;6161;608104;448044;51.7;38.1
34;2021-07-04;310;2765;608414;450809;51.7;38.3
34;2021-07-05;3187;7995;611601;458804;52.0;39.0
34;2021-07-06;3418;9171;615019;467975;52.3;39.8
34;2021-07-07;3233;8634;618252;476609;52.6;40.5
34;2021-07-08;4252;8846;622504;485455;52.9;41.3
34;2021-07-09;3902;9325;626406;494780;53.3;42.1
34;2021-07-10;2102;5705;628508;500485;53.4;42.6
34;2021-07-11;920;2575;629428;503060;53.5;42.8
34;2021-07-12;2830;8973;632258;512033;53.8;43.5
34;2021-07-13;4533;10019;636791;522052;54.1;44.4
34;2021-07-14;736;347;637527;522399;54.2;44.4
34;2021-07-15;5773;10359;643300;532758;54.7;45.3
34;2021-07-16;5695;10683;648995;543441;55.2;46.2
34;2021-07-17;4440;4389;653435;547830;55.6;46.6
34;2021-07-18;226;197;653661;548027;55.6;46.6
34;2021-07-19;5021;8293;658682;556320;56.0;47.3
34;2021-07-20;6750;8359;665432;564679;56.6;48.0
34;2021-07-21;7478;7765;672910;572444;57.2;48.7
34;2021-07-22;7351;8129;680261;580573;57.8;49.4
34;2021-07-23;7735;8100;687996;588673;58.5;50.1
34;2021-07-24;5972;3012;693968;591685;59.0;50.3
34;2021-07-25;3192;527;697160;592212;59.3;50.4
34;2021-07-26;6196;6406;703356;598618;59.8;50.9
34;2021-07-27;8325;5984;711681;604602;60.5;51.4
34;2021-07-28;9173;5852;720854;610454;61.3;51.9
34;2021-07-29;11229;5961;732083;616415;62.2;52.4
34;2021-07-30;9705;6463;741788;622878;63.1;53.0
34;2021-07-31;6378;2142;748166;625020;63.6;53.1
34;2021-08-01;3230;564;751396;625584;63.9;53.2
34;2021-08-02;7275;4988;758671;630572;64.5;53.6
34;2021-08-03;8008;5313;766679;635885;65.2;54.1
34;2021-08-04;8148;4494;774827;640379;65.9;54.4
34;2021-08-05;7019;4941;781846;645320;66.5;54.9
35;2020-12-27;0;0;0;0;0.0;0.0
35;2020-12-28;0;0;0;0;0.0;0.0
35;2020-12-29;2;0;2;0;0.0;0.0
35;2020-12-30;0;0;2;0;0.0;0.0
35;2020-12-31;1;0;3;0;0.0;0.0
35;2021-01-01;3;0;6;0;0.0;0.0
35;2021-01-02;0;0;6;0;0.0;0.0
35;2021-01-03;0;0;6;0;0.0;0.0
35;2021-01-04;10;0;16;0;0.0;0.0
35;2021-01-05;109;0;125;0;0.0;0.0
35;2021-01-06;175;0;300;0;0.0;0.0
35;2021-01-07;438;1;738;1;0.1;0.0
35;2021-01-08;513;1;1251;2;0.1;0.0
35;2021-01-09;31;0;1282;2;0.1;0.0
35;2021-01-10;1;0;1283;2;0.1;0.0
35;2021-01-11;538;0;1821;2;0.2;0.0
35;2021-01-12;885;2;2706;4;0.3;0.0
35;2021-01-13;967;1;3673;5;0.3;0.0
35;2021-01-14;1259;19;4932;24;0.5;0.0
35;2021-01-15;728;2;5660;26;0.5;0.0
35;2021-01-16;188;2;5848;28;0.5;0.0
35;2021-01-17;43;0;5891;28;0.5;0.0
35;2021-01-18;1221;2;7112;30;0.7;0.0
35;2021-01-19;5372;13;12484;43;1.2;0.0
35;2021-01-20;3204;7;15688;50;1.4;0.0
35;2021-01-21;3631;5;19319;55;1.8;0.0
35;2021-01-22;2088;10;21407;65;2.0;0.0
35;2021-01-23;421;1;21828;66;2.0;0.0
35;2021-01-24;50;0;21878;66;2.0;0.0
35;2021-01-25;914;17;22792;83;2.1;0.0
35;2021-01-26;1127;138;23919;221;2.2;0.0
35;2021-01-27;1030;128;24949;349;2.3;0.0
35;2021-01-28;915;299;25864;648;2.4;0.1
35;2021-01-29;724;292;26588;940;2.5;0.1
35;2021-01-30;139;20;26727;960;2.5;0.1
35;2021-01-31;0;0;26727;960;2.5;0.1
35;2021-02-01;667;335;27394;1295;2.5;0.1
35;2021-02-02;725;488;28119;1783;2.6;0.2
35;2021-02-03;659;506;28778;2289;2.7;0.2
35;2021-02-04;589;657;29367;2946;2.7;0.3
35;2021-02-05;624;563;29991;3509;2.8;0.3
35;2021-02-06;169;5;30160;3514;2.8;0.3
35;2021-02-07;1;0;30161;3514;2.8;0.3
35;2021-02-08;447;659;30608;4173;2.8;0.4
35;2021-02-09;1714;3554;32322;7727;3.0;0.7
35;2021-02-10;1367;2707;33689;10434;3.1;1.0
35;2021-02-11;1924;3222;35613;13656;3.3;1.3
35;2021-02-12;1639;1741;37252;15397;3.4;1.4
35;2021-02-13;57;254;37309;15651;3.4;1.4
35;2021-02-14;7;68;37316;15719;3.4;1.5
35;2021-02-15;771;1103;38087;16822;3.5;1.6
35;2021-02-16;918;1026;39005;17848;3.6;1.6
35;2021-02-17;889;1099;39894;18947;3.7;1.8
35;2021-02-18;1016;1000;40910;19947;3.8;1.8
35;2021-02-19;1010;972;41920;20919;3.9;1.9
35;2021-02-20;143;49;42063;20968;3.9;1.9
35;2021-02-21;5;0;42068;20968;3.9;1.9
35;2021-02-22;774;834;42842;21802;4.0;2.0
35;2021-02-23;1287;865;44129;22667;4.1;2.1
35;2021-02-24;1403;818;45532;23485;4.2;2.2
35;2021-02-25;2245;781;47777;24266;4.4;2.2
35;2021-02-26;2598;734;50375;25000;4.7;2.3
35;2021-02-27;868;103;51243;25103;4.7;2.3
35;2021-02-28;9;0;51252;25103;4.7;2.3
35;2021-03-01;961;694;52213;25797;4.8;2.4
35;2021-03-02;1632;1996;53845;27793;5.0;2.6
35;2021-03-03;1907;967;55752;28760;5.2;2.7
35;2021-03-04;2916;1410;58668;30170;5.4;2.8
35;2021-03-05;3711;1334;62379;31504;5.8;2.9
35;2021-03-06;1340;87;63719;31591;5.9;2.9
35;2021-03-07;1;40;63720;31631;5.9;2.9
35;2021-03-08;1469;584;65189;32215;6.0;3.0
35;2021-03-09;3230;600;68419;32815;6.3;3.0
35;2021-03-10;2901;560;71320;33375;6.6;3.1
35;2021-03-11;4193;708;75513;34083;7.0;3.1
35;2021-03-12;6046;591;81559;34674;7.5;3.2
35;2021-03-13;2424;132;83983;34806;7.8;3.2
35;2021-03-14;18;25;84001;34831;7.8;3.2
35;2021-03-15;1966;667;85967;35498;7.9;3.3
35;2021-03-16;2501;728;88468;36226;8.2;3.3
35;2021-03-17;2389;602;90857;36828;8.4;3.4
35;2021-03-18;2332;596;93189;37424;8.6;3.5
35;2021-03-19;3542;499;96731;37923;8.9;3.5
35;2021-03-20;1537;111;98268;38034;9.1;3.5
35;2021-03-21;36;1;98304;38035;9.1;3.5
35;2021-03-22;1750;844;100054;38879;9.2;3.6
35;2021-03-23;3624;1180;103678;40059;9.6;3.7
35;2021-03-24;3728;988;107406;41047;9.9;3.8
35;2021-03-25;5330;987;112736;42034;10.4;3.9
35;2021-03-26;5842;810;118578;42844;11.0;4.0
35;2021-03-27;1414;207;119992;43051;11.1;4.0
35;2021-03-28;4;0;119996;43051;11.1;4.0
35;2021-03-29;2779;909;122775;43960;11.3;4.1
35;2021-03-30;4290;1329;127065;45289;11.7;4.2
35;2021-03-31;3467;1339;130532;46628;12.1;4.3
35;2021-04-01;4248;1227;134780;47855;12.5;4.4
35;2021-04-02;4862;1208;139642;49063;12.9;4.5
35;2021-04-03;763;214;140405;49277;13.0;4.6
35;2021-04-04;5;0;140410;49277;13.0;4.6
35;2021-04-05;19;1;140429;49278;13.0;4.6
35;2021-04-06;3270;2041;143699;51319;13.3;4.7
35;2021-04-07;3959;1842;147658;53161;13.6;4.9
35;2021-04-08;5803;1584;153461;54745;14.2;5.1
35;2021-04-09;7424;1408;160885;56153;14.9;5.2
35;2021-04-10;1859;248;162744;56401;15.0;5.2
35;2021-04-11;35;23;162779;56424;15.0;5.2
35;2021-04-12;5137;1597;167916;58021;15.5;5.4
35;2021-04-13;7613;2782;175529;60803;16.2;5.6
35;2021-04-14;6318;2296;181847;63099;16.8;5.8
35;2021-04-15;7562;2161;189409;65260;17.5;6.0
35;2021-04-16;8078;1752;197487;67012;18.3;6.2
35;2021-04-17;1570;220;199057;67232;18.4;6.2
35;2021-04-18;10;4;199067;67236;18.4;6.2
35;2021-04-19;4815;1671;203882;68907;18.8;6.4
35;2021-04-20;5157;2636;209039;71543;19.3;6.6
35;2021-04-21;5128;2201;214167;73744;19.8;6.8
35;2021-04-22;6423;2317;220590;76061;20.4;7.0
35;2021-04-23;6817;2348;227407;78409;21.0;7.2
35;2021-04-24;1130;261;228537;78670;21.1;7.3
35;2021-04-25;7;16;228544;78686;21.1;7.3
35;2021-04-26;5096;2150;233640;80836;21.6;7.5
35;2021-04-27;6086;3205;239726;84041;22.2;7.8
35;2021-04-28;6171;2559;245897;86600;22.7;8.0
35;2021-04-29;7116;2753;253013;89353;23.4;8.3
35;2021-04-30;7556;2533;260569;91886;24.1;8.5
35;2021-05-01;616;239;261185;92125;24.1;8.5
35;2021-05-02;14;21;261199;92146;24.1;8.5
35;2021-05-03;5308;2331;266507;94477;24.6;8.7
35;2021-05-04;5079;5340;271586;99817;25.1;9.2
35;2021-05-05;4877;4440;276463;104257;25.5;9.6
35;2021-05-06;6168;5269;282631;109526;26.1;10.1
35;2021-05-07;5620;5249;288251;114775;26.6;10.6
35;2021-05-08;1720;136;289971;114911;26.8;10.6
35;2021-05-09;695;75;290666;114986;26.9;10.6
35;2021-05-10;3724;4960;294390;119946;27.2;11.1
35;2021-05-11;4774;5799;299164;125745;27.6;11.6
35;2021-05-12;5284;5494;304448;131239;28.1;12.1
35;2021-05-13;2698;1427;307146;132666;28.4;12.3
35;2021-05-14;5456;4283;312602;136949;28.9;12.7
35;2021-05-15;2928;716;315530;137665;29.2;12.7
35;2021-05-16;995;61;316525;137726;29.3;12.7
35;2021-05-17;4476;3882;321001;141608;29.7;13.1
35;2021-05-18;5833;4319;326834;145927;30.2;13.5
35;2021-05-19;5862;3619;332696;149546;30.7;13.8
35;2021-05-20;6443;4008;339139;153554;31.3;14.2
35;2021-05-21;6139;4765;345278;158319;31.9;14.6
35;2021-05-22;2115;739;347393;159058;32.1;14.7
35;2021-05-23;689;46;348082;159104;32.2;14.7
35;2021-05-24;3205;1294;351287;160398;32.5;14.8
35;2021-05-25;5542;4274;356829;164672;33.0;15.2
35;2021-05-26;5722;4168;362551;168840;33.5;15.6
35;2021-05-27;6524;4779;369075;173619;34.1;16.0
35;2021-05-28;6330;5576;375405;179195;34.7;16.6
35;2021-05-29;2875;1148;378280;180343;35.0;16.7
35;2021-05-30;876;39;379156;180382;35.0;16.7
35;2021-05-31;6311;4387;385467;184769;35.6;17.1
35;2021-06-01;7367;5121;392834;189890;36.3;17.5
35;2021-06-02;7216;3791;400050;193681;37.0;17.9
35;2021-06-03;8155;4993;408205;198674;37.7;18.4
35;2021-06-04;7272;7463;415477;206137;38.4;19.1
35;2021-06-05;4140;1579;419617;207716;38.8;19.2
35;2021-06-06;3054;148;422671;207864;39.1;19.2
35;2021-06-07;5776;5770;428447;213634;39.6;19.7
35;2021-06-08;7594;5950;436041;219584;40.3;20.3
35;2021-06-09;8459;4818;444500;224402;41.1;20.7
35;2021-06-10;9342;4744;453842;229146;41.9;21.2
35;2021-06-11;8634;7473;462476;236619;42.7;21.9
35;2021-06-12;4687;1206;467163;237825;43.2;22.0
35;2021-06-13;3386;223;470549;238048;43.5;22.0
35;2021-06-14;6230;6515;476779;244563;44.1;22.6
35;2021-06-15;7506;6959;484285;251522;44.8;23.2
35;2021-06-16;8314;5626;492599;257148;45.5;23.8
35;2021-06-17;8887;5899;501486;263047;46.3;24.3
35;2021-06-18;8718;8100;510204;271147;47.2;25.1
35;2021-06-19;1500;2509;511704;273656;47.3;25.3
35;2021-06-20;2955;885;514659;274541;47.6;25.4
35;2021-06-21;5928;6373;520587;280914;48.1;26.0
35;2021-06-22;6841;7497;527428;288411;48.7;26.7
35;2021-06-23;7249;6141;534677;294552;49.4;27.2
35;2021-06-24;8352;5917;543029;300469;50.2;27.8
35;2021-06-25;6612;8470;549641;308939;50.8;28.6
35;2021-06-26;1103;3079;550744;312018;50.9;28.8
35;2021-06-27;2632;1028;553376;313046;51.1;28.9
35;2021-06-28;4283;7755;557659;320801;51.5;29.6
35;2021-06-29;5070;7972;562729;328773;52.0;30.4
35;2021-06-30;5578;7886;568307;336659;52.5;31.1
35;2021-07-01;6528;7538;574835;344197;53.1;31.8
35;2021-07-02;5313;9857;580148;354054;53.6;32.7
35;2021-07-03;1077;2841;581225;356895;53.7;33.0
35;2021-07-04;2145;1552;583370;358447;53.9;33.1
35;2021-07-05;3714;8202;587084;366649;54.3;33.9
35;2021-07-06;4747;9474;591831;376123;54.7;34.8
35;2021-07-07;5006;8324;596837;384447;55.2;35.5
35;2021-07-08;5331;8483;602168;392930;55.6;36.3
35;2021-07-09;3859;11545;606027;404475;56.0;37.4
35;2021-07-10;889;3151;606916;407626;56.1;37.7
35;2021-07-11;1292;2360;608208;409986;56.2;37.9
35;2021-07-12;3045;9158;611253;419144;56.5;38.7
35;2021-07-13;3943;10749;615196;429893;56.9;39.7
35;2021-07-14;2137;4451;617333;434344;57.1;40.1
35;2021-07-15;4245;10181;621578;444525;57.4;41.1
35;2021-07-16;4678;11011;626256;455536;57.9;42.1
35;2021-07-17;1969;4070;628225;459606;58.1;42.5
35;2021-07-18;841;2569;629066;462175;58.1;42.7
35;2021-07-19;3223;8984;632289;471159;58.4;43.5
35;2021-07-20;4180;10594;636469;481753;58.8;44.5
35;2021-07-21;4276;9389;640745;491142;59.2;45.4
35;2021-07-22;4788;9663;645533;500805;59.7;46.3
35;2021-07-23;4516;11010;650049;511815;60.1;47.3
35;2021-07-24;1579;4266;651628;516081;60.2;47.7
35;2021-07-25;809;2845;652437;518926;60.3;48.0
35;2021-07-26;3836;8734;656273;527660;60.6;48.8
35;2021-07-27;5159;9649;661432;537309;61.1;49.7
35;2021-07-28;5275;8671;666707;545980;61.6;50.5
35;2021-07-29;6051;8326;672758;554306;62.2;51.2
35;2021-07-30;5830;9058;678588;563364;62.7;52.1
35;2021-07-31;2286;3654;680874;567018;62.9;52.4
35;2021-08-01;1513;2411;682387;569429;63.1;52.6
35;2021-08-02;4685;6940;687072;576369;63.5;53.3
35;2021-08-03;6642;7572;693714;583941;64.1;54.0
35;2021-08-04;6622;6568;700336;590509;64.7;54.6
35;2021-08-05;6558;6956;706894;597465;65.3;55.2
36;2020-12-27;0;0;0;0;0.0;0.0
36;2020-12-28;0;0;0;0;0.0;0.0
36;2020-12-29;0;0;0;0;0.0;0.0
36;2020-12-30;0;0;0;0;0.0;0.0
36;2020-12-31;0;0;0;0;0.0;0.0
36;2021-01-01;0;0;0;0;0.0;0.0
36;2021-01-02;0;0;0;0;0.0;0.0
36;2021-01-03;0;0;0;0;0.0;0.0
36;2021-01-04;2;0;2;0;0.0;0.0
36;2021-01-05;0;0;2;0;0.0;0.0
36;2021-01-06;24;0;26;0;0.0;0.0
36;2021-01-07;51;0;77;0;0.0;0.0
36;2021-01-08;111;0;188;0;0.1;0.0
36;2021-01-09;83;0;271;0;0.1;0.0
36;2021-01-10;142;0;413;0;0.2;0.0
36;2021-01-11;239;1;652;1;0.3;0.0
36;2021-01-12;282;0;934;1;0.4;0.0
36;2021-01-13;198;1;1132;2;0.5;0.0
36;2021-01-14;505;4;1637;6;0.8;0.0
36;2021-01-15;179;1;1816;7;0.8;0.0
36;2021-01-16;24;0;1840;7;0.8;0.0
36;2021-01-17;19;2;1859;9;0.9;0.0
36;2021-01-18;613;4;2472;13;1.1;0.0
36;2021-01-19;1172;3;3644;16;1.7;0.0
36;2021-01-20;1102;3;4746;19;2.2;0.0
36;2021-01-21;721;0;5467;19;2.5;0.0
36;2021-01-22;857;4;6324;23;2.9;0.0
36;2021-01-23;295;0;6619;23;3.0;0.0
36;2021-01-24;185;1;6804;24;3.1;0.0
36;2021-01-25;640;5;7444;29;3.4;0.0
36;2021-01-26;610;1;8054;30;3.7;0.0
36;2021-01-27;848;19;8902;49;4.1;0.0
36;2021-01-28;477;47;9379;96;4.3;0.0
36;2021-01-29;573;98;9952;194;4.6;0.1
36;2021-01-30;288;73;10240;267;4.7;0.1
36;2021-01-31;115;135;10355;402;4.8;0.2
36;2021-02-01;378;100;10733;502;4.9;0.2
36;2021-02-02;410;175;11143;677;5.1;0.3
36;2021-02-03;471;264;11614;941;5.3;0.4
36;2021-02-04;275;280;11889;1221;5.5;0.6
36;2021-02-05;302;164;12191;1385;5.6;0.6
36;2021-02-06;0;0;12191;1385;5.6;0.6
36;2021-02-07;1;0;12192;1385;5.6;0.6
36;2021-02-08;280;259;12472;1644;5.7;0.8
36;2021-02-09;327;609;12799;2253;5.9;1.0
36;2021-02-10;490;656;13289;2909;6.1;1.3
36;2021-02-11;385;600;13674;3509;6.3;1.6
36;2021-02-12;302;461;13976;3970;6.4;1.8
36;2021-02-13;126;83;14102;4053;6.5;1.9
36;2021-02-14;22;45;14124;4098;6.5;1.9
36;2021-02-15;42;576;14166;4674;6.5;2.2
36;2021-02-16;105;419;14271;5093;6.6;2.3
36;2021-02-17;117;626;14388;5719;6.6;2.6
36;2021-02-18;161;619;14549;6338;6.7;2.9
36;2021-02-19;181;541;14730;6879;6.8;3.2
36;2021-02-20;86;239;14816;7118;6.8;3.3
36;2021-02-21;87;157;14903;7275;6.9;3.4
36;2021-02-22;162;508;15065;7783;6.9;3.6
36;2021-02-23;62;575;15127;8358;7.0;3.8
36;2021-02-24;112;682;15239;9040;7.0;4.2
36;2021-02-25;251;283;15490;9323;7.1;4.3
36;2021-02-26;339;474;15829;9797;7.3;4.5
36;2021-02-27;72;277;15901;10074;7.3;4.6
36;2021-02-28;13;97;15914;10171;7.3;4.7
36;2021-03-01;218;343;16132;10514;7.4;4.8
36;2021-03-02;352;362;16484;10876;7.6;5.0
36;2021-03-03;394;532;16878;11408;7.8;5.3
36;2021-03-04;662;356;17540;11764;8.1;5.4
36;2021-03-05;799;297;18339;12061;8.4;5.6
36;2021-03-06;410;16;18749;12077;8.6;5.6
36;2021-03-07;340;7;19089;12084;8.8;5.6
36;2021-03-08;251;315;19340;12399;8.9;5.7
36;2021-03-09;449;268;19789;12667;9.1;5.8
36;2021-03-10;723;409;20512;13076;9.4;6.0
36;2021-03-11;838;242;21350;13318;9.8;6.1
36;2021-03-12;1445;293;22795;13611;10.5;6.3
36;2021-03-13;574;126;23369;13737;10.8;6.3
36;2021-03-14;113;0;23482;13737;10.8;6.3
36;2021-03-15;648;157;24130;13894;11.1;6.4
36;2021-03-16;447;67;24577;13961;11.3;6.4
36;2021-03-17;764;90;25341;14051;11.7;6.5
36;2021-03-18;414;71;25755;14122;11.9;6.5
36;2021-03-19;738;39;26493;14161;12.2;6.5
36;2021-03-20;451;27;26944;14188;12.4;6.5
36;2021-03-21;0;0;26944;14188;12.4;6.5
36;2021-03-22;496;58;27440;14246;12.6;6.6
36;2021-03-23;777;57;28217;14303;13.0;6.6
36;2021-03-24;1088;74;29305;14377;13.5;6.6
36;2021-03-25;1335;89;30640;14466;14.1;6.7
36;2021-03-26;1419;156;32059;14622;14.8;6.7
36;2021-03-27;475;42;32534;14664;15.0;6.8
36;2021-03-28;68;57;32602;14721;15.0;6.8
36;2021-03-29;461;183;33063;14904;15.2;6.9
36;2021-03-30;582;264;33645;15168;15.5;7.0
36;2021-03-31;1262;168;34907;15336;16.1;7.1
36;2021-04-01;1084;428;35991;15764;16.6;7.3
36;2021-04-02;965;139;36956;15903;17.0;7.3
36;2021-04-03;282;179;37238;16082;17.1;7.4
36;2021-04-04;42;2;37280;16084;17.2;7.4
36;2021-04-05;15;46;37295;16130;17.2;7.4
36;2021-04-06;821;361;38116;16491;17.6;7.6
36;2021-04-07;1073;537;39189;17028;18.0;7.8
36;2021-04-08;1347;478;40536;17506;18.7;8.1
36;2021-04-09;1939;401;42475;17907;19.6;8.2
36;2021-04-10;591;240;43066;18147;19.8;8.4
36;2021-04-11;256;90;43322;18237;20.0;8.4
36;2021-04-12;849;561;44171;18798;20.3;8.7
36;2021-04-13;1139;518;45310;19316;20.9;8.9
36;2021-04-14;1582;862;46892;20178;21.6;9.3
36;2021-04-15;1653;467;48545;20645;22.4;9.5
36;2021-04-16;1488;466;50033;21111;23.0;9.7
36;2021-04-17;893;247;50926;21358;23.5;9.8
36;2021-04-18;383;7;51309;21365;23.6;9.8
36;2021-04-19;874;442;52183;21807;24.0;10.0
36;2021-04-20;1145;519;53328;22326;24.6;10.3
36;2021-04-21;1240;876;54568;23202;25.1;10.7
36;2021-04-22;1593;870;56161;24072;25.9;11.1
36;2021-04-23;1327;618;57488;24690;26.5;11.4
36;2021-04-24;678;378;58166;25068;26.8;11.5
36;2021-04-25;413;95;58579;25163;27.0;11.6
36;2021-04-26;1134;448;59713;25611;27.5;11.8
36;2021-04-27;1280;553;60993;26164;28.1;12.0
36;2021-04-28;1489;1061;62482;27225;28.8;12.5
36;2021-04-29;2016;704;64498;27929;29.7;12.9
36;2021-04-30;1553;456;66051;28385;30.4;13.1
36;2021-05-01;724;64;66775;28449;30.8;13.1
36;2021-05-02;498;61;67273;28510;31.0;13.1
36;2021-05-03;1292;306;68565;28816;31.6;13.3
36;2021-05-04;780;807;69345;29623;31.9;13.6
36;2021-05-05;1282;1308;70627;30931;32.5;14.2
36;2021-05-06;2138;793;72765;31724;33.5;14.6
36;2021-05-07;1469;767;74234;32491;34.2;15.0
36;2021-05-08;306;104;74540;32595;34.3;15.0
36;2021-05-09;175;343;74715;32938;34.4;15.2
36;2021-05-10;1215;813;75930;33751;35.0;15.5
36;2021-05-11;1726;1247;77656;34998;35.8;16.1
36;2021-05-12;1825;1481;79481;36479;36.6;16.8
36;2021-05-13;548;306;80029;36785;36.9;16.9
36;2021-05-14;700;1039;80729;37824;37.2;17.4
36;2021-05-15;636;591;81365;38415;37.5;17.7
36;2021-05-16;337;377;81702;38792;37.6;17.9
36;2021-05-17;614;944;82316;39736;37.9;18.3
36;2021-05-18;874;938;83190;40674;38.3;18.7
36;2021-05-19;1332;843;84522;41517;38.9;19.1
36;2021-05-20;1611;1208;86133;42725;39.7;19.7
36;2021-05-21;1106;1069;87239;43794;40.2;20.2
36;2021-05-22;678;342;87917;44136;40.5;20.3
36;2021-05-23;426;295;88343;44431;40.7;20.5
36;2021-05-24;504;468;88847;44899;40.9;20.7
36;2021-05-25;1045;686;89892;45585;41.4;21.0
36;2021-05-26;1473;1165;91365;46750;42.1;21.5
36;2021-05-27;1397;976;92762;47726;42.7;22.0
36;2021-05-28;921;1481;93683;49207;43.1;22.7
36;2021-05-29;700;507;94383;49714;43.5;22.9
36;2021-05-30;111;574;94494;50288;43.5;23.2
36;2021-05-31;1137;762;95631;51050;44.0;23.5
36;2021-06-01;1410;825;97041;51875;44.7;23.9
36;2021-06-02;2058;613;99099;52488;45.6;24.2
36;2021-06-03;1903;1199;101002;53687;46.5;24.7
36;2021-06-04;1774;1047;102776;54734;47.3;25.2
36;2021-06-05;692;657;103468;55391;47.7;25.5
36;2021-06-06;336;272;103804;55663;47.8;25.6
36;2021-06-07;983;809;104787;56472;48.3;26.0
36;2021-06-08;958;980;105745;57452;48.7;26.5
36;2021-06-09;1674;1069;107419;58521;49.5;27.0
36;2021-06-10;1533;1376;108952;59897;50.2;27.6
36;2021-06-11;1288;1499;110240;61396;50.8;28.3
36;2021-06-12;919;782;111159;62178;51.2;28.6
36;2021-06-13;343;269;111502;62447;51.4;28.8
36;2021-06-14;606;1270;112108;63717;51.6;29.3
36;2021-06-15;731;1216;112839;64933;52.0;29.9
36;2021-06-16;902;1518;113741;66451;52.4;30.6
36;2021-06-17;750;1906;114491;68357;52.7;31.5
36;2021-06-18;705;1880;115196;70237;53.1;32.3
36;2021-06-19;294;395;115490;70632;53.2;32.5
36;2021-06-20;235;327;115725;70959;53.3;32.7
36;2021-06-21;684;1448;116409;72407;53.6;33.3
36;2021-06-22;840;1550;117249;73957;54.0;34.1
36;2021-06-23;773;1792;118022;75749;54.4;34.9
36;2021-06-24;853;1525;118875;77274;54.7;35.6
36;2021-06-25;940;1220;119815;78494;55.2;36.1
36;2021-06-26;324;603;120139;79097;55.3;36.4
36;2021-06-27;105;267;120244;79364;55.4;36.5
36;2021-06-28;698;927;120942;80291;55.7;37.0
36;2021-06-29;684;1458;121626;81749;56.0;37.6
36;2021-06-30;836;2151;122462;83900;56.4;38.6
36;2021-07-01;351;1082;122813;84982;56.6;39.1
36;2021-07-02;741;1846;123554;86828;56.9;40.0
36;2021-07-03;466;883;124020;87711;57.1;40.4
36;2021-07-04;184;326;124204;88037;57.2;40.5
36;2021-07-05;495;1333;124699;89370;57.4;41.2
36;2021-07-06;490;1221;125189;90591;57.7;41.7
36;2021-07-07;585;1795;125774;92386;57.9;42.5
36;2021-07-08;545;1706;126319;94092;58.2;43.3
36;2021-07-09;779;1656;127098;95748;58.5;44.1
36;2021-07-10;466;1119;127564;96867;58.7;44.6
36;2021-07-11;256;154;127820;97021;58.9;44.7
36;2021-07-12;329;1630;128149;98651;59.0;45.4
36;2021-07-13;308;1938;128457;100589;59.2;46.3
36;2021-07-14;375;763;128832;101352;59.3;46.7
36;2021-07-15;913;2169;129745;103521;59.8;47.7
36;2021-07-16;626;1880;130371;105401;60.0;48.5
36;2021-07-17;396;859;130767;106260;60.2;48.9
36;2021-07-18;195;407;130962;106667;60.3;49.1
36;2021-07-19;549;1458;131511;108125;60.6;49.8
36;2021-07-20;776;1406;132287;109531;60.9;50.4
36;2021-07-21;709;1981;132996;111512;61.2;51.4
36;2021-07-22;1135;1684;134131;113196;61.8;52.1
36;2021-07-23;964;1744;135095;114940;62.2;52.9
36;2021-07-24;607;804;135702;115744;62.5;53.3
36;2021-07-25;147;404;135849;116148;62.6;53.5
36;2021-07-26;944;1085;136793;117233;63.0;54.0
36;2021-07-27;806;1350;137599;118583;63.4;54.6
36;2021-07-28;1383;1396;138982;119979;64.0;55.3
36;2021-07-29;1706;1310;140688;121289;64.8;55.9
36;2021-07-30;1441;1312;142129;122601;65.5;56.5
36;2021-07-31;931;532;143060;123133;65.9;56.7
36;2021-08-01;206;240;143266;123373;66.0;56.8
36;2021-08-02;1112;889;144378;124262;66.5;57.2
36;2021-08-03;1269;991;145647;125253;67.1;57.7
36;2021-08-04;1676;929;147323;126182;67.8;58.1
36;2021-08-05;1721;891;149044;127073;68.6;58.5
37;2020-12-27;0;0;0;0;0.0;0.0
37;2020-12-28;17;0;17;0;0.0;0.0
37;2020-12-29;10;0;27;0;0.0;0.0
37;2020-12-30;0;0;27;0;0.0;0.0
37;2020-12-31;0;0;27;0;0.0;0.0
37;2021-01-01;0;0;27;0;0.0;0.0
37;2021-01-02;0;0;27;0;0.0;0.0
37;2021-01-03;0;0;27;0;0.0;0.0
37;2021-01-04;21;0;48;0;0.0;0.0
37;2021-01-05;47;0;95;0;0.0;0.0
37;2021-01-06;79;0;174;0;0.0;0.0
37;2021-01-07;115;0;289;0;0.0;0.0
37;2021-01-08;442;0;731;0;0.1;0.0
37;2021-01-09;79;0;810;0;0.1;0.0
37;2021-01-10;83;0;893;0;0.1;0.0
37;2021-01-11;280;0;1173;0;0.2;0.0
37;2021-01-12;659;4;1832;4;0.3;0.0
37;2021-01-13;560;1;2392;5;0.4;0.0
37;2021-01-14;521;3;2913;8;0.5;0.0
37;2021-01-15;627;1;3540;9;0.6;0.0
37;2021-01-16;303;2;3843;11;0.6;0.0
37;2021-01-17;262;1;4105;12;0.7;0.0
37;2021-01-18;733;8;4838;20;0.8;0.0
37;2021-01-19;1244;10;6082;30;1.0;0.0
37;2021-01-20;1038;3;7120;33;1.2;0.0
37;2021-01-21;854;0;7974;33;1.3;0.0
37;2021-01-22;767;2;8741;35;1.4;0.0
37;2021-01-23;173;0;8914;35;1.5;0.0
37;2021-01-24;0;0;8914;35;1.5;0.0
37;2021-01-25;538;13;9452;48;1.6;0.0
37;2021-01-26;1812;65;11264;113;1.9;0.0
37;2021-01-27;1520;76;12784;189;2.1;0.0
37;2021-01-28;1528;92;14312;281;2.4;0.0
37;2021-01-29;632;309;14944;590;2.5;0.1
37;2021-01-30;202;63;15146;653;2.5;0.1
37;2021-01-31;15;64;15161;717;2.5;0.1
37;2021-02-01;332;200;15493;917;2.6;0.2
37;2021-02-02;523;529;16016;1446;2.6;0.2
37;2021-02-03;661;354;16677;1800;2.8;0.3
37;2021-02-04;546;409;17223;2209;2.8;0.4
37;2021-02-05;465;444;17688;2653;2.9;0.4
37;2021-02-06;189;2;17877;2655;3.0;0.4
37;2021-02-07;20;1;17897;2656;3.0;0.4
37;2021-02-08;331;321;18228;2977;3.0;0.5
37;2021-02-09;625;722;18853;3699;3.1;0.6
37;2021-02-10;662;510;19515;4209;3.2;0.7
37;2021-02-11;611;563;20126;4772;3.3;0.8
37;2021-02-12;489;553;20615;5325;3.4;0.9
37;2021-02-13;155;207;20770;5532;3.4;0.9
37;2021-02-14;1;71;20771;5603;3.4;0.9
37;2021-02-15;425;479;21196;6082;3.5;1.0
37;2021-02-16;842;1452;22038;7534;3.6;1.2
37;2021-02-17;633;1371;22671;8905;3.7;1.5
37;2021-02-18;903;1416;23574;10321;3.9;1.7
37;2021-02-19;795;840;24369;11161;4.0;1.8
37;2021-02-20;245;212;24614;11373;4.1;1.9
37;2021-02-21;5;1;24619;11374;4.1;1.9
37;2021-02-22;336;583;24955;11957;4.1;2.0
37;2021-02-23;604;631;25559;12588;4.2;2.1
37;2021-02-24;571;620;26130;13208;4.3;2.2
37;2021-02-25;874;614;27004;13822;4.5;2.3
37;2021-02-26;1114;580;28118;14402;4.6;2.4
37;2021-02-27;584;187;28702;14589;4.7;2.4
37;2021-02-28;23;0;28725;14589;4.7;2.4
37;2021-03-01;603;362;29328;14951;4.8;2.5
37;2021-03-02;1090;540;30418;15491;5.0;2.6
37;2021-03-03;970;547;31388;16038;5.2;2.6
37;2021-03-04;1604;479;32992;16517;5.4;2.7
37;2021-03-05;2128;556;35120;17073;5.8;2.8
37;2021-03-06;1166;211;36286;17284;6.0;2.9
37;2021-03-07;471;66;36757;17350;6.1;2.9
37;2021-03-08;666;400;37423;17750;6.2;2.9
37;2021-03-09;1652;702;39075;18452;6.5;3.0
37;2021-03-10;1607;744;40682;19196;6.7;3.2
37;2021-03-11;2046;697;42728;19893;7.1;3.3
37;2021-03-12;3207;465;45935;20358;7.6;3.4
37;2021-03-13;1951;189;47886;20547;7.9;3.4
37;2021-03-14;206;4;48092;20551;7.9;3.4
37;2021-03-15;1069;249;49161;20800;8.1;3.4
37;2021-03-16;1048;528;50209;21328;8.3;3.5
37;2021-03-17;935;277;51144;21605;8.4;3.6
37;2021-03-18;1031;524;52175;22129;8.6;3.7
37;2021-03-19;2218;338;54393;22467;9.0;3.7
37;2021-03-20;1331;140;55724;22607;9.2;3.7
37;2021-03-21;202;4;55926;22611;9.2;3.7
37;2021-03-22;1287;243;57213;22854;9.5;3.8
37;2021-03-23;2254;566;59467;23420;9.8;3.9
37;2021-03-24;2244;460;61711;23880;10.2;3.9
37;2021-03-25;2981;445;64692;24325;10.7;4.0
37;2021-03-26;3524;402;68216;24727;11.3;4.1
37;2021-03-27;1172;127;69388;24854;11.5;4.1
37;2021-03-28;139;1;69527;24855;11.5;4.1
37;2021-03-29;1604;342;71131;25197;11.7;4.2
37;2021-03-30;2524;622;73655;25819;12.2;4.3
37;2021-03-31;2046;483;75701;26302;12.5;4.3
37;2021-04-01;2600;968;78301;27270;12.9;4.5
37;2021-04-02;2813;662;81114;27932;13.4;4.6
37;2021-04-03;817;220;81931;28152;13.5;4.7
37;2021-04-04;104;1;82035;28153;13.6;4.7
37;2021-04-05;3;0;82038;28153;13.6;4.7
37;2021-04-06;2236;778;84274;28931;13.9;4.8
37;2021-04-07;3167;854;87441;29785;14.4;4.9
37;2021-04-08;4038;963;91479;30748;15.1;5.1
37;2021-04-09;4542;938;96021;31686;15.9;5.2
37;2021-04-10;1328;429;97349;32115;16.1;5.3
37;2021-04-11;104;1;97453;32116;16.1;5.3
37;2021-04-12;2640;671;100093;32787;16.5;5.4
37;2021-04-13;4112;1152;104205;33939;17.2;5.6
37;2021-04-14;3042;893;107247;34832;17.7;5.8
37;2021-04-15;3757;1011;111004;35843;18.3;5.9
37;2021-04-16;4358;1212;115362;37055;19.1;6.1
37;2021-04-17;1147;220;116509;37275;19.2;6.2
37;2021-04-18;97;3;116606;37278;19.3;6.2
37;2021-04-19;2481;851;119087;38129;19.7;6.3
37;2021-04-20;3235;1332;122322;39461;20.2;6.5
37;2021-04-21;2930;1153;125252;40614;20.7;6.7
37;2021-04-22;3455;1399;128707;42013;21.3;6.9
37;2021-04-23;3689;1808;132396;43821;21.9;7.2
37;2021-04-24;1006;387;133402;44208;22.0;7.3
37;2021-04-25;45;2;133447;44210;22.0;7.3
37;2021-04-26;2968;1350;136415;45560;22.5;7.5
37;2021-04-27;4182;1807;140597;47367;23.2;7.8
37;2021-04-28;3460;1940;144057;49307;23.8;8.1
37;2021-04-29;4584;2015;148641;51322;24.6;8.5
37;2021-04-30;5055;1984;153696;53306;25.4;8.8
37;2021-05-01;639;210;154335;53516;25.5;8.8
37;2021-05-02;104;15;154439;53531;25.5;8.8
37;2021-05-03;2670;1952;157109;55483;26.0;9.2
37;2021-05-04;3735;2706;160844;58189;26.6;9.6
37;2021-05-05;3498;2086;164342;60275;27.1;10.0
37;2021-05-06;4997;1945;169339;62220;28.0;10.3
37;2021-05-07;4686;2884;174025;65104;28.7;10.8
37;2021-05-08;536;312;174561;65416;28.8;10.8
37;2021-05-09;63;41;174624;65457;28.8;10.8
37;2021-05-10;2160;3489;176784;68946;29.2;11.4
37;2021-05-11;3866;3881;180650;72827;29.8;12.0
37;2021-05-12;4036;2542;184686;75369;30.5;12.4
37;2021-05-13;1137;517;185823;75886;30.7;12.5
37;2021-05-14;4045;2680;189868;78566;31.4;13.0
37;2021-05-15;2322;743;192190;79309;31.7;13.1
37;2021-05-16;22;71;192212;79380;31.8;13.1
37;2021-05-17;2764;2056;194976;81436;32.2;13.5
37;2021-05-18;3875;2359;198851;83795;32.8;13.8
37;2021-05-19;3495;1806;202346;85601;33.4;14.1
37;2021-05-20;4752;1775;207098;87376;34.2;14.4
37;2021-05-21;4527;2569;211625;89945;35.0;14.9
37;2021-05-22;1077;753;212702;90698;35.1;15.0
37;2021-05-23;73;89;212775;90787;35.1;15.0
37;2021-05-24;513;106;213288;90893;35.2;15.0
37;2021-05-25;5123;2177;218411;93070;36.1;15.4
37;2021-05-26;4929;2095;223340;95165;36.9;15.7
37;2021-05-27;5986;2370;229326;97535;37.9;16.1
37;2021-05-28;6023;3262;235349;100797;38.9;16.7
37;2021-05-29;1518;1167;236867;101964;39.1;16.8
37;2021-05-30;55;160;236922;102124;39.1;16.9
37;2021-05-31;3648;2528;240570;104652;39.7;17.3
37;2021-06-01;5843;3622;246413;108274;40.7;17.9
37;2021-06-02;5077;2453;251490;110727;41.5;18.3
37;2021-06-03;6086;2883;257576;113610;42.5;18.8
37;2021-06-04;5508;4203;263084;117813;43.5;19.5
37;2021-06-05;1855;1304;264939;119117;43.8;19.7
37;2021-06-06;49;197;264988;119314;43.8;19.7
37;2021-06-07;3020;4163;268008;123477;44.3;20.4
37;2021-06-08;4199;4656;272207;128133;45.0;21.2
37;2021-06-09;3884;3569;276091;131702;45.6;21.8
37;2021-06-10;5266;3616;281357;135318;46.5;22.4
37;2021-06-11;4978;4839;286335;140157;47.3;23.2
37;2021-06-12;3553;1348;289888;141505;47.9;23.4
37;2021-06-13;15;164;289903;141669;47.9;23.4
37;2021-06-14;2668;4041;292571;145710;48.3;24.1
37;2021-06-15;3898;4782;296469;150492;49.0;24.9
37;2021-06-16;3254;3597;299723;154089;49.5;25.5
37;2021-06-17;4003;4493;303726;158582;50.2;26.2
37;2021-06-18;4704;5069;308430;163651;50.9;27.0
37;2021-06-19;2519;1101;310949;164752;51.4;27.2
37;2021-06-20;8;183;310957;164935;51.4;27.2
37;2021-06-21;2418;3827;313375;168762;51.8;27.9
37;2021-06-22;2963;5009;316338;173771;52.3;28.7
37;2021-06-23;2616;3643;318954;177414;52.7;29.3
37;2021-06-24;2857;3543;321811;180957;53.2;29.9
37;2021-06-25;3300;4877;325111;185834;53.7;30.7
37;2021-06-26;1235;3085;326346;188919;53.9;31.2
37;2021-06-27;23;142;326369;189061;53.9;31.2
37;2021-06-28;1702;4514;328071;193575;54.2;32.0
37;2021-06-29;1891;6221;329962;199796;54.5;33.0
37;2021-06-30;1854;4437;331816;204233;54.8;33.7
37;2021-07-01;2099;4795;333915;209028;55.2;34.5
37;2021-07-02;2674;5593;336589;214621;55.6;35.5
37;2021-07-03;944;2138;337533;216759;55.8;35.8
37;2021-07-04;4;104;337537;216863;55.8;35.8
37;2021-07-05;1703;5145;339240;222008;56.0;36.7
37;2021-07-06;1994;6762;341234;228770;56.4;37.8
37;2021-07-07;1944;5464;343178;234234;56.7;38.7
37;2021-07-08;2455;6664;345633;240898;57.1;39.8
37;2021-07-09;1979;7644;347612;248542;57.4;41.1
37;2021-07-10;1013;2619;348625;251161;57.6;41.5
37;2021-07-11;26;96;348651;251257;57.6;41.5
37;2021-07-12;1120;5984;349771;257241;57.8;42.5
37;2021-07-13;1609;7830;351380;265071;58.0;43.8
37;2021-07-14;523;407;351903;265478;58.1;43.9
37;2021-07-15;2608;7492;354511;272970;58.6;45.1
37;2021-07-16;2753;7806;357264;280776;59.0;46.4
37;2021-07-17;1198;2445;358462;283221;59.2;46.8
37;2021-07-18;50;53;358512;283274;59.2;46.8
37;2021-07-19;1638;6129;360150;289403;59.5;47.8
37;2021-07-20;2901;7069;363051;296472;60.0;49.0
37;2021-07-21;2969;5780;366020;302252;60.5;49.9
37;2021-07-22;4028;6534;370048;308786;61.1;51.0
37;2021-07-23;3795;7102;373843;315888;61.8;52.2
37;2021-07-24;1770;3307;375613;319195;62.0;52.7
37;2021-07-25;65;77;375678;319272;62.1;52.7
37;2021-07-26;3228;4313;378906;323585;62.6;53.5
37;2021-07-27;4406;4949;383312;328534;63.3;54.3
37;2021-07-28;4099;3647;387411;332181;64.0;54.9
37;2021-07-29;5058;4177;392469;336358;64.8;55.6
37;2021-07-30;5221;4907;397690;341265;65.7;56.4
37;2021-07-31;1912;1838;399602;343103;66.0;56.7
37;2021-08-01;31;52;399633;343155;66.0;56.7
37;2021-08-02;3268;3259;402901;346414;66.6;57.2
37;2021-08-03;5253;3115;408154;349529;67.4;57.7
37;2021-08-04;4524;1895;412678;351424;68.2;58.1
37;2021-08-05;4750;2558;417428;353982;69.0;58.5
38;2020-12-27;1;0;1;0;0.0;0.0
38;2020-12-28;0;0;1;0;0.0;0.0
38;2020-12-29;0;0;1;0;0.0;0.0
38;2020-12-30;0;0;1;0;0.0;0.0
38;2020-12-31;5;0;6;0;0.0;0.0
38;2021-01-01;1;0;7;0;0.0;0.0
38;2021-01-02;0;0;7;0;0.0;0.0
38;2021-01-03;2;0;9;0;0.0;0.0
38;2021-01-04;162;0;171;0;0.0;0.0
38;2021-01-05;257;1;428;1;0.0;0.0
38;2021-01-06;364;0;792;1;0.1;0.0
38;2021-01-07;636;1;1428;2;0.1;0.0
38;2021-01-08;695;0;2123;2;0.2;0.0
38;2021-01-09;30;0;2153;2;0.2;0.0
38;2021-01-10;0;0;2153;2;0.2;0.0
38;2021-01-11;799;2;2952;4;0.2;0.0
38;2021-01-12;1470;3;4422;7;0.3;0.0
38;2021-01-13;1081;5;5503;12;0.4;0.0
38;2021-01-14;1678;15;7181;27;0.6;0.0
38;2021-01-15;1672;7;8853;34;0.7;0.0
38;2021-01-16;306;2;9159;36;0.7;0.0
38;2021-01-17;3;0;9162;36;0.7;0.0
38;2021-01-18;1176;4;10338;40;0.8;0.0
38;2021-01-19;2239;5;12577;45;1.0;0.0
38;2021-01-20;1878;3;14455;48;1.1;0.0
38;2021-01-21;1622;6;16077;54;1.3;0.0
38;2021-01-22;1398;8;17475;62;1.4;0.0
38;2021-01-23;379;3;17854;65;1.4;0.0
38;2021-01-24;1;0;17855;65;1.4;0.0
38;2021-01-25;788;108;18643;173;1.5;0.0
38;2021-01-26;854;184;19497;357;1.5;0.0
38;2021-01-27;1089;277;20586;634;1.6;0.1
38;2021-01-28;1155;478;21741;1112;1.7;0.1
38;2021-01-29;948;379;22689;1491;1.8;0.1
38;2021-01-30;304;1;22993;1492;1.8;0.1
38;2021-01-31;0;0;22993;1492;1.8;0.1
38;2021-02-01;703;598;23696;2090;1.9;0.2
38;2021-02-02;967;963;24663;3053;1.9;0.2
38;2021-02-03;1230;695;25893;3748;2.0;0.3
38;2021-02-04;1279;972;27172;4720;2.1;0.4
38;2021-02-05;1399;846;28571;5566;2.3;0.4
38;2021-02-06;187;95;28758;5661;2.3;0.4
38;2021-02-07;3;48;28761;5709;2.3;0.5
38;2021-02-08;859;797;29620;6506;2.3;0.5
38;2021-02-09;1538;1312;31158;7818;2.5;0.6
38;2021-02-10;1580;1285;32738;9103;2.6;0.7
38;2021-02-11;1869;1159;34607;10262;2.7;0.8
38;2021-02-12;1509;1126;36116;11388;2.9;0.9
38;2021-02-13;466;189;36582;11577;2.9;0.9
38;2021-02-14;1;7;36583;11584;2.9;0.9
38;2021-02-15;975;946;37558;12530;3.0;1.0
38;2021-02-16;1381;982;38939;13512;3.1;1.1
38;2021-02-17;1371;1067;40310;14579;3.2;1.2
38;2021-02-18;1782;1067;42092;15646;3.3;1.2
38;2021-02-19;1255;868;43347;16514;3.4;1.3
38;2021-02-20;469;312;43816;16826;3.5;1.3
38;2021-02-21;0;0;43816;16826;3.5;1.3
38;2021-02-22;1074;910;44890;17736;3.5;1.4
38;2021-02-23;1539;944;46429;18680;3.7;1.5
38;2021-02-24;1728;1132;48157;19812;3.8;1.6
38;2021-02-25;2494;1050;50651;20862;4.0;1.6
38;2021-02-26;3306;977;53957;21839;4.3;1.7
38;2021-02-27;1510;429;55467;22268;4.4;1.8
38;2021-02-28;33;2;55500;22270;4.4;1.8
38;2021-03-01;2499;774;57999;23044;4.6;1.8
38;2021-03-02;4046;1054;62045;24098;4.9;1.9
38;2021-03-03;3356;1231;65401;25329;5.2;2.0
38;2021-03-04;4479;1371;69880;26700;5.5;2.1
38;2021-03-05;5229;1198;75109;27898;5.9;2.2
38;2021-03-06;3041;259;78150;28157;6.2;2.2
38;2021-03-07;113;1;78263;28158;6.2;2.2
38;2021-03-08;2441;910;80704;29068;6.4;2.3
38;2021-03-09;4024;1305;84728;30373;6.7;2.4
38;2021-03-10;3500;1075;88228;31448;7.0;2.5
38;2021-03-11;5140;1513;93368;32961;7.4;2.6
38;2021-03-12;7084;1150;100452;34111;7.9;2.7
38;2021-03-13;3770;204;104222;34315;8.2;2.7
38;2021-03-14;544;12;104766;34327;8.3;2.7
38;2021-03-15;2700;1003;107466;35330;8.5;2.8
38;2021-03-16;2083;1365;109549;36695;8.7;2.9
38;2021-03-17;2026;1204;111575;37899;8.8;3.0
38;2021-03-18;2636;1362;114211;39261;9.0;3.1
38;2021-03-19;4007;1054;118218;40315;9.3;3.2
38;2021-03-20;1823;239;120041;40554;9.5;3.2
38;2021-03-21;130;8;120171;40562;9.5;3.2
38;2021-03-22;2863;1002;123034;41564;9.7;3.3
38;2021-03-23;4777;1488;127811;43052;10.1;3.4
38;2021-03-24;3709;1576;131520;44628;10.4;3.5
38;2021-03-25;5791;1526;137311;46154;10.9;3.6
38;2021-03-26;6599;1734;143910;47888;11.4;3.8
38;2021-03-27;2511;755;146421;48643;11.6;3.8
38;2021-03-28;926;43;147347;48686;11.6;3.8
38;2021-03-29;2674;1851;150021;50537;11.9;4.0
38;2021-03-30;4564;2543;154585;53080;12.2;4.2
38;2021-03-31;3661;2225;158246;55305;12.5;4.4
38;2021-04-01;5127;2504;163373;57809;12.9;4.6
38;2021-04-02;3867;2525;167240;60334;13.2;4.8
38;2021-04-03;1417;941;168657;61275;13.3;4.8
38;2021-04-04;429;45;169086;61320;13.4;4.8
38;2021-04-05;2173;338;171259;61658;13.5;4.9
38;2021-04-06;4346;2394;175605;64052;13.9;5.1
38;2021-04-07;4413;2728;180018;66780;14.2;5.3
38;2021-04-08;5644;2663;185662;69443;14.7;5.5
38;2021-04-09;8555;2717;194217;72160;15.4;5.7
38;2021-04-10;3599;1468;197816;73628;15.6;5.8
38;2021-04-11;1046;100;198862;73728;15.7;5.8
38;2021-04-12;4195;2253;203057;75981;16.1;6.0
38;2021-04-13;6122;2466;209179;78447;16.5;6.2
38;2021-04-14;5115;2458;214294;80905;16.9;6.4
38;2021-04-15;6361;2750;220655;83655;17.4;6.6
38;2021-04-16;6215;2724;226870;86379;17.9;6.8
38;2021-04-17;2587;988;229457;87367;18.1;6.9
38;2021-04-18;1333;72;230790;87439;18.2;6.9
38;2021-04-19;3943;2812;234733;90251;18.6;7.1
38;2021-04-20;5418;2838;240151;93089;19.0;7.4
38;2021-04-21;4979;2698;245130;95787;19.4;7.6
38;2021-04-22;5776;2820;250906;98607;19.8;7.8
38;2021-04-23;6031;2801;256937;101408;20.3;8.0
38;2021-04-24;2662;1345;259599;102753;20.5;8.1
38;2021-04-25;804;592;260403;103345;20.6;8.2
38;2021-04-26;4482;2472;264885;105817;20.9;8.4
38;2021-04-27;6042;2733;270927;108550;21.4;8.6
38;2021-04-28;6192;2509;277119;111059;21.9;8.8
38;2021-04-29;8327;3070;285446;114129;22.6;9.0
38;2021-04-30;7672;4057;293118;118186;23.2;9.3
38;2021-05-01;1541;198;294659;118384;23.3;9.4
38;2021-05-02;842;71;295501;118455;23.4;9.4
38;2021-05-03;5294;3573;300795;122028;23.8;9.6
38;2021-05-04;6187;5053;306982;127081;24.3;10.0
38;2021-05-05;6062;4581;313044;131662;24.7;10.4
38;2021-05-06;6713;5283;319757;136945;25.3;10.8
38;2021-05-07;7268;6426;327025;143371;25.9;11.3
38;2021-05-08;3739;711;330764;144082;26.1;11.4
38;2021-05-09;2848;1928;333612;146010;26.4;11.5
38;2021-05-10;6150;5279;339762;151289;26.9;12.0
38;2021-05-11;8220;6003;347982;157292;27.5;12.4
38;2021-05-12;9048;4675;357030;161967;28.2;12.8
38;2021-05-13;6634;1409;363664;163376;28.7;12.9
38;2021-05-14;9559;3408;373223;166784;29.5;13.2
38;2021-05-15;6851;1455;380074;168239;30.0;13.3
38;2021-05-16;5474;652;385548;168891;30.5;13.4
38;2021-05-17;7666;2977;393214;171868;31.1;13.6
38;2021-05-18;8619;4006;401833;175874;31.8;13.9
38;2021-05-19;8149;3337;409982;179211;32.4;14.2
38;2021-05-20;8974;4478;418956;183689;33.1;14.5
38;2021-05-21;9954;4587;428910;188276;33.9;14.9
38;2021-05-22;7449;1903;436359;190179;34.5;15.0
38;2021-05-23;5584;578;441943;190757;34.9;15.1
38;2021-05-24;7496;1616;449439;192373;35.5;15.2
38;2021-05-25;9540;4839;458979;197212;36.3;15.6
38;2021-05-26;8105;4711;467084;201923;36.9;16.0
38;2021-05-27;9126;5635;476210;207558;37.6;16.4
38;2021-05-28;8784;6481;484994;214039;38.3;16.9
38;2021-05-29;5816;3258;490810;217297;38.8;17.2
38;2021-05-30;2691;1594;493501;218891;39.0;17.3
38;2021-05-31;8269;5116;501770;224007;39.7;17.7
38;2021-06-01;7962;6410;509732;230417;40.3;18.2
38;2021-06-02;7140;5606;516872;236023;40.9;18.7
38;2021-06-03;7394;6823;524266;242846;41.4;19.2
38;2021-06-04;8117;7602;532383;250448;42.1;19.8
38;2021-06-05;5794;3942;538177;254390;42.5;20.1
38;2021-06-06;2507;1460;540684;255850;42.7;20.2
38;2021-06-07;5553;6851;546237;262701;43.2;20.8
38;2021-06-08;5876;7528;552113;270229;43.6;21.4
38;2021-06-09;5045;6461;557158;276690;44.0;21.9
38;2021-06-10;5425;6783;562583;283473;44.5;22.4
38;2021-06-11;5882;7783;568465;291256;44.9;23.0
38;2021-06-12;3950;3257;572415;294513;45.3;23.3
38;2021-06-13;1254;1301;573669;295814;45.4;23.4
38;2021-06-14;3872;7667;577541;303481;45.7;24.0
38;2021-06-15;5241;8142;582782;311623;46.1;24.6
38;2021-06-16;5126;7397;587908;319020;46.5;25.2
38;2021-06-17;4520;7060;592428;326080;46.8;25.8
38;2021-06-18;6040;9213;598468;335293;47.3;26.5
38;2021-06-19;3595;4963;602063;340256;47.6;26.9
38;2021-06-20;1039;2901;603102;343157;47.7;27.1
38;2021-06-21;3746;8696;606848;351853;48.0;27.8
38;2021-06-22;3791;10098;610639;361951;48.3;28.6
38;2021-06-23;3149;9551;613788;371502;48.5;29.4
38;2021-06-24;3375;8590;617163;380092;48.8;30.0
38;2021-06-25;3772;11489;620935;391581;49.1;31.0
38;2021-06-26;2225;7852;623160;399433;49.3;31.6
38;2021-06-27;1096;4355;624256;403788;49.3;31.9
38;2021-06-28;2946;10302;627202;414090;49.6;32.7
38;2021-06-29;3775;10433;630977;424523;49.9;33.6
38;2021-06-30;4049;9936;635026;434459;50.2;34.3
38;2021-07-01;3484;9009;638510;443468;50.5;35.1
38;2021-07-02;3650;11603;642160;455071;50.8;36.0
38;2021-07-03;1729;8789;643889;463860;50.9;36.7
38;2021-07-04;1243;3202;645132;467062;51.0;36.9
38;2021-07-05;2852;10543;647984;477605;51.2;37.8
38;2021-07-06;3408;10231;651392;487836;51.5;38.6
38;2021-07-07;3454;9394;654846;497230;51.8;39.3
38;2021-07-08;3474;8222;658320;505452;52.0;40.0
38;2021-07-09;3602;10742;661922;516194;52.3;40.8
38;2021-07-10;2389;7789;664311;523983;52.5;41.4
38;2021-07-11;772;2022;665083;526005;52.6;41.6
38;2021-07-12;3371;10665;668454;536670;52.8;42.4
38;2021-07-13;6507;10914;674961;547584;53.4;43.3
38;2021-07-14;4568;3327;679529;550911;53.7;43.6
38;2021-07-15;8612;9660;688141;560571;54.4;44.3
38;2021-07-16;8671;10693;696812;571264;55.1;45.2
38;2021-07-17;4659;7469;701471;578733;55.5;45.8
38;2021-07-18;2553;2484;704024;581217;55.7;45.9
38;2021-07-19;5769;9207;709793;590424;56.1;46.7
38;2021-07-20;6180;8287;715973;598711;56.6;47.3
38;2021-07-21;7801;8014;723774;606725;57.2;48.0
38;2021-07-22;7517;6980;731291;613705;57.8;48.5
38;2021-07-23;8859;9004;740150;622709;58.5;49.2
38;2021-07-24;5529;5519;745679;628228;58.9;49.7
38;2021-07-25;2812;1647;748491;629875;59.2;49.8
38;2021-07-26;7763;7478;756254;637353;59.8;50.4
38;2021-07-27;7503;6243;763757;643596;60.4;50.9
38;2021-07-28;8503;5671;772260;649267;61.0;51.3
38;2021-07-29;7591;4653;779851;653920;61.6;51.7
38;2021-07-30;7656;6613;787507;660533;62.3;52.2
38;2021-07-31;4269;3569;791776;664102;62.6;52.5
38;2021-08-01;1246;1077;793022;665179;62.7;52.6
38;2021-08-02;3878;4429;796900;669608;63.0;52.9
38;2021-08-03;4524;4533;801424;674141;63.4;53.3
38;2021-08-04;4567;4322;805991;678463;63.7;53.6
38;2021-08-05;3636;4601;809627;683064;64.0;54.0
39;2020-12-27;0;0;0;0;0.0;0.0
39;2020-12-28;0;0;0;0;0.0;0.0
39;2020-12-29;0;0;0;0;0.0;0.0
39;2020-12-30;0;0;0;0;0.0;0.0
39;2020-12-31;0;0;0;0;0.0;0.0
39;2021-01-01;0;0;0;0;0.0;0.0
39;2021-01-02;0;0;0;0;0.0;0.0
39;2021-01-03;0;0;0;0;0.0;0.0
39;2021-01-04;3;0;3;0;0.0;0.0
39;2021-01-05;3;0;6;0;0.0;0.0
39;2021-01-06;57;3;63;3;0.0;0.0
39;2021-01-07;331;2;394;5;0.2;0.0
39;2021-01-08;657;2;1051;7;0.4;0.0
39;2021-01-09;169;0;1220;7;0.5;0.0
39;2021-01-10;1;0;1221;7;0.5;0.0
39;2021-01-11;476;1;1697;8;0.7;0.0
39;2021-01-12;431;1;2128;9;0.8;0.0
39;2021-01-13;408;2;2536;11;1.0;0.0
39;2021-01-14;574;3;3110;14;1.2;0.0
39;2021-01-15;470;1;3580;15;1.4;0.0
39;2021-01-16;141;1;3721;16;1.4;0.0
39;2021-01-17;0;1;3721;17;1.4;0.0
39;2021-01-18;924;7;4645;24;1.8;0.0
39;2021-01-19;1181;7;5826;31;2.3;0.0
39;2021-01-20;905;4;6731;35;2.6;0.0
39;2021-01-21;1177;2;7908;37;3.1;0.0
39;2021-01-22;985;1;8893;38;3.4;0.0
39;2021-01-23;382;1;9275;39;3.6;0.0
39;2021-01-24;0;0;9275;39;3.6;0.0
39;2021-01-25;642;2;9917;41;3.8;0.0
39;2021-01-26;1120;12;11037;53;4.3;0.0
39;2021-01-27;925;17;11962;70;4.6;0.0
39;2021-01-28;741;244;12703;314;4.9;0.1
39;2021-01-29;582;423;13285;737;5.2;0.3
39;2021-01-30;265;109;13550;846;5.3;0.3
39;2021-01-31;1;0;13551;846;5.3;0.3
39;2021-02-01;562;262;14113;1108;5.5;0.4
39;2021-02-02;753;322;14866;1430;5.8;0.6
39;2021-02-03;531;516;15397;1946;6.0;0.8
39;2021-02-04;553;462;15950;2408;6.2;0.9
39;2021-02-05;438;431;16388;2839;6.4;1.1
39;2021-02-06;265;110;16653;2949;6.5;1.1
39;2021-02-07;0;1;16653;2950;6.5;1.1
39;2021-02-08;320;372;16973;3322;6.6;1.3
39;2021-02-09;383;485;17356;3807;6.7;1.5
39;2021-02-10;250;338;17606;4145;6.8;1.6
39;2021-02-11;586;510;18192;4655;7.1;1.8
39;2021-02-12;386;417;18578;5072;7.2;2.0
39;2021-02-13;99;69;18677;5141;7.2;2.0
39;2021-02-14;0;0;18677;5141;7.2;2.0
39;2021-02-15;99;758;18776;5899;7.3;2.3
39;2021-02-16;99;912;18875;6811;7.3;2.6
39;2021-02-17;58;695;18933;7506;7.3;2.9
39;2021-02-18;109;858;19042;8364;7.4;3.2
39;2021-02-19;100;486;19142;8850;7.4;3.4
39;2021-02-20;18;364;19160;9214;7.4;3.6
39;2021-02-21;0;0;19160;9214;7.4;3.6
39;2021-02-22;100;729;19260;9943;7.5;3.9
39;2021-02-23;4;764;19264;10707;7.5;4.2
39;2021-02-24;125;872;19389;11579;7.5;4.5
39;2021-02-25;213;751;19602;12330;7.6;4.8
39;2021-02-26;218;468;19820;12798;7.7;5.0
39;2021-02-27;169;297;19989;13095;7.8;5.1
39;2021-02-28;1;0;19990;13095;7.8;5.1
39;2021-03-01;218;639;20208;13734;7.8;5.3
39;2021-03-02;328;825;20536;14559;8.0;5.6
39;2021-03-03;600;524;21136;15083;8.2;5.8
39;2021-03-04;657;474;21793;15557;8.5;6.0
39;2021-03-05;670;328;22463;15885;8.7;6.2
39;2021-03-06;777;244;23240;16129;9.0;6.3
39;2021-03-07;242;81;23482;16210;9.1;6.3
39;2021-03-08;286;441;23768;16651;9.2;6.5
39;2021-03-09;843;455;24611;17106;9.5;6.6
39;2021-03-10;985;334;25596;17440;9.9;6.8
39;2021-03-11;828;460;26424;17900;10.2;6.9
39;2021-03-12;807;288;27231;18188;10.6;7.1
39;2021-03-13;788;103;28019;18291;10.9;7.1
39;2021-03-14;35;10;28054;18301;10.9;7.1
39;2021-03-15;512;92;28566;18393;11.1;7.1
39;2021-03-16;555;66;29121;18459;11.3;7.2
39;2021-03-17;612;54;29733;18513;11.5;7.2
39;2021-03-18;595;68;30328;18581;11.8;7.2
39;2021-03-19;393;71;30721;18652;11.9;7.2
39;2021-03-20;311;10;31032;18662;12.0;7.2
39;2021-03-21;3;0;31035;18662;12.0;7.2
39;2021-03-22;754;114;31789;18776;12.3;7.3
39;2021-03-23;1130;42;32919;18818;12.8;7.3
39;2021-03-24;1178;91;34097;18909;13.2;7.3
39;2021-03-25;2041;122;36138;19031;14.0;7.4
39;2021-03-26;797;110;36935;19141;14.3;7.4
39;2021-03-27;345;4;37280;19145;14.5;7.4
39;2021-03-28;36;4;37316;19149;14.5;7.4
39;2021-03-29;1036;191;38352;19340;14.9;7.5
39;2021-03-30;1399;264;39751;19604;15.4;7.6
39;2021-03-31;658;518;40409;20122;15.7;7.8
39;2021-04-01;1310;307;41719;20429;16.2;7.9
39;2021-04-02;626;131;42345;20560;16.4;8.0
39;2021-04-03;180;7;42525;20567;16.5;8.0
39;2021-04-04;4;1;42529;20568;16.5;8.0
39;2021-04-05;1;0;42530;20568;16.5;8.0
39;2021-04-06;824;630;43354;21198;16.8;8.2
39;2021-04-07;1131;677;44485;21875;17.3;8.5
39;2021-04-08;1790;570;46275;22445;17.9;8.7
39;2021-04-09;1676;289;47951;22734;18.6;8.8
39;2021-04-10;345;182;48296;22916;18.7;8.9
39;2021-04-11;2;0;48298;22916;18.7;8.9
39;2021-04-12;679;393;48977;23309;19.0;9.0
39;2021-04-13;1202;579;50179;23888;19.5;9.3
39;2021-04-14;845;636;51024;24524;19.8;9.5
39;2021-04-15;1481;711;52505;25235;20.4;9.8
39;2021-04-16;1090;173;53595;25408;20.8;9.9
39;2021-04-17;197;58;53792;25466;20.9;9.9
39;2021-04-18;0;0;53792;25466;20.9;9.9
39;2021-04-19;524;699;54316;26165;21.1;10.1
39;2021-04-20;765;541;55081;26706;21.4;10.4
39;2021-04-21;1142;718;56223;27424;21.8;10.6
39;2021-04-22;1012;1131;57235;28555;22.2;11.1
39;2021-04-23;457;358;57692;28913;22.4;11.2
39;2021-04-24;275;149;57967;29062;22.5;11.3
39;2021-04-25;12;2;57979;29064;22.5;11.3
39;2021-04-26;569;1036;58548;30100;22.7;11.7
39;2021-04-27;788;981;59336;31081;23.0;12.1
39;2021-04-28;1719;416;61055;31497;23.7;12.2
39;2021-04-29;2571;967;63626;32464;24.7;12.6
39;2021-04-30;2474;388;66100;32852;25.6;12.7
39;2021-05-01;41;53;66141;32905;25.7;12.8
39;2021-05-02;0;0;66141;32905;25.7;12.8
39;2021-05-03;917;805;67058;33710;26.0;13.1
39;2021-05-04;949;1128;68007;34838;26.4;13.5
39;2021-05-05;1952;888;69959;35726;27.1;13.9
39;2021-05-06;2424;1337;72383;37063;28.1;14.4
39;2021-05-07;1286;571;73669;37634;28.6;14.6
39;2021-05-08;179;55;73848;37689;28.6;14.6
39;2021-05-09;10;8;73858;37697;28.6;14.6
39;2021-05-10;1762;845;75620;38542;29.3;14.9
39;2021-05-11;1773;1512;77393;40054;30.0;15.5
39;2021-05-12;1800;1486;79193;41540;30.7;16.1
39;2021-05-13;246;23;79439;41563;30.8;16.1
39;2021-05-14;2392;328;81831;41891;31.7;16.2
39;2021-05-15;1848;257;83679;42148;32.5;16.3
39;2021-05-16;0;0;83679;42148;32.5;16.3
39;2021-05-17;1988;724;85667;42872;33.2;16.6
39;2021-05-18;1691;1182;87358;44054;33.9;17.1
39;2021-05-19;2496;555;89854;44609;34.8;17.3
39;2021-05-20;2467;753;92321;45362;35.8;17.6
39;2021-05-21;1799;563;94120;45925;36.5;17.8
39;2021-05-22;322;220;94442;46145;36.6;17.9
39;2021-05-23;7;36;94449;46181;36.6;17.9
39;2021-05-24;8;28;94457;46209;36.6;17.9
39;2021-05-25;1726;1197;96183;47406;37.3;18.4
39;2021-05-26;1642;1375;97825;48781;37.9;18.9
39;2021-05-27;1487;1621;99312;50402;38.5;19.5
39;2021-05-28;856;1217;100168;51619;38.8;20.0
39;2021-05-29;261;274;100429;51893;38.9;20.1
39;2021-05-30;2;40;100431;51933;38.9;20.1
39;2021-05-31;1626;1246;102057;53179;39.6;20.6
39;2021-06-01;1894;1318;103951;54497;40.3;21.1
39;2021-06-02;1705;1175;105656;55672;41.0;21.6
39;2021-06-03;1326;1159;106982;56831;41.5;22.0
39;2021-06-04;942;1069;107924;57900;41.9;22.5
39;2021-06-05;766;516;108690;58416;42.2;22.7
39;2021-06-06;1;36;108691;58452;42.2;22.7
39;2021-06-07;2105;913;110796;59365;43.0;23.0
39;2021-06-08;2211;1155;113007;60520;43.8;23.5
39;2021-06-09;1732;1244;114739;61764;44.5;24.0
39;2021-06-10;1617;2081;116356;63845;45.1;24.8
39;2021-06-11;1568;1271;117924;65116;45.7;25.3
39;2021-06-12;1263;347;119187;65463;46.2;25.4
39;2021-06-13;10;18;119197;65481;46.2;25.4
39;2021-06-14;1335;1894;120532;67375;46.7;26.1
39;2021-06-15;1383;1253;121915;68628;47.3;26.6
39;2021-06-16;1171;1539;123086;70167;47.7;27.2
39;2021-06-17;1044;1716;124130;71883;48.1;27.9
39;2021-06-18;1637;1178;125767;73061;48.8;28.3
39;2021-06-19;249;412;126016;73473;48.9;28.5
39;2021-06-20;2;18;126018;73491;48.9;28.5
39;2021-06-21;350;2494;126368;75985;49.0;29.5
39;2021-06-22;810;2289;127178;78274;49.3;30.4
39;2021-06-23;1199;1301;128377;79575;49.8;30.9
39;2021-06-24;738;1047;129115;80622;50.1;31.3
39;2021-06-25;681;2961;129796;83583;50.3;32.4
39;2021-06-26;204;1565;130000;85148;50.4;33.0
39;2021-06-27;0;0;130000;85148;50.4;33.0
39;2021-06-28;304;2745;130304;87893;50.5;34.1
39;2021-06-29;498;2696;130802;90589;50.7;35.1
39;2021-06-30;894;2419;131696;93008;51.1;36.1
39;2021-07-01;644;1936;132340;94944;51.3;36.8
39;2021-07-02;1111;1404;133451;96348;51.8;37.4
39;2021-07-03;549;523;134000;96871;52.0;37.6
39;2021-07-04;1;2;134001;96873;52.0;37.6
39;2021-07-05;598;2590;134599;99463;52.2;38.6
39;2021-07-06;836;1884;135435;101347;52.5;39.3
39;2021-07-07;586;1389;136021;102736;52.8;39.8
39;2021-07-08;695;906;136716;103642;53.0;40.2
39;2021-07-09;1078;1586;137794;105228;53.4;40.8
39;2021-07-10;738;476;138532;105704;53.7;41.0
39;2021-07-11;28;8;138560;105712;53.7;41.0
39;2021-07-12;562;2596;139122;108308;54.0;42.0
39;2021-07-13;1627;2652;140749;110960;54.6;43.0
39;2021-07-14;12;20;140761;110980;54.6;43.0
39;2021-07-15;1893;1836;142654;112816;55.3;43.8
39;2021-07-16;3215;2029;145869;114845;56.6;44.5
39;2021-07-17;2218;1149;148087;115994;57.4;45.0
39;2021-07-18;164;52;148251;116046;57.5;45.0
39;2021-07-19;1393;2954;149644;119000;58.0;46.2
39;2021-07-20;1832;2810;151476;121810;58.7;47.2
39;2021-07-21;2581;2577;154057;124387;59.7;48.2
39;2021-07-22;1934;1834;155991;126221;60.5;49.0
39;2021-07-23;1806;1921;157797;128142;61.2;49.7
39;2021-07-24;1397;1426;159194;129568;61.7;50.2
39;2021-07-25;0;1;159194;129569;61.7;50.2
39;2021-07-26;1318;1995;160512;131564;62.3;51.0
39;2021-07-27;2326;1893;162838;133457;63.2;51.8
39;2021-07-28;2680;1472;165518;134929;64.2;52.3
39;2021-07-29;2186;1739;167704;136668;65.0;53.0
39;2021-07-30;2029;1451;169733;138119;65.8;53.6
39;2021-07-31;1363;653;171096;138772;66.4;53.8
39;2021-08-01;9;18;171105;138790;66.4;53.8
39;2021-08-02;1204;1395;172309;140185;66.8;54.4
39;2021-08-03;1901;1477;174210;141662;67.6;54.9
39;2021-08-04;1034;656;175244;142318;68.0;55.2
39;2021-08-05;1228;725;176472;143043;68.4;55.5
40;2020-12-27;0;0;0;0;0.0;0.0
40;2020-12-28;0;0;0;0;0.0;0.0
40;2020-12-29;0;0;0;0;0.0;0.0
40;2020-12-30;0;0;0;0;0.0;0.0
40;2020-12-31;0;0;0;0;0.0;0.0
40;2021-01-01;0;0;0;0;0.0;0.0
40;2021-01-02;0;0;0;0;0.0;0.0
40;2021-01-03;0;0;0;0;0.0;0.0
40;2021-01-04;0;0;0;0;0.0;0.0
40;2021-01-05;0;0;0;0;0.0;0.0
40;2021-01-06;1;0;1;0;0.0;0.0
40;2021-01-07;212;0;213;0;0.1;0.0
40;2021-01-08;392;2;605;2;0.1;0.0
40;2021-01-09;0;0;605;2;0.1;0.0
40;2021-01-10;1;0;606;2;0.1;0.0
40;2021-01-11;111;0;717;2;0.2;0.0
40;2021-01-12;0;0;717;2;0.2;0.0
40;2021-01-13;681;0;1398;2;0.3;0.0
40;2021-01-14;901;5;2299;7;0.6;0.0
40;2021-01-15;810;2;3109;9;0.8;0.0
40;2021-01-16;157;0;3266;9;0.8;0.0
40;2021-01-17;1;1;3267;10;0.8;0.0
40;2021-01-18;402;0;3669;10;0.9;0.0
40;2021-01-19;1204;2;4873;12;1.2;0.0
40;2021-01-20;879;2;5752;14;1.4;0.0
40;2021-01-21;1265;3;7017;17;1.7;0.0
40;2021-01-22;809;2;7826;19;1.9;0.0
40;2021-01-23;288;0;8114;19;2.0;0.0
40;2021-01-24;2;0;8116;19;2.0;0.0
40;2021-01-25;393;1;8509;20;2.1;0.0
40;2021-01-26;803;6;9312;26;2.3;0.0
40;2021-01-27;1118;12;10430;38;2.5;0.0
40;2021-01-28;704;116;11134;154;2.7;0.0
40;2021-01-29;600;228;11734;382;2.8;0.1
40;2021-01-30;235;3;11969;385;2.9;0.1
40;2021-01-31;1;0;11970;385;2.9;0.1
40;2021-02-01;358;132;12328;517;3.0;0.1
40;2021-02-02;923;52;13251;569;3.2;0.1
40;2021-02-03;892;298;14143;867;3.4;0.2
40;2021-02-04;1058;602;15201;1469;3.7;0.4
40;2021-02-05;793;421;15994;1890;3.9;0.5
40;2021-02-06;379;84;16373;1974;4.0;0.5
40;2021-02-07;10;0;16383;1974;4.0;0.5
40;2021-02-08;371;122;16754;2096;4.1;0.5
40;2021-02-09;809;541;17563;2637;4.3;0.6
40;2021-02-10;748;470;18311;3107;4.4;0.8
40;2021-02-11;739;685;19050;3792;4.6;0.9
40;2021-02-12;628;643;19678;4435;4.8;1.1
40;2021-02-13;400;94;20078;4529;4.9;1.1
40;2021-02-14;0;0;20078;4529;4.9;1.1
40;2021-02-15;48;386;20126;4915;4.9;1.2
40;2021-02-16;285;600;20411;5515;5.0;1.3
40;2021-02-17;360;895;20771;6410;5.0;1.6
40;2021-02-18;382;696;21153;7106;5.1;1.7
40;2021-02-19;144;645;21297;7751;5.2;1.9
40;2021-02-20;39;95;21336;7846;5.2;1.9
40;2021-02-21;1;66;21337;7912;5.2;1.9
40;2021-02-22;53;565;21390;8477;5.2;2.1
40;2021-02-23;179;835;21569;9312;5.2;2.3
40;2021-02-24;282;687;21851;9999;5.3;2.4
40;2021-02-25;726;992;22577;10991;5.5;2.7
40;2021-02-26;655;635;23232;11626;5.6;2.8
40;2021-02-27;384;101;23616;11727;5.7;2.8
40;2021-02-28;2;0;23618;11727;5.7;2.8
40;2021-03-01;418;507;24036;12234;5.8;3.0
40;2021-03-02;734;1043;24770;13277;6.0;3.2
40;2021-03-03;933;911;25703;14188;6.2;3.4
40;2021-03-04;1312;822;27015;15010;6.6;3.6
40;2021-03-05;1230;744;28245;15754;6.9;3.8
40;2021-03-06;864;391;29109;16145;7.1;3.9
40;2021-03-07;90;9;29199;16154;7.1;3.9
40;2021-03-08;838;500;30037;16654;7.3;4.0
40;2021-03-09;1505;642;31542;17296;7.7;4.2
40;2021-03-10;1747;704;33289;18000;8.1;4.4
40;2021-03-11;1984;694;35273;18694;8.6;4.5
40;2021-03-12;2048;549;37321;19243;9.1;4.7
40;2021-03-13;970;252;38291;19495;9.3;4.7
40;2021-03-14;98;0;38389;19495;9.3;4.7
40;2021-03-15;924;88;39313;19583;9.5;4.8
40;2021-03-16;986;268;40299;19851;9.8;4.8
40;2021-03-17;1576;345;41875;20196;10.2;4.9
40;2021-03-18;1560;334;43435;20530;10.5;5.0
40;2021-03-19;1806;146;45241;20676;11.0;5.0
40;2021-03-20;706;13;45947;20689;11.2;5.0
40;2021-03-21;52;1;45999;20690;11.2;5.0
40;2021-03-22;1173;35;47172;20725;11.5;5.0
40;2021-03-23;2323;165;49495;20890;12.0;5.1
40;2021-03-24;2323;228;51818;21118;12.6;5.1
40;2021-03-25;2765;375;54583;21493;13.2;5.2
40;2021-03-26;3120;208;57703;21701;14.0;5.3
40;2021-03-27;923;45;58626;21746;14.2;5.3
40;2021-03-28;178;47;58804;21793;14.3;5.3
40;2021-03-29;1152;381;59956;22174;14.6;5.4
40;2021-03-30;2298;383;62254;22557;15.1;5.5
40;2021-03-31;2002;298;64256;22855;15.6;5.5
40;2021-04-01;2408;326;66664;23181;16.2;5.6
40;2021-04-02;2361;216;69025;23397;16.8;5.7
40;2021-04-03;743;120;69768;23517;16.9;5.7
40;2021-04-04;362;8;70130;23525;17.0;5.7
40;2021-04-05;523;40;70653;23565;17.1;5.7
40;2021-04-06;2096;803;72749;24368;17.7;5.9
40;2021-04-07;2664;870;75413;25238;18.3;6.1
40;2021-04-08;3058;894;78471;26132;19.0;6.3
40;2021-04-09;3826;599;82297;26731;20.0;6.5
40;2021-04-10;1598;341;83895;27072;20.4;6.6
40;2021-04-11;51;5;83946;27077;20.4;6.6
40;2021-04-12;2176;730;86122;27807;20.9;6.7
40;2021-04-13;2568;1089;88690;28896;21.5;7.0
40;2021-04-14;2570;1374;91260;30270;22.2;7.3
40;2021-04-15;2982;1504;94242;31774;22.9;7.7
40;2021-04-16;2877;1187;97119;32961;23.6;8.0
40;2021-04-17;1464;347;98583;33308;23.9;8.1
40;2021-04-18;57;24;98640;33332;23.9;8.1
40;2021-04-19;1057;1019;99697;34351;24.2;8.3
40;2021-04-20;1622;1744;101319;36095;24.6;8.8
40;2021-04-21;1774;1739;103093;37834;25.0;9.2
40;2021-04-22;2113;1775;105206;39609;25.5;9.6
40;2021-04-23;2158;1392;107364;41001;26.1;10.0
40;2021-04-24;1327;621;108691;41622;26.4;10.1
40;2021-04-25;37;57;108728;41679;26.4;10.1
40;2021-04-26;1250;1137;109978;42816;26.7;10.4
40;2021-04-27;1484;2030;111462;44846;27.1;10.9
40;2021-04-28;2051;1368;113513;46214;27.6;11.2
40;2021-04-29;2607;1896;116120;48110;28.2;11.7
40;2021-04-30;2698;1614;118818;49724;28.8;12.1
40;2021-05-01;1228;779;120046;50503;29.1;12.3
40;2021-05-02;143;322;120189;50825;29.2;12.3
40;2021-05-03;1858;1499;122047;52324;29.6;12.7
40;2021-05-04;1883;2468;123930;54792;30.1;13.3
40;2021-05-05;2189;2670;126119;57462;30.6;13.9
40;2021-05-06;2235;2861;128354;60323;31.2;14.6
40;2021-05-07;1905;3004;130259;63327;31.6;15.4
40;2021-05-08;675;467;130934;63794;31.8;15.5
40;2021-05-09;316;21;131250;63815;31.9;15.5
40;2021-05-10;1399;2054;132649;65869;32.2;16.0
40;2021-05-11;2196;2511;134845;68380;32.7;16.6
40;2021-05-12;2731;1943;137576;70323;33.4;17.1
40;2021-05-13;1983;515;139559;70838;33.9;17.2
40;2021-05-14;2323;1654;141882;72492;34.4;17.6
40;2021-05-15;1340;963;143222;73455;34.8;17.8
40;2021-05-16;434;24;143656;73479;34.9;17.8
40;2021-05-17;2120;1313;145776;74792;35.4;18.2
40;2021-05-18;2509;1417;148285;76209;36.0;18.5
40;2021-05-19;2953;1103;151238;77312;36.7;18.8
40;2021-05-20;3584;1165;154822;78477;37.6;19.0
40;2021-05-21;2924;1331;157746;79808;38.3;19.4
40;2021-05-22;1146;795;158892;80603;38.6;19.6
40;2021-05-23;631;29;159523;80632;38.7;19.6
40;2021-05-24;1211;332;160734;80964;39.0;19.7
40;2021-05-25;2168;1304;162902;82268;39.5;20.0
40;2021-05-26;2615;1559;165517;83827;40.2;20.3
40;2021-05-27;2733;2009;168250;85836;40.8;20.8
40;2021-05-28;2569;2276;170819;88112;41.5;21.4
40;2021-05-29;1556;1253;172375;89365;41.8;21.7
40;2021-05-30;2;52;172377;89417;41.8;21.7
40;2021-05-31;2564;1207;174941;90624;42.5;22.0
40;2021-06-01;3010;1768;177951;92392;43.2;22.4
40;2021-06-02;3173;1986;181124;94378;44.0;22.9
40;2021-06-03;3592;2335;184716;96713;44.8;23.5
40;2021-06-04;3015;2804;187731;99517;45.6;24.2
40;2021-06-05;1779;1394;189510;100911;46.0;24.5
40;2021-06-06;459;78;189969;100989;46.1;24.5
40;2021-06-07;2184;2025;192153;103014;46.6;25.0
40;2021-06-08;2951;2101;195104;105115;47.4;25.5
40;2021-06-09;3214;2261;198318;107376;48.1;26.1
40;2021-06-10;2995;2092;201313;109468;48.9;26.6
40;2021-06-11;3139;2796;204452;112264;49.6;27.2
40;2021-06-12;1965;1636;206417;113900;50.1;27.6
40;2021-06-13;643;161;207060;114061;50.3;27.7
40;2021-06-14;1457;2498;208517;116559;50.6;28.3
40;2021-06-15;2234;2818;210751;119377;51.2;29.0
40;2021-06-16;2601;2453;213352;121830;51.8;29.6
40;2021-06-17;2430;2434;215782;124264;52.4;30.2
40;2021-06-18;2320;2905;218102;127169;52.9;30.9
40;2021-06-19;1798;1231;219900;128400;53.4;31.2
40;2021-06-20;344;275;220244;128675;53.5;31.2
40;2021-06-21;1390;2318;221634;130993;53.8;31.8
40;2021-06-22;1685;2994;223319;133987;54.2;32.5
40;2021-06-23;1607;3347;224926;137334;54.6;33.3
40;2021-06-24;1730;2380;226656;139714;55.0;33.9
40;2021-06-25;1758;3262;228414;142976;55.4;34.7
40;2021-06-26;1327;1710;229741;144686;55.8;35.1
40;2021-06-27;262;354;230003;145040;55.8;35.2
40;2021-06-28;1331;2819;231334;147859;56.2;35.9
40;2021-06-29;1705;3385;233039;151244;56.6;36.7
40;2021-06-30;1773;3637;234812;154881;57.0;37.6
40;2021-07-01;1709;3948;236521;158829;57.4;38.6
40;2021-07-02;1549;3810;238070;162639;57.8;39.5
40;2021-07-03;673;1922;238743;164561;58.0;39.9
40;2021-07-04;218;483;238961;165044;58.0;40.1
40;2021-07-05;1470;3020;240431;168064;58.4;40.8
40;2021-07-06;1753;3609;242184;171673;58.8;41.7
40;2021-07-07;1972;3845;244156;175518;59.3;42.6
40;2021-07-08;2093;3405;246249;178923;59.8;43.4
40;2021-07-09;1893;3945;248142;182868;60.2;44.4
40;2021-07-10;1003;2161;249145;185029;60.5;44.9
40;2021-07-11;205;294;249350;185323;60.5;45.0
40;2021-07-12;1304;4043;250654;189366;60.8;46.0
40;2021-07-13;2410;4693;253064;194059;61.4;47.1
40;2021-07-14;2181;2056;255245;196115;62.0;47.6
40;2021-07-15;2820;4856;258065;200971;62.6;48.8
40;2021-07-16;3293;3943;261358;204914;63.4;49.7
40;2021-07-17;2098;2589;263456;207503;63.9;50.4
40;2021-07-18;466;541;263922;208044;64.1;50.5
40;2021-07-19;2551;3702;266473;211746;64.7;51.4
40;2021-07-20;3028;4052;269501;215798;65.4;52.4
40;2021-07-21;3176;3872;272677;219670;66.2;53.3
40;2021-07-22;3822;3923;276499;223593;67.1;54.3
40;2021-07-23;4063;4104;280562;227697;68.1;55.3
40;2021-07-24;2773;2092;283335;229789;68.8;55.8
40;2021-07-25;946;487;284281;230276;69.0;55.9
40;2021-07-26;2919;3075;287200;233351;69.7;56.6
40;2021-07-27;3487;3600;290687;236951;70.6;57.5
40;2021-07-28;3357;3386;294044;240337;71.4;58.3
40;2021-07-29;3511;3421;297555;243758;72.2;59.2
40;2021-07-30;3105;3397;300660;247155;73.0;60.0
40;2021-07-31;1764;1909;302424;249064;73.4;60.5
40;2021-08-01;343;286;302767;249350;73.5;60.5
40;2021-08-02;1984;2375;304751;251725;74.0;61.1
40;2021-08-03;2318;2678;307069;254403;74.5;61.8
40;2021-08-04;2072;2309;309141;256712;75.0;62.3
40;2021-08-05;1934;2654;311075;259366;75.5;63.0
41;2020-12-27;0;0;0;0;0.0;0.0
41;2020-12-28;0;0;0;0;0.0;0.0
41;2020-12-29;0;0;0;0;0.0;0.0
41;2020-12-30;0;0;0;0;0.0;0.0
41;2020-12-31;0;0;0;0;0.0;0.0
41;2021-01-01;0;0;0;0;0.0;0.0
41;2021-01-02;2;0;2;0;0.0;0.0
41;2021-01-03;0;0;2;0;0.0;0.0
41;2021-01-04;0;0;2;0;0.0;0.0
41;2021-01-05;35;0;37;0;0.0;0.0
41;2021-01-06;72;0;109;0;0.0;0.0
41;2021-01-07;21;0;130;0;0.0;0.0
41;2021-01-08;1;0;131;0;0.0;0.0
41;2021-01-09;0;0;131;0;0.0;0.0
41;2021-01-10;0;0;131;0;0.0;0.0
41;2021-01-11;133;0;264;0;0.1;0.0
41;2021-01-12;321;1;585;1;0.2;0.0
41;2021-01-13;270;0;855;1;0.3;0.0
41;2021-01-14;283;1;1138;2;0.3;0.0
41;2021-01-15;215;1;1353;3;0.4;0.0
41;2021-01-16;0;0;1353;3;0.4;0.0
41;2021-01-17;0;0;1353;3;0.4;0.0
41;2021-01-18;397;2;1750;5;0.5;0.0
41;2021-01-19;857;0;2607;5;0.8;0.0
41;2021-01-20;1056;3;3663;8;1.1;0.0
41;2021-01-21;1567;1;5230;9;1.6;0.0
41;2021-01-22;835;0;6065;9;1.9;0.0
41;2021-01-23;92;0;6157;9;1.9;0.0
41;2021-01-24;0;0;6157;9;1.9;0.0
41;2021-01-25;421;1;6578;10;2.0;0.0
41;2021-01-26;473;0;7051;10;2.2;0.0
41;2021-01-27;441;1;7492;11;2.3;0.0
41;2021-01-28;604;56;8096;67;2.5;0.0
41;2021-01-29;258;30;8354;97;2.5;0.0
41;2021-01-30;0;0;8354;97;2.5;0.0
41;2021-01-31;0;0;8354;97;2.5;0.0
41;2021-02-01;350;147;8704;244;2.7;0.1
41;2021-02-02;471;231;9175;475;2.8;0.1
41;2021-02-03;341;202;9516;677;2.9;0.2
41;2021-02-04;559;154;10075;831;3.1;0.3
41;2021-02-05;329;191;10404;1022;3.2;0.3
41;2021-02-06;4;0;10408;1022;3.2;0.3
41;2021-02-07;2;0;10410;1022;3.2;0.3
41;2021-02-08;306;311;10716;1333;3.3;0.4
41;2021-02-09;598;453;11314;1786;3.5;0.5
41;2021-02-10;486;694;11800;2480;3.6;0.8
41;2021-02-11;1066;1157;12866;3637;3.9;1.1
41;2021-02-12;688;356;13554;3993;4.1;1.2
41;2021-02-13;9;5;13563;3998;4.1;1.2
41;2021-02-14;0;27;13563;4025;4.1;1.2
41;2021-02-15;314;307;13877;4332;4.2;1.3
41;2021-02-16;354;565;14231;4897;4.3;1.5
41;2021-02-17;318;460;14549;5357;4.4;1.6
41;2021-02-18;617;318;15166;5675;4.6;1.7
41;2021-02-19;455;336;15621;6011;4.8;1.8
41;2021-02-20;69;58;15690;6069;4.8;1.9
41;2021-02-21;0;0;15690;6069;4.8;1.9
41;2021-02-22;310;421;16000;6490;4.9;2.0
41;2021-02-23;454;351;16454;6841;5.0;2.1
41;2021-02-24;281;441;16735;7282;5.1;2.2
41;2021-02-25;674;457;17409;7739;5.3;2.4
41;2021-02-26;629;253;18038;7992;5.5;2.4
41;2021-02-27;161;4;18199;7996;5.6;2.4
41;2021-02-28;2;31;18201;8027;5.6;2.4
41;2021-03-01;310;311;18511;8338;5.6;2.5
41;2021-03-02;648;415;19159;8753;5.8;2.7
41;2021-03-03;497;411;19656;9164;6.0;2.8
41;2021-03-04;782;836;20438;10000;6.2;3.1
41;2021-03-05;838;672;21276;10672;6.5;3.3
41;2021-03-06;715;18;21991;10690;6.7;3.3
41;2021-03-07;498;16;22489;10706;6.9;3.3
41;2021-03-08;299;377;22788;11083;7.0;3.4
41;2021-03-09;1042;450;23830;11533;7.3;3.5
41;2021-03-10;721;455;24551;11988;7.5;3.7
41;2021-03-11;1181;678;25732;12666;7.8;3.9
41;2021-03-12;1114;410;26846;13076;8.2;4.0
41;2021-03-13;1222;14;28068;13090;8.6;4.0
41;2021-03-14;392;3;28460;13093;8.7;4.0
41;2021-03-15;797;350;29257;13443;8.9;4.1
41;2021-03-16;1060;408;30317;13851;9.2;4.2
41;2021-03-17;587;240;30904;14091;9.4;4.3
41;2021-03-18;925;400;31829;14491;9.7;4.4
41;2021-03-19;911;332;32740;14823;10.0;4.5
41;2021-03-20;539;17;33279;14840;10.2;4.5
41;2021-03-21;1;0;33280;14840;10.2;4.5
41;2021-03-22;809;269;34089;15109;10.4;4.6
41;2021-03-23;1309;490;35398;15599;10.8;4.8
41;2021-03-24;1231;365;36629;15964;11.2;4.9
41;2021-03-25;2026;436;38655;16400;11.8;5.0
41;2021-03-26;1655;322;40310;16722;12.3;5.1
41;2021-03-27;452;56;40762;16778;12.4;5.1
41;2021-03-28;1;0;40763;16778;12.4;5.1
41;2021-03-29;938;305;41701;17083;12.7;5.2
41;2021-03-30;1496;594;43197;17677;13.2;5.4
41;2021-03-31;1147;494;44344;18171;13.5;5.5
41;2021-04-01;2252;558;46596;18729;14.2;5.7
41;2021-04-02;1242;470;47838;19199;14.6;5.9
41;2021-04-03;321;5;48159;19204;14.7;5.9
41;2021-04-04;39;0;48198;19204;14.7;5.9
41;2021-04-05;140;2;48338;19206;14.7;5.9
41;2021-04-06;1299;621;49637;19827;15.1;6.0
41;2021-04-07;1851;700;51488;20527;15.7;6.3
41;2021-04-08;2290;918;53778;21445;16.4;6.5
41;2021-04-09;2567;605;56345;22050;17.2;6.7
41;2021-04-10;954;496;57299;22546;17.5;6.9
41;2021-04-11;278;376;57577;22922;17.6;7.0
41;2021-04-12;1688;646;59265;23568;18.1;7.2
41;2021-04-13;2262;979;61527;24547;18.8;7.5
41;2021-04-14;1793;546;63320;25093;19.3;7.7
41;2021-04-15;2384;967;65704;26060;20.0;7.9
41;2021-04-16;1931;619;67635;26679;20.6;8.1
41;2021-04-17;647;134;68282;26813;20.8;8.2
41;2021-04-18;5;0;68287;26813;20.8;8.2
41;2021-04-19;1262;743;69549;27556;21.2;8.4
41;2021-04-20;2004;1202;71553;28758;21.8;8.8
41;2021-04-21;1504;911;73057;29669;22.3;9.0
41;2021-04-22;2235;1591;75292;31260;23.0;9.5
41;2021-04-23;1735;1076;77027;32336;23.5;9.9
41;2021-04-24;1543;276;78570;32612;24.0;9.9
41;2021-04-25;1007;19;79577;32631;24.3;10.0
41;2021-04-26;1356;625;80933;33256;24.7;10.1
41;2021-04-27;2094;1038;83027;34294;25.3;10.5
41;2021-04-28;1561;854;84588;35148;25.8;10.7
41;2021-04-29;2212;1373;86800;36521;26.5;11.1
41;2021-04-30;1962;863;88762;37384;27.1;11.4
41;2021-05-01;189;12;88951;37396;27.1;11.4
41;2021-05-02;107;17;89058;37413;27.2;11.4
41;2021-05-03;1867;890;90925;38303;27.7;11.7
41;2021-05-04;2096;1540;93021;39843;28.4;12.2
41;2021-05-05;1881;1189;94902;41032;28.9;12.5
41;2021-05-06;2448;1696;97350;42728;29.7;13.0
41;2021-05-07;2019;1797;99369;44525;30.3;13.6
41;2021-05-08;203;152;99572;44677;30.4;13.6
41;2021-05-09;11;354;99583;45031;30.4;13.7
41;2021-05-10;1590;1557;101173;46588;30.9;14.2
41;2021-05-11;2090;2096;103263;48684;31.5;14.9
41;2021-05-12;1952;1675;105215;50359;32.1;15.4
41;2021-05-13;1485;945;106700;51304;32.5;15.6
41;2021-05-14;1577;1303;108277;52607;33.0;16.0
41;2021-05-15;206;294;108483;52901;33.1;16.1
41;2021-05-16;4;0;108487;52901;33.1;16.1
41;2021-05-17;2483;560;110970;53461;33.8;16.3
41;2021-05-18;3138;1024;114108;54485;34.8;16.6
41;2021-05-19;2554;670;116662;55155;35.6;16.8
41;2021-05-20;3349;1152;120011;56307;36.6;17.2
41;2021-05-21;2726;967;122737;57274;37.4;17.5
41;2021-05-22;396;236;123133;57510;37.6;17.5
41;2021-05-23;6;2;123139;57512;37.6;17.5
41;2021-05-24;2605;145;125744;57657;38.4;17.6
41;2021-05-25;2989;575;128733;58232;39.3;17.8
41;2021-05-26;3037;645;131770;58877;40.2;18.0
41;2021-05-27;3296;1109;135066;59986;41.2;18.3
41;2021-05-28;3143;980;138209;60966;42.2;18.6
41;2021-05-29;2075;427;140284;61393;42.8;18.7
41;2021-05-30;343;21;140627;61414;42.9;18.7
41;2021-05-31;1711;1505;142338;62919;43.4;19.2
41;2021-06-01;2262;2012;144600;64931;44.1;19.8
41;2021-06-02;1831;1289;146431;66220;44.7;20.2
41;2021-06-03;2597;1942;149028;68162;45.5;20.8
41;2021-06-04;2306;1962;151334;70124;46.2;21.4
41;2021-06-05;611;1582;151945;71706;46.3;21.9
41;2021-06-06;108;927;152053;72633;46.4;22.2
41;2021-06-07;1517;1532;153570;74165;46.8;22.6
41;2021-06-08;1712;2414;155282;76579;47.4;23.4
41;2021-06-09;1615;1642;156897;78221;47.9;23.9
41;2021-06-10;1917;1818;158814;80039;48.4;24.4
41;2021-06-11;1571;1796;160385;81835;48.9;25.0
41;2021-06-12;663;649;161048;82484;49.1;25.2
41;2021-06-13;12;77;161060;82561;49.1;25.2
41;2021-06-14;1269;1963;162329;84524;49.5;25.8
41;2021-06-15;1834;2761;164163;87285;50.1;26.6
41;2021-06-16;1725;2309;165888;89594;50.6;27.3
41;2021-06-17;1812;2577;167700;92171;51.2;28.1
41;2021-06-18;1666;2396;169366;94567;51.7;28.8
41;2021-06-19;412;531;169778;95098;51.8;29.0
41;2021-06-20;11;32;169789;95130;51.8;29.0
41;2021-06-21;1325;1780;171114;96910;52.2;29.6
41;2021-06-22;1618;2564;172732;99474;52.7;30.3
41;2021-06-23;1375;2046;174107;101520;53.1;31.0
41;2021-06-24;1483;2311;175590;103831;53.6;31.7
41;2021-06-25;1294;2613;176884;106444;54.0;32.5
41;2021-06-26;434;613;177318;107057;54.1;32.7
41;2021-06-27;1;4;177319;107061;54.1;32.7
41;2021-06-28;404;2698;177723;109759;54.2;33.5
41;2021-06-29;664;3441;178387;113200;54.4;34.5
41;2021-06-30;549;3070;178936;116270;54.6;35.5
41;2021-07-01;767;3107;179703;119377;54.8;36.4
41;2021-07-02;588;3499;180291;122876;55.0;37.5
41;2021-07-03;158;648;180449;123524;55.0;37.7
41;2021-07-04;1;2;180450;123526;55.0;37.7
41;2021-07-05;287;2821;180737;126347;55.1;38.5
41;2021-07-06;666;3636;181403;129983;55.3;39.6
41;2021-07-07;478;3140;181881;133123;55.5;40.6
41;2021-07-08;941;3374;182822;136497;55.8;41.6
41;2021-07-09;534;3645;183356;140142;55.9;42.7
41;2021-07-10;246;2086;183602;142228;56.0;43.4
41;2021-07-11;5;281;183607;142509;56.0;43.5
41;2021-07-12;858;2295;184465;144804;56.3;44.2
41;2021-07-13;1195;3286;185660;148090;56.6;45.2
41;2021-07-14;140;1081;185800;149171;56.7;45.5
41;2021-07-15;1330;3325;187130;152496;57.1;46.5
41;2021-07-16;1088;3398;188218;155894;57.4;47.6
41;2021-07-17;341;807;188559;156701;57.5;47.8
41;2021-07-18;24;32;188583;156733;57.5;47.8
41;2021-07-19;1188;2318;189771;159051;57.9;48.5
41;2021-07-20;1634;2742;191405;161793;58.4;49.4
41;2021-07-21;1701;2087;193106;163880;58.9;50.0
41;2021-07-22;2258;2303;195364;166183;59.6;50.7
41;2021-07-23;2094;2478;197458;168661;60.2;51.4
41;2021-07-24;327;842;197785;169503;60.3;51.7
41;2021-07-25;17;23;197802;169526;60.3;51.7
41;2021-07-26;1895;1676;199697;171202;60.9;52.2
41;2021-07-27;2529;2334;202226;173536;61.7;52.9
41;2021-07-28;2161;1826;204387;175362;62.3;53.5
41;2021-07-29;2336;2021;206723;177383;63.1;54.1
41;2021-07-30;2151;2081;208874;179464;63.7;54.7
41;2021-07-31;378;575;209252;180039;63.8;54.9
41;2021-08-01;17;7;209269;180046;63.8;54.9
41;2021-08-02;1544;1607;210813;181653;64.3;55.4
41;2021-08-03;2506;1852;213319;183505;65.1;56.0
41;2021-08-04;2293;1192;215612;184697;65.8;56.3
41;2021-08-05;3019;1253;218631;185950;66.7;56.7
42;2020-12-27;2;0;2;0;0.0;0.0
42;2020-12-28;0;0;2;0;0.0;0.0
42;2020-12-29;0;0;2;0;0.0;0.0
42;2020-12-30;0;0;2;0;0.0;0.0
42;2020-12-31;0;0;2;0;0.0;0.0
42;2021-01-01;0;0;2;0;0.0;0.0
42;2021-01-02;0;0;2;0;0.0;0.0
42;2021-01-03;0;0;2;0;0.0;0.0
42;2021-01-04;1;0;3;0;0.0;0.0
42;2021-01-05;1;0;4;0;0.0;0.0
42;2021-01-06;178;1;182;1;0.0;0.0
42;2021-01-07;256;0;438;1;0.1;0.0
42;2021-01-08;262;1;700;2;0.1;0.0
42;2021-01-09;136;0;836;2;0.1;0.0
42;2021-01-10;0;0;836;2;0.1;0.0
42;2021-01-11;293;2;1129;4;0.1;0.0
42;2021-01-12;412;1;1541;5;0.2;0.0
42;2021-01-13;527;2;2068;7;0.3;0.0
42;2021-01-14;771;4;2839;11;0.4;0.0
42;2021-01-15;703;4;3542;15;0.5;0.0
42;2021-01-16;298;1;3840;16;0.5;0.0
42;2021-01-17;219;0;4059;16;0.5;0.0
42;2021-01-18;968;1;5027;17;0.7;0.0
42;2021-01-19;1328;11;6355;28;0.8;0.0
42;2021-01-20;955;4;7310;32;1.0;0.0
42;2021-01-21;1002;5;8312;37;1.1;0.0
42;2021-01-22;991;4;9303;41;1.2;0.0
42;2021-01-23;401;0;9704;41;1.3;0.0
42;2021-01-24;358;0;10062;41;1.3;0.0
42;2021-01-25;1098;10;11160;51;1.5;0.0
42;2021-01-26;1744;19;12904;70;1.7;0.0
42;2021-01-27;1456;123;14360;193;1.9;0.0
42;2021-01-28;1663;141;16023;334;2.1;0.0
42;2021-01-29;945;117;16968;451;2.2;0.1
42;2021-01-30;257;113;17225;564;2.3;0.1
42;2021-01-31;258;2;17483;566;2.3;0.1
42;2021-02-01;729;62;18212;628;2.4;0.1
42;2021-02-02;1800;287;20012;915;2.6;0.1
42;2021-02-03;1515;485;21527;1400;2.8;0.2
42;2021-02-04;1282;613;22809;2013;3.0;0.3
42;2021-02-05;683;525;23492;2538;3.1;0.3
42;2021-02-06;303;149;23795;2687;3.1;0.4
42;2021-02-07;275;153;24070;2840;3.1;0.4
42;2021-02-08;508;627;24578;3467;3.2;0.5
42;2021-02-09;703;802;25281;4269;3.3;0.6
42;2021-02-10;739;690;26020;4959;3.4;0.6
42;2021-02-11;767;676;26787;5635;3.5;0.7
42;2021-02-12;675;754;27462;6389;3.6;0.8
42;2021-02-13;427;303;27889;6692;3.6;0.9
42;2021-02-14;186;229;28075;6921;3.7;0.9
42;2021-02-15;521;819;28596;7740;3.7;1.0
42;2021-02-16;488;1245;29084;8985;3.8;1.2
42;2021-02-17;518;1535;29602;10520;3.9;1.4
42;2021-02-18;754;1381;30356;11901;4.0;1.6
42;2021-02-19;767;1023;31123;12924;4.1;1.7
42;2021-02-20;248;411;31371;13335;4.1;1.7
42;2021-02-21;63;328;31434;13663;4.1;1.8
42;2021-02-22;575;967;32009;14630;4.2;1.9
42;2021-02-23;1200;1419;33209;16049;4.3;2.1
42;2021-02-24;1238;1221;34447;17270;4.5;2.3
42;2021-02-25;1666;1414;36113;18684;4.7;2.4
42;2021-02-26;1644;919;37757;19603;4.9;2.6
42;2021-02-27;580;294;38337;19897;5.0;2.6
42;2021-02-28;167;126;38504;20023;5.0;2.6
42;2021-03-01;812;847;39316;20870;5.1;2.7
42;2021-03-02;1274;812;40590;21682;5.3;2.8
42;2021-03-03;1366;795;41956;22477;5.5;2.9
42;2021-03-04;1704;701;43660;23178;5.7;3.0
42;2021-03-05;2627;653;46287;23831;6.1;3.1
42;2021-03-06;1932;254;48219;24085;6.3;3.1
42;2021-03-07;1492;84;49711;24169;6.5;3.2
42;2021-03-08;1404;504;51115;24673;6.7;3.2
42;2021-03-09;1984;445;53099;25118;6.9;3.3
42;2021-03-10;2053;485;55152;25603;7.2;3.3
42;2021-03-11;3047;591;58199;26194;7.6;3.4
42;2021-03-12;3006;817;61205;27011;8.0;3.5
42;2021-03-13;1479;351;62684;27362;8.2;3.6
42;2021-03-14;472;175;63156;27537;8.3;3.6
42;2021-03-15;1571;587;64727;28124;8.5;3.7
42;2021-03-16;1472;771;66199;28895;8.7;3.8
42;2021-03-17;1717;1063;67916;29958;8.9;3.9
42;2021-03-18;1804;1021;69720;30979;9.1;4.1
42;2021-03-19;2563;671;72283;31650;9.5;4.1
42;2021-03-20;1671;223;73954;31873;9.7;4.2
42;2021-03-21;528;95;74482;31968;9.7;4.2
42;2021-03-22;1430;732;75912;32700;9.9;4.3
42;2021-03-23;2506;843;78418;33543;10.3;4.4
42;2021-03-24;2782;775;81200;34318;10.6;4.5
42;2021-03-25;3720;927;84920;35245;11.1;4.6
42;2021-03-26;3759;775;88679;36020;11.6;4.7
42;2021-03-27;1805;436;90484;36456;11.8;4.8
42;2021-03-28;1040;204;91524;36660;12.0;4.8
42;2021-03-29;2062;915;93586;37575;12.2;4.9
42;2021-03-30;3144;850;96730;38425;12.6;5.0
42;2021-03-31;2441;1057;99171;39482;13.0;5.2
42;2021-04-01;3390;1034;102561;40516;13.4;5.3
42;2021-04-02;2849;1216;105410;41732;13.8;5.5
42;2021-04-03;1418;598;106828;42330;14.0;5.5
42;2021-04-04;1401;387;108229;42717;14.2;5.6
42;2021-04-05;1900;282;110129;42999;14.4;5.6
42;2021-04-06;2293;1400;112422;44399;14.7;5.8
42;2021-04-07;2755;1813;115177;46212;15.1;6.0
42;2021-04-08;4022;1582;119199;47794;15.6;6.2
42;2021-04-09;5126;1520;124325;49314;16.3;6.4
42;2021-04-10;2588;749;126913;50063;16.6;6.5
42;2021-04-11;1955;416;128868;50479;16.9;6.6
42;2021-04-12;3694;1538;132562;52017;17.3;6.8
42;2021-04-13;4658;1793;137220;53810;17.9;7.0
42;2021-04-14;4312;1889;141532;55699;18.5;7.3
42;2021-04-15;4804;1798;146336;57497;19.1;7.5
42;2021-04-16;4614;1868;150950;59365;19.7;7.8
42;2021-04-17;2979;1067;153929;60432;20.1;7.9
42;2021-04-18;1883;410;155812;60842;20.4;8.0
42;2021-04-19;3090;1525;158902;62367;20.8;8.2
42;2021-04-20;3466;1939;162368;64306;21.2;8.4
42;2021-04-21;3471;1738;165839;66044;21.7;8.6
42;2021-04-22;3767;1935;169606;67979;22.2;8.9
42;2021-04-23;3836;2000;173442;69979;22.7;9.2
42;2021-04-24;2357;1511;175799;71490;23.0;9.3
42;2021-04-25;1656;942;177455;72432;23.2;9.5
42;2021-04-26;3275;1722;180730;74154;23.6;9.7
42;2021-04-27;3256;2198;183986;76352;24.1;10.0
42;2021-04-28;3464;2614;187450;78966;24.5;10.3
42;2021-04-29;3770;2799;191220;81765;25.0;10.7
42;2021-04-30;3360;3029;194580;84794;25.4;11.1
42;2021-05-01;2969;1038;197549;85832;25.8;11.2
42;2021-05-02;1935;1256;199484;87088;26.1;11.4
42;2021-05-03;2872;2761;202356;89849;26.5;11.7
42;2021-05-04;3418;3121;205774;92970;26.9;12.2
42;2021-05-05;3331;3396;209105;96366;27.3;12.6
42;2021-05-06;3889;3757;212994;100123;27.9;13.1
42;2021-05-07;3731;4033;216725;104156;28.3;13.6
42;2021-05-08;3164;1062;219889;105218;28.8;13.8
42;2021-05-09;1506;2211;221395;107429;29.0;14.0
42;2021-05-10;3249;3824;224644;111253;29.4;14.5
42;2021-05-11;5580;3903;230224;115156;30.1;15.1
42;2021-05-12;5344;3563;235568;118719;30.8;15.5
42;2021-05-13;5455;1133;241023;119852;31.5;15.7
42;2021-05-14;5243;2922;246266;122774;32.2;16.1
42;2021-05-15;4880;2111;251146;124885;32.8;16.3
42;2021-05-16;2871;1036;254017;125921;33.2;16.5
42;2021-05-17;5887;2839;259904;128760;34.0;16.8
42;2021-05-18;6251;2980;266155;131740;34.8;17.2
42;2021-05-19;6525;2746;272680;134486;35.7;17.6
42;2021-05-20;7106;2889;279786;137375;36.6;18.0
42;2021-05-21;6352;3260;286138;140635;37.4;18.4
42;2021-05-22;5838;2120;291976;142755;38.2;18.7
42;2021-05-23;2833;871;294809;143626;38.6;18.8
42;2021-05-24;5250;1421;300059;145047;39.2;19.0
42;2021-05-25;5153;3946;305212;148993;39.9;19.5
42;2021-05-26;5155;3448;310367;152441;40.6;19.9
42;2021-05-27;5365;3630;315732;156071;41.3;20.4
42;2021-05-28;5039;4196;320771;160267;41.9;21.0
42;2021-05-29;4342;2985;325113;163252;42.5;21.3
42;2021-05-30;1981;1207;327094;164459;42.8;21.5
42;2021-05-31;4240;3425;331334;167884;43.3;22.0
42;2021-06-01;4591;3572;335925;171456;43.9;22.4
42;2021-06-02;4470;3009;340395;174465;44.5;22.8
42;2021-06-03;4925;3836;345320;178301;45.2;23.3
42;2021-06-04;4767;4217;350087;182518;45.8;23.9
42;2021-06-05;3687;2422;353774;184940;46.3;24.2
42;2021-06-06;1445;1293;355219;186233;46.4;24.4
42;2021-06-07;3988;3374;359207;189607;47.0;24.8
42;2021-06-08;3461;3238;362668;192845;47.4;25.2
42;2021-06-09;2958;3200;365626;196045;47.8;25.6
42;2021-06-10;3239;2929;368865;198974;48.2;26.0
42;2021-06-11;3587;4116;372452;203090;48.7;26.6
42;2021-06-12;2863;2880;375315;205970;49.1;26.9
42;2021-06-13;943;1276;376258;207246;49.2;27.1
42;2021-06-14;2307;4063;378565;211309;49.5;27.6
42;2021-06-15;2831;4069;381396;215378;49.9;28.2
42;2021-06-16;2923;3548;384319;218926;50.3;28.6
42;2021-06-17;2637;3740;386956;222666;50.6;29.1
42;2021-06-18;3089;5150;390045;227816;51.0;29.8
42;2021-06-19;2845;4244;392890;232060;51.4;30.3
42;2021-06-20;856;1842;393746;233902;51.5;30.6
42;2021-06-21;1905;6275;395651;240177;51.7;31.4
42;2021-06-22;1873;5897;397524;246074;52.0;32.2
42;2021-06-23;1840;5321;399364;251395;52.2;32.9
42;2021-06-24;1782;4678;401146;256073;52.5;33.5
42;2021-06-25;2027;6950;403173;263023;52.7;34.4
42;2021-06-26;1412;5818;404585;268841;52.9;35.2
42;2021-06-27;756;2852;405341;271693;53.0;35.5
42;2021-06-28;1740;7058;407081;278751;53.2;36.5
42;2021-06-29;1528;6561;408609;285312;53.4;37.3
42;2021-06-30;1965;5763;410574;291075;53.7;38.1
42;2021-07-01;1769;5117;412343;296192;53.9;38.7
42;2021-07-02;2044;6746;414387;302938;54.2;39.6
42;2021-07-03;1754;5972;416141;308910;54.4;40.4
42;2021-07-04;853;2509;416994;311419;54.5;40.7
42;2021-07-05;1710;6287;418704;317706;54.8;41.5
42;2021-07-06;2101;5572;420805;323278;55.0;42.3
42;2021-07-07;2323;4657;423128;327935;55.3;42.9
42;2021-07-08;2267;3960;425395;331895;55.6;43.4
42;2021-07-09;2372;6102;427767;337997;55.9;44.2
42;2021-07-10;1692;5585;429459;343582;56.2;44.9
42;2021-07-11;919;2295;430378;345877;56.3;45.2
42;2021-07-12;1766;6291;432144;352168;56.5;46.1
42;2021-07-13;3587;6282;435731;358450;57.0;46.9
42;2021-07-14;4467;2047;440198;360497;57.6;47.1
42;2021-07-15;4535;5614;444733;366111;58.2;47.9
42;2021-07-16;4329;6185;449062;372296;58.7;48.7
42;2021-07-17;3188;4696;452250;376992;59.1;49.3
42;2021-07-18;1829;1737;454079;378729;59.4;49.5
42;2021-07-19;3777;5057;457856;383786;59.9;50.2
42;2021-07-20;4684;4855;462540;388641;60.5;50.8
42;2021-07-21;5134;4699;467674;393340;61.2;51.4
42;2021-07-22;5470;3923;473144;397263;61.9;51.9
42;2021-07-23;5449;5086;478593;402349;62.6;52.6
42;2021-07-24;4004;3803;482597;406152;63.1;53.1
42;2021-07-25;1638;1377;484235;407529;63.3;53.3
42;2021-07-26;4693;4308;488928;411837;63.9;53.9
42;2021-07-27;5299;3940;494227;415777;64.6;54.4
42;2021-07-28;5750;3654;499977;419431;65.4;54.8
42;2021-07-29;5635;3409;505612;422840;66.1;55.3
42;2021-07-30;5098;3743;510710;426583;66.8;55.8
42;2021-07-31;4711;3028;515421;429611;67.4;56.2
42;2021-08-01;2474;1298;517895;430909;67.7;56.3
42;2021-08-02;4312;3081;522207;433990;68.3;56.8
42;2021-08-03;3793;3250;526000;437240;68.8;57.2
42;2021-08-04;3419;3195;529419;440435;69.2;57.6
42;2021-08-05;3363;3277;532782;443712;69.7;58.0
43;2020-12-27;0;0;0;0;0.0;0.0
43;2020-12-28;0;0;0;0;0.0;0.0
43;2020-12-29;0;0;0;0;0.0;0.0
43;2020-12-30;0;0;0;0;0.0;0.0
43;2020-12-31;0;0;0;0;0.0;0.0
43;2021-01-01;0;0;0;0;0.0;0.0
43;2021-01-02;0;0;0;0;0.0;0.0
43;2021-01-03;0;0;0;0;0.0;0.0
43;2021-01-04;1;0;1;0;0.0;0.0
43;2021-01-05;0;0;1;0;0.0;0.0
43;2021-01-06;0;0;1;0;0.0;0.0
43;2021-01-07;167;0;168;0;0.1;0.0
43;2021-01-08;151;1;319;1;0.1;0.0
43;2021-01-09;0;0;319;1;0.1;0.0
43;2021-01-10;0;0;319;1;0.1;0.0
43;2021-01-11;137;0;456;1;0.2;0.0
43;2021-01-12;244;1;700;2;0.3;0.0
43;2021-01-13;244;1;944;3;0.4;0.0
43;2021-01-14;293;2;1237;5;0.5;0.0
43;2021-01-15;303;2;1540;7;0.7;0.0
43;2021-01-16;32;0;1572;7;0.7;0.0
43;2021-01-17;0;0;1572;7;0.7;0.0
43;2021-01-18;760;5;2332;12;1.0;0.0
43;2021-01-19;776;6;3108;18;1.4;0.0
43;2021-01-20;517;0;3625;18;1.6;0.0
43;2021-01-21;446;2;4071;20;1.8;0.0
43;2021-01-22;465;8;4536;28;2.0;0.0
43;2021-01-23;1;0;4537;28;2.0;0.0
43;2021-01-24;1;0;4538;28;2.0;0.0
43;2021-01-25;539;0;5077;28;2.2;0.0
43;2021-01-26;616;4;5693;32;2.5;0.0
43;2021-01-27;740;0;6433;32;2.8;0.0
43;2021-01-28;747;32;7180;64;3.2;0.0
43;2021-01-29;719;84;7899;148;3.5;0.1
43;2021-01-30;109;0;8008;148;3.5;0.1
43;2021-01-31;0;0;8008;148;3.5;0.1
43;2021-02-01;404;100;8412;248;3.7;0.1
43;2021-02-02;711;151;9123;399;4.0;0.2
43;2021-02-03;691;43;9814;442;4.3;0.2
43;2021-02-04;523;172;10337;614;4.6;0.3
43;2021-02-05;543;173;10880;787;4.8;0.3
43;2021-02-06;164;19;11044;806;4.9;0.4
43;2021-02-07;0;0;11044;806;4.9;0.4
43;2021-02-08;411;304;11455;1110;5.0;0.5
43;2021-02-09;369;434;11824;1544;5.2;0.7
43;2021-02-10;399;361;12223;1905;5.4;0.8
43;2021-02-11;390;395;12613;2300;5.6;1.0
43;2021-02-12;426;202;13039;2502;5.7;1.1
43;2021-02-13;572;38;13611;2540;6.0;1.1
43;2021-02-14;0;0;13611;2540;6.0;1.1
43;2021-02-15;68;480;13679;3020;6.0;1.3
43;2021-02-16;41;375;13720;3395;6.0;1.5
43;2021-02-17;87;484;13807;3879;6.1;1.7
43;2021-02-18;147;379;13954;4258;6.1;1.9
43;2021-02-19;277;509;14231;4767;6.3;2.1
43;2021-02-20;22;4;14253;4771;6.3;2.1
43;2021-02-21;0;0;14253;4771;6.3;2.1
43;2021-02-22;16;503;14269;5274;6.3;2.3
43;2021-02-23;202;798;14471;6072;6.4;2.7
43;2021-02-24;147;714;14618;6786;6.4;3.0
43;2021-02-25;227;694;14845;7480;6.5;3.3
43;2021-02-26;222;671;15067;8151;6.6;3.6
43;2021-02-27;138;75;15205;8226;6.7;3.6
43;2021-02-28;1;0;15206;8226;6.7;3.6
43;2021-03-01;210;479;15416;8705;6.8;3.8
43;2021-03-02;342;582;15758;9287;6.9;4.1
43;2021-03-03;339;589;16097;9876;7.1;4.4
43;2021-03-04;551;459;16648;10335;7.3;4.6
43;2021-03-05;566;449;17214;10784;7.6;4.8
43;2021-03-06;489;178;17703;10962;7.8;4.8
43;2021-03-07;12;0;17715;10962;7.8;4.8
43;2021-03-08;445;443;18160;11405;8.0;5.0
43;2021-03-09;621;350;18781;11755;8.3;5.2
43;2021-03-10;673;492;19454;12247;8.6;5.4
43;2021-03-11;953;436;20407;12683;9.0;5.6
43;2021-03-12;945;421;21352;13104;9.4;5.8
43;2021-03-13;792;113;22144;13217;9.8;5.8
43;2021-03-14;2;0;22146;13217;9.8;5.8
43;2021-03-15;706;141;22852;13358;10.1;5.9
43;2021-03-16;847;278;23699;13636;10.4;6.0
43;2021-03-17;638;134;24337;13770;10.7;6.1
43;2021-03-18;675;130;25012;13900;11.0;6.1
43;2021-03-19;839;101;25851;14001;11.4;6.2
43;2021-03-20;450;60;26301;14061;11.6;6.2
43;2021-03-21;0;0;26301;14061;11.6;6.2
43;2021-03-22;744;37;27045;14098;11.9;6.2
43;2021-03-23;870;35;27915;14133;12.3;6.2
43;2021-03-24;1174;76;29089;14209;12.8;6.3
43;2021-03-25;1594;139;30683;14348;13.5;6.3
43;2021-03-26;1609;179;32292;14527;14.2;6.4
43;2021-03-27;1449;70;33741;14597;14.9;6.4
43;2021-03-28;420;20;34161;14617;15.1;6.4
43;2021-03-29;1094;166;35255;14783;15.5;6.5
43;2021-03-30;1312;232;36567;15015;16.1;6.6
43;2021-03-31;1305;246;37872;15261;16.7;6.7
43;2021-04-01;1345;335;39217;15596;17.3;6.9
43;2021-04-02;1051;349;40268;15945;17.7;7.0
43;2021-04-03;338;195;40606;16140;17.9;7.1
43;2021-04-04;0;0;40606;16140;17.9;7.1
43;2021-04-05;3;0;40609;16140;17.9;7.1
43;2021-04-06;689;604;41298;16744;18.2;7.4
43;2021-04-07;868;573;42166;17317;18.6;7.6
43;2021-04-08;1086;460;43252;17777;19.1;7.8
43;2021-04-09;1146;652;44398;18429;19.6;8.1
43;2021-04-10;625;260;45023;18689;19.8;8.2
43;2021-04-11;0;0;45023;18689;19.8;8.2
43;2021-04-12;682;649;45705;19338;20.1;8.5
43;2021-04-13;917;722;46622;20060;20.5;8.8
43;2021-04-14;725;666;47347;20726;20.9;9.1
43;2021-04-15;959;697;48306;21423;21.3;9.4
43;2021-04-16;1007;687;49313;22110;21.7;9.7
43;2021-04-17;423;302;49736;22412;21.9;9.9
43;2021-04-18;3;5;49739;22417;21.9;9.9
43;2021-04-19;629;564;50368;22981;22.2;10.1
43;2021-04-20;840;666;51208;23647;22.6;10.4
43;2021-04-21;320;987;51528;24634;22.7;10.9
43;2021-04-22;679;1011;52207;25645;23.0;11.3
43;2021-04-23;401;1100;52608;26745;23.2;11.8
43;2021-04-24;347;1038;52955;27783;23.3;12.2
43;2021-04-25;23;403;52978;28186;23.3;12.4
43;2021-04-26;386;963;53364;29149;23.5;12.8
43;2021-04-27;824;989;54188;30138;23.9;13.3
43;2021-04-28;794;1105;54982;31243;24.2;13.8
43;2021-04-29;1238;1138;56220;32381;24.8;14.3
43;2021-04-30;1199;1060;57419;33441;25.3;14.7
43;2021-05-01;400;22;57819;33463;25.5;14.7
43;2021-05-02;1;0;57820;33463;25.5;14.7
43;2021-05-03;1218;401;59038;33864;26.0;14.9
43;2021-05-04;1236;947;60274;34811;26.6;15.3
43;2021-05-05;1145;847;61419;35658;27.1;15.7
43;2021-05-06;1404;935;62823;36593;27.7;16.1
43;2021-05-07;1089;1168;63912;37761;28.2;16.6
43;2021-05-08;518;136;64430;37897;28.4;16.7
43;2021-05-09;0;2;64430;37899;28.4;16.7
43;2021-05-10;1085;722;65515;38621;28.9;17.0
43;2021-05-11;1555;1002;67070;39623;29.6;17.5
43;2021-05-12;1481;808;68551;40431;30.2;17.8
43;2021-05-13;936;380;69487;40811;30.6;18.0
43;2021-05-14;2203;1104;71690;41915;31.6;18.5
43;2021-05-15;1269;318;72959;42233;32.2;18.6
43;2021-05-16;272;47;73231;42280;32.3;18.6
43;2021-05-17;1624;625;74855;42905;33.0;18.9
43;2021-05-18;1966;672;76821;43577;33.9;19.2
43;2021-05-19;2068;569;78889;44146;34.8;19.5
43;2021-05-20;2338;798;81227;44944;35.8;19.8
43;2021-05-21;2384;705;83611;45649;36.8;20.1
43;2021-05-22;1208;340;84819;45989;37.4;20.3
43;2021-05-23;1;0;84820;45989;37.4;20.3
43;2021-05-24;382;100;85202;46089;37.6;20.3
43;2021-05-25;1407;652;86609;46741;38.2;20.6
43;2021-05-26;1349;557;87958;47298;38.8;20.8
43;2021-05-27;1389;710;89347;48008;39.4;21.2
43;2021-05-28;1348;732;90695;48740;40.0;21.5
43;2021-05-29;1135;599;91830;49339;40.5;21.7
43;2021-05-30;149;17;91979;49356;40.5;21.8
43;2021-05-31;1208;441;93187;49797;41.1;21.9
43;2021-06-01;1277;983;94464;50780;41.6;22.4
43;2021-06-02;1086;698;95550;51478;42.1;22.7
43;2021-06-03;1193;855;96743;52333;42.6;23.1
43;2021-06-04;1350;859;98093;53192;43.2;23.4
43;2021-06-05;824;450;98917;53642;43.6;23.6
43;2021-06-06;10;5;98927;53647;43.6;23.6
43;2021-06-07;749;515;99676;54162;43.9;23.9
43;2021-06-08;664;703;100340;54865;44.2;24.2
43;2021-06-09;539;759;100879;55624;44.5;24.5
43;2021-06-10;807;1119;101686;56743;44.8;25.0
43;2021-06-11;758;1346;102444;58089;45.1;25.6
43;2021-06-12;914;513;103358;58602;45.6;25.8
43;2021-06-13;3;27;103361;58629;45.6;25.8
43;2021-06-14;447;1088;103808;59717;45.8;26.3
43;2021-06-15;630;1195;104438;60912;46.0;26.8
43;2021-06-16;549;975;104987;61887;46.3;27.3
43;2021-06-17;600;1500;105587;63387;46.5;27.9
43;2021-06-18;901;1462;106488;64849;46.9;28.6
43;2021-06-19;448;782;106936;65631;47.1;28.9
43;2021-06-20;0;12;106936;65643;47.1;28.9
43;2021-06-21;423;1305;107359;66948;47.3;29.5
43;2021-06-22;532;1960;107891;68908;47.5;30.4
43;2021-06-23;343;1743;108234;70651;47.7;31.1
43;2021-06-24;512;1494;108746;72145;47.9;31.8
43;2021-06-25;596;2345;109342;74490;48.2;32.8
43;2021-06-26;505;1245;109847;75735;48.4;33.4
43;2021-06-27;10;20;109857;75755;48.4;33.4
43;2021-06-28;341;1785;110198;77540;48.6;34.2
43;2021-06-29;525;2378;110723;79918;48.8;35.2
43;2021-06-30;459;2275;111182;82193;49.0;36.2
43;2021-07-01;472;1908;111654;84101;49.2;37.1
43;2021-07-02;500;1962;112154;86063;49.4;37.9
43;2021-07-03;256;1106;112410;87169;49.5;38.4
43;2021-07-04;1;0;112411;87169;49.5;38.4
43;2021-07-05;523;1199;112934;88368;49.8;38.9
43;2021-07-06;631;1679;113565;90047;50.1;39.7
43;2021-07-07;522;1418;114087;91465;50.3;40.3
43;2021-07-08;836;1420;114923;92885;50.6;40.9
43;2021-07-09;548;1498;115471;94383;50.9;41.6
43;2021-07-10;401;1336;115872;95719;51.1;42.2
43;2021-07-11;23;98;115895;95817;51.1;42.2
43;2021-07-12;602;1685;116497;97502;51.3;43.0
43;2021-07-13;1185;1852;117682;99354;51.9;43.8
43;2021-07-14;844;156;118526;99510;52.2;43.9
43;2021-07-15;1929;1839;120455;101349;53.1;44.7
43;2021-07-16;1749;1614;122204;102963;53.9;45.4
43;2021-07-17;1534;1193;123738;104156;54.5;45.9
43;2021-07-18;4;19;123742;104175;54.5;45.9
43;2021-07-19;1435;1259;125177;105434;55.2;46.5
43;2021-07-20;1887;1450;127064;106884;56.0;47.1
43;2021-07-21;1842;1104;128906;107988;56.8;47.6
43;2021-07-22;2101;1320;131007;109308;57.7;48.2
43;2021-07-23;1615;1319;132622;110627;58.4;48.8
43;2021-07-24;574;987;133196;111614;58.7;49.2
43;2021-07-25;0;1;133196;111615;58.7;49.2
43;2021-07-26;1637;1067;134833;112682;59.4;49.7
43;2021-07-27;2268;1216;137101;113898;60.4;50.2
43;2021-07-28;1952;1084;139053;114982;61.3;50.7
43;2021-07-29;1977;1017;141030;115999;62.2;51.1
43;2021-07-30;1861;1333;142891;117332;63.0;51.7
43;2021-07-31;704;607;143595;117939;63.3;52.0
43;2021-08-01;13;20;143608;117959;63.3;52.0
43;2021-08-02;1531;961;145139;118920;64.0;52.4
43;2021-08-03;1395;1161;146534;120081;64.6;52.9
43;2021-08-04;1257;1101;147791;121182;65.1;53.4
43;2021-08-05;1233;1273;149024;122455;65.7;54.0
44;2020-12-27;1;0;1;0;0.0;0.0
44;2020-12-28;1;0;2;0;0.0;0.0
44;2020-12-29;0;0;2;0;0.0;0.0
44;2020-12-30;1;0;3;0;0.0;0.0
44;2020-12-31;0;0;3;0;0.0;0.0
44;2021-01-01;0;0;3;0;0.0;0.0
44;2021-01-02;0;0;3;0;0.0;0.0
44;2021-01-03;3;0;6;0;0.0;0.0
44;2021-01-04;0;0;6;0;0.0;0.0
44;2021-01-05;0;0;6;0;0.0;0.0
44;2021-01-06;20;1;26;1;0.0;0.0
44;2021-01-07;186;0;212;1;0.0;0.0
44;2021-01-08;528;0;740;1;0.1;0.0
44;2021-01-09;473;0;1213;1;0.1;0.0
44;2021-01-10;455;1;1668;2;0.1;0.0
44;2021-01-11;801;0;2469;2;0.2;0.0
44;2021-01-12;906;1;3375;3;0.2;0.0
44;2021-01-13;1087;1;4462;4;0.3;0.0
44;2021-01-14;1113;8;5575;12;0.4;0.0
44;2021-01-15;987;1;6562;13;0.5;0.0
44;2021-01-16;335;2;6897;15;0.5;0.0
44;2021-01-17;327;1;7224;16;0.5;0.0
44;2021-01-18;855;3;8079;19;0.6;0.0
44;2021-01-19;2610;4;10689;23;0.7;0.0
44;2021-01-20;2721;5;13410;28;0.9;0.0
44;2021-01-21;4529;3;17939;31;1.2;0.0
44;2021-01-22;2415;6;20354;37;1.4;0.0
44;2021-01-23;764;1;21118;38;1.5;0.0
44;2021-01-24;119;0;21237;38;1.5;0.0
44;2021-01-25;829;0;22066;38;1.5;0.0
44;2021-01-26;2562;18;24628;56;1.7;0.0
44;2021-01-27;2091;63;26719;119;1.9;0.0
44;2021-01-28;3732;192;30451;311;2.1;0.0
44;2021-01-29;2367;493;32818;804;2.3;0.1
44;2021-01-30;628;218;33446;1022;2.3;0.1
44;2021-01-31;14;214;33460;1236;2.3;0.1
44;2021-02-01;591;545;34051;1781;2.4;0.1
44;2021-02-02;878;761;34929;2542;2.4;0.2
44;2021-02-03;889;899;35818;3441;2.5;0.2
44;2021-02-04;936;724;36754;4165;2.6;0.3
44;2021-02-05;894;629;37648;4794;2.6;0.3
44;2021-02-06;466;269;38114;5063;2.7;0.4
44;2021-02-07;72;208;38186;5271;2.7;0.4
44;2021-02-08;522;460;38708;5731;2.7;0.4
44;2021-02-09;989;1254;39697;6985;2.8;0.5
44;2021-02-10;1139;1315;40836;8300;2.8;0.6
44;2021-02-11;2288;3014;43124;11314;3.0;0.8
44;2021-02-12;1662;1746;44786;13060;3.1;0.9
44;2021-02-13;433;518;45219;13578;3.1;0.9
44;2021-02-14;10;180;45229;13758;3.1;1.0
44;2021-02-15;505;1104;45734;14862;3.2;1.0
44;2021-02-16;1441;2569;47175;17431;3.3;1.2
44;2021-02-17;1103;2172;48278;19603;3.4;1.4
44;2021-02-18;1959;3722;50237;23325;3.5;1.6
44;2021-02-19;1579;2540;51816;25865;3.6;1.8
44;2021-02-20;409;648;52225;26513;3.6;1.8
44;2021-02-21;6;178;52231;26691;3.6;1.9
44;2021-02-22;714;839;52945;27530;3.7;1.9
44;2021-02-23;1246;1131;54191;28661;3.8;2.0
44;2021-02-24;1239;1092;55430;29753;3.9;2.1
44;2021-02-25;2442;1085;57872;30838;4.0;2.1
44;2021-02-26;2291;964;60163;31802;4.2;2.2
44;2021-02-27;976;455;61139;32257;4.3;2.2
44;2021-02-28;6;32;61145;32289;4.3;2.2
44;2021-03-01;990;561;62135;32850;4.3;2.3
44;2021-03-02;1798;1054;63933;33904;4.4;2.4
44;2021-03-03;1859;1134;65792;35038;4.6;2.4
44;2021-03-04;2878;1574;68670;36612;4.8;2.5
44;2021-03-05;3477;1331;72147;37943;5.0;2.6
44;2021-03-06;2508;496;74655;38439;5.2;2.7
44;2021-03-07;988;87;75643;38526;5.3;2.7
44;2021-03-08;1784;612;77427;39138;5.4;2.7
44;2021-03-09;3351;1155;80778;40293;5.6;2.8
44;2021-03-10;3077;1115;83855;41408;5.8;2.9
44;2021-03-11;4436;1787;88291;43195;6.1;3.0
44;2021-03-12;5888;1292;94179;44487;6.6;3.1
44;2021-03-13;3630;295;97809;44782;6.8;3.1
44;2021-03-14;430;63;98239;44845;6.8;3.1
44;2021-03-15;2686;359;100925;45204;7.0;3.1
44;2021-03-16;2150;624;103075;45828;7.2;3.2
44;2021-03-17;1966;677;105041;46505;7.3;3.2
44;2021-03-18;2167;636;107208;47141;7.5;3.3
44;2021-03-19;3779;362;110987;47503;7.7;3.3
44;2021-03-20;3210;288;114197;47791;7.9;3.3
44;2021-03-21;911;18;115108;47809;8.0;3.3
44;2021-03-22;2462;439;117570;48248;8.2;3.4
44;2021-03-23;3960;703;121530;48951;8.5;3.4
44;2021-03-24;4303;626;125833;49577;8.8;3.4
44;2021-03-25;5621;925;131454;50502;9.1;3.5
44;2021-03-26;6502;756;137956;51258;9.6;3.6
44;2021-03-27;3214;422;141170;51680;9.8;3.6
44;2021-03-28;1244;38;142414;51718;9.9;3.6
44;2021-03-29;3118;790;145532;52508;10.1;3.7
44;2021-03-30;5134;1114;150666;53622;10.5;3.7
44;2021-03-31;4612;1309;155278;54931;10.8;3.8
44;2021-04-01;6131;995;161409;55926;11.2;3.9
44;2021-04-02;5795;948;167204;56874;11.6;4.0
44;2021-04-03;2434;647;169638;57521;11.8;4.0
44;2021-04-04;665;19;170303;57540;11.9;4.0
44;2021-04-05;692;286;170995;57826;11.9;4.0
44;2021-04-06;4205;1373;175200;59199;12.2;4.1
44;2021-04-07;5073;1650;180273;60849;12.5;4.2
44;2021-04-08;7179;1651;187452;62500;13.0;4.3
44;2021-04-09;10060;1788;197512;64288;13.7;4.5
44;2021-04-10;4559;1440;202071;65728;14.1;4.6
44;2021-04-11;2148;422;204219;66150;14.2;4.6
44;2021-04-12;5462;1585;209681;67735;14.6;4.7
44;2021-04-13;6728;2254;216409;69989;15.1;4.9
44;2021-04-14;5907;2228;222316;72217;15.5;5.0
44;2021-04-15;6702;2205;229018;74422;15.9;5.2
44;2021-04-16;7779;2033;236797;76455;16.5;5.3
44;2021-04-17;4296;1376;241093;77831;16.8;5.4
44;2021-04-18;2254;819;243347;78650;16.9;5.5
44;2021-04-19;5042;1902;248389;80552;17.3;5.6
44;2021-04-20;6279;2651;254668;83203;17.7;5.8
44;2021-04-21;6007;2781;260675;85984;18.1;6.0
44;2021-04-22;6958;2507;267633;88491;18.6;6.2
44;2021-04-23;7329;3163;274962;91654;19.1;6.4
44;2021-04-24;3974;2046;278936;93700;19.4;6.5
44;2021-04-25;2076;1057;281012;94757;19.6;6.6
44;2021-04-26;5647;2759;286659;97516;19.9;6.8
44;2021-04-27;7418;4099;294077;101615;20.5;7.1
44;2021-04-28;7604;3779;301681;105394;21.0;7.3
44;2021-04-29;8965;4266;310646;109660;21.6;7.6
44;2021-04-30;9566;4689;320212;114349;22.3;8.0
44;2021-05-01;2847;923;323059;115272;22.5;8.0
44;2021-05-02;1900;618;324959;115890;22.6;8.1
44;2021-05-03;5550;4073;330509;119963;23.0;8.3
44;2021-05-04;6331;5130;336840;125093;23.4;8.7
44;2021-05-05;6069;4625;342909;129718;23.9;9.0
44;2021-05-06;7252;4879;350161;134597;24.4;9.4
44;2021-05-07;7453;5714;357614;140311;24.9;9.8
44;2021-05-08;2583;1262;360197;141573;25.1;9.9
44;2021-05-09;1802;1815;361999;143388;25.2;10.0
44;2021-05-10;6571;5771;368570;149159;25.6;10.4
44;2021-05-11;7787;6259;376357;155418;26.2;10.8
44;2021-05-12;8191;5724;384548;161142;26.8;11.2
44;2021-05-13;5296;1186;389844;162328;27.1;11.3
44;2021-05-14;7584;3971;397428;166299;27.7;11.6
44;2021-05-15;5005;2232;402433;168531;28.0;11.7
44;2021-05-16;2796;741;405229;169272;28.2;11.8
44;2021-05-17;6745;5151;411974;174423;28.7;12.1
44;2021-05-18;7972;5238;419946;179661;29.2;12.5
44;2021-05-19;8162;4286;428108;183947;29.8;12.8
44;2021-05-20;8365;4654;436473;188601;30.4;13.1
44;2021-05-21;8834;5215;445307;193816;31.0;13.5
44;2021-05-22;5098;2233;450405;196049;31.3;13.6
44;2021-05-23;1759;825;452164;196874;31.5;13.7
44;2021-05-24;4887;1618;457051;198492;31.8;13.8
44;2021-05-25;7740;5544;464791;204036;32.3;14.2
44;2021-05-26;8180;5039;472971;209075;32.9;14.5
44;2021-05-27;9657;5353;482628;214428;33.6;14.9
44;2021-05-28;9183;6917;491811;221345;34.2;15.4
44;2021-05-29;5884;3330;497695;224675;34.6;15.6
44;2021-05-30;1775;704;499470;225379;34.8;15.7
44;2021-05-31;8062;6185;507532;231564;35.3;16.1
44;2021-06-01;9900;6560;517432;238124;36.0;16.6
44;2021-06-02;9517;5690;526949;243814;36.7;17.0
44;2021-06-03;10856;5879;537805;249693;37.4;17.4
44;2021-06-04;9937;8069;547742;257762;38.1;17.9
44;2021-06-05;5776;4345;553518;262107;38.5;18.2
44;2021-06-06;2361;1130;555879;263237;38.7;18.3
44;2021-06-07;9550;6930;565429;270167;39.3;18.8
44;2021-06-08;10900;7494;576329;277661;40.1;19.3
44;2021-06-09;10547;6323;586876;283984;40.8;19.8
44;2021-06-10;11400;6035;598276;290019;41.6;20.2
44;2021-06-11;11919;8633;610195;298652;42.5;20.8
44;2021-06-12;7758;4083;617953;302735;43.0;21.1
44;2021-06-13;2792;1008;620745;303743;43.2;21.1
44;2021-06-14;8714;8404;629459;312147;43.8;21.7
44;2021-06-15;11243;8238;640702;320385;44.6;22.3
44;2021-06-16;10920;7647;651622;328032;45.3;22.8
44;2021-06-17;11676;8670;663298;336702;46.2;23.4
44;2021-06-18;10645;10101;673943;346803;46.9;24.1
44;2021-06-19;5874;4322;679817;351125;47.3;24.4
44;2021-06-20;2534;1334;682351;352459;47.5;24.5
44;2021-06-21;7219;10013;689570;362472;48.0;25.2
44;2021-06-22;8443;10620;698013;373092;48.6;26.0
44;2021-06-23;8531;9125;706544;382217;49.2;26.6
44;2021-06-24;9110;8565;715654;390782;49.8;27.2
44;2021-06-25;7613;10805;723267;401587;50.3;27.9
44;2021-06-26;2956;6469;726223;408056;50.5;28.4
44;2021-06-27;816;2405;727039;410461;50.6;28.6
44;2021-06-28;5214;10057;732253;420518;51.0;29.3
44;2021-06-29;6175;12082;738428;432600;51.4;30.1
44;2021-06-30;6144;10457;744572;443057;51.8;30.8
44;2021-07-01;6894;10486;751466;453543;52.3;31.6
44;2021-07-02;6416;12545;757882;466088;52.7;32.4
44;2021-07-03;2568;7003;760450;473091;52.9;32.9
44;2021-07-04;986;2235;761436;475326;53.0;33.1
44;2021-07-05;5226;11864;766662;487190;53.3;33.9
44;2021-07-06;5893;12612;772555;499802;53.8;34.8
44;2021-07-07;6379;11097;778934;510899;54.2;35.5
44;2021-07-08;7242;11962;786176;522861;54.7;36.4
44;2021-07-09;6044;14265;792220;537126;55.1;37.4
44;2021-07-10;2375;7018;794595;544144;55.3;37.9
44;2021-07-11;724;2261;795319;546405;55.3;38.0
44;2021-07-12;4341;14063;799660;560468;55.6;39.0
44;2021-07-13;5704;14871;805364;575339;56.0;40.0
44;2021-07-14;3622;5814;808986;581153;56.3;40.4
44;2021-07-15;7130;14268;816116;595421;56.8;41.4
44;2021-07-16;8063;15003;824179;610424;57.3;42.5
44;2021-07-17;3346;7577;827525;618001;57.6;43.0
44;2021-07-18;1422;2548;828947;620549;57.7;43.2
44;2021-07-19;4659;14704;833606;635253;58.0;44.2
44;2021-07-20;5960;15681;839566;650934;58.4;45.3
44;2021-07-21;5798;14007;845364;664941;58.8;46.3
44;2021-07-22;6666;13754;852030;678695;59.3;47.2
44;2021-07-23;6109;15646;858139;694341;59.7;48.3
44;2021-07-24;2816;8723;860955;703064;59.9;48.9
44;2021-07-25;929;3092;861884;706156;60.0;49.1
44;2021-07-26;6032;12697;867916;718853;60.4;50.0
44;2021-07-27;9617;12182;877533;731035;61.1;50.9
44;2021-07-28;9188;10829;886721;741864;61.7;51.6
44;2021-07-29;10195;10825;896916;752689;62.4;52.4
44;2021-07-30;9078;10904;905994;763593;63.0;53.1
44;2021-07-31;4733;5636;910727;769229;63.4;53.5
44;2021-08-01;2536;1403;913263;770632;63.5;53.6
44;2021-08-02;6272;9465;919535;780097;64.0;54.3
44;2021-08-03;8308;8528;927843;788625;64.6;54.9
44;2021-08-04;8977;6955;936820;795580;65.2;55.4
44;2021-08-05;11236;7436;948056;803016;66.0;55.9
45;2020-12-27;0;0;0;0;0.0;0.0
45;2020-12-28;1;0;1;0;0.0;0.0
45;2020-12-29;0;0;1;0;0.0;0.0
45;2020-12-30;0;0;1;0;0.0;0.0
45;2020-12-31;1;0;2;0;0.0;0.0
45;2021-01-01;0;0;2;0;0.0;0.0
45;2021-01-02;0;0;2;0;0.0;0.0
45;2021-01-03;0;0;2;0;0.0;0.0
45;2021-01-04;0;0;2;0;0.0;0.0
45;2021-01-05;76;0;78;0;0.0;0.0
45;2021-01-06;69;0;147;0;0.0;0.0
45;2021-01-07;186;0;333;0;0.0;0.0
45;2021-01-08;199;1;532;1;0.1;0.0
45;2021-01-09;42;0;574;1;0.1;0.0
45;2021-01-10;23;0;597;1;0.1;0.0
45;2021-01-11;254;0;851;1;0.1;0.0
45;2021-01-12;679;2;1530;3;0.2;0.0
45;2021-01-13;496;2;2026;5;0.3;0.0
45;2021-01-14;482;39;2508;44;0.4;0.0
45;2021-01-15;391;3;2899;47;0.4;0.0
45;2021-01-16;39;0;2938;47;0.4;0.0
45;2021-01-17;24;0;2962;47;0.4;0.0
45;2021-01-18;814;1;3776;48;0.6;0.0
45;2021-01-19;1196;6;4972;54;0.7;0.0
45;2021-01-20;2113;6;7085;60;1.0;0.0
45;2021-01-21;2523;6;9608;66;1.4;0.0
45;2021-01-22;1409;2;11017;68;1.6;0.0
45;2021-01-23;121;0;11138;68;1.6;0.0
45;2021-01-24;39;0;11177;68;1.6;0.0
45;2021-01-25;556;3;11733;71;1.7;0.0
45;2021-01-26;847;18;12580;89;1.8;0.0
45;2021-01-27;649;44;13229;133;1.9;0.0
45;2021-01-28;882;219;14111;352;2.1;0.1
45;2021-01-29;577;125;14688;477;2.2;0.1
45;2021-01-30;40;41;14728;518;2.2;0.1
45;2021-01-31;37;23;14765;541;2.2;0.1
45;2021-02-01;462;209;15227;750;2.2;0.1
45;2021-02-02;759;469;15986;1219;2.3;0.2
45;2021-02-03;773;480;16759;1699;2.5;0.2
45;2021-02-04;701;267;17460;1966;2.6;0.3
45;2021-02-05;417;151;17877;2117;2.6;0.3
45;2021-02-06;36;28;17913;2145;2.6;0.3
45;2021-02-07;5;31;17918;2176;2.6;0.3
45;2021-02-08;455;194;18373;2370;2.7;0.3
45;2021-02-09;1004;409;19377;2779;2.8;0.4
45;2021-02-10;1277;799;20654;3578;3.0;0.5
45;2021-02-11;1383;1523;22037;5101;3.2;0.7
45;2021-02-12;1052;1143;23089;6244;3.4;0.9
45;2021-02-13;85;158;23174;6402;3.4;0.9
45;2021-02-14;39;11;23213;6413;3.4;0.9
45;2021-02-15;523;611;23736;7024;3.5;1.0
45;2021-02-16;756;940;24492;7964;3.6;1.2
45;2021-02-17;642;1049;25134;9013;3.7;1.3
45;2021-02-18;840;856;25974;9869;3.8;1.4
45;2021-02-19;827;762;26801;10631;3.9;1.6
45;2021-02-20;59;94;26860;10725;3.9;1.6
45;2021-02-21;17;46;26877;10771;3.9;1.6
45;2021-02-22;407;632;27284;11403;4.0;1.7
45;2021-02-23;815;808;28099;12211;4.1;1.8
45;2021-02-24;650;923;28749;13134;4.2;1.9
45;2021-02-25;961;800;29710;13934;4.4;2.0
45;2021-02-26;1044;689;30754;14623;4.5;2.1
45;2021-02-27;290;52;31044;14675;4.5;2.1
45;2021-02-28;28;5;31072;14680;4.6;2.1
45;2021-03-01;533;335;31605;15015;4.6;2.2
45;2021-03-02;671;727;32276;15742;4.7;2.3
45;2021-03-03;982;892;33258;16634;4.9;2.4
45;2021-03-04;1108;985;34366;17619;5.0;2.6
45;2021-03-05;1441;862;35807;18481;5.2;2.7
45;2021-03-06;2022;125;37829;18606;5.5;2.7
45;2021-03-07;143;59;37972;18665;5.6;2.7
45;2021-03-08;752;851;38724;19516;5.7;2.9
45;2021-03-09;1256;718;39980;20234;5.9;3.0
45;2021-03-10;1594;901;41574;21135;6.1;3.1
45;2021-03-11;1720;751;43294;21886;6.3;3.2
45;2021-03-12;2074;604;45368;22490;6.6;3.3
45;2021-03-13;987;46;46355;22536;6.8;3.3
45;2021-03-14;24;43;46379;22579;6.8;3.3
45;2021-03-15;810;598;47189;23177;6.9;3.4
45;2021-03-16;943;838;48132;24015;7.0;3.5
45;2021-03-17;1051;688;49183;24703;7.2;3.6
45;2021-03-18;997;580;50180;25283;7.3;3.7
45;2021-03-19;1619;430;51799;25713;7.6;3.8
45;2021-03-20;498;81;52297;25794;7.7;3.8
45;2021-03-21;20;35;52317;25829;7.7;3.8
45;2021-03-22;913;528;53230;26357;7.8;3.9
45;2021-03-23;1983;718;55213;27075;8.1;4.0
45;2021-03-24;1897;547;57110;27622;8.4;4.0
45;2021-03-25;2983;448;60093;28070;8.8;4.1
45;2021-03-26;3389;474;63482;28544;9.3;4.2
45;2021-03-27;1793;118;65275;28662;9.6;4.2
45;2021-03-28;89;40;65364;28702;9.6;4.2
45;2021-03-29;1529;537;66893;29239;9.8;4.3
45;2021-03-30;2781;782;69674;30021;10.2;4.4
45;2021-03-31;2134;573;71808;30594;10.5;4.5
45;2021-04-01;2973;561;74781;31155;11.0;4.6
45;2021-04-02;2824;507;77605;31662;11.4;4.6
45;2021-04-03;810;73;78415;31735;11.5;4.6
45;2021-04-04;112;33;78527;31768;11.5;4.7
45;2021-04-05;14;2;78541;31770;11.5;4.7
45;2021-04-06;1734;791;80275;32561;11.8;4.8
45;2021-04-07;1776;1112;82051;33673;12.0;4.9
45;2021-04-08;2773;1019;84824;34692;12.4;5.1
45;2021-04-09;3673;640;88497;35332;13.0;5.2
45;2021-04-10;2322;105;90819;35437;13.3;5.2
45;2021-04-11;153;24;90972;35461;13.3;5.2
45;2021-04-12;2605;660;93577;36121;13.7;5.3
45;2021-04-13;3843;1081;97420;37202;14.3;5.4
45;2021-04-14;2930;1218;100350;38420;14.7;5.6
45;2021-04-15;3520;1031;103870;39451;15.2;5.8
45;2021-04-16;3775;684;107645;40135;15.8;5.9
45;2021-04-17;1613;109;109258;40244;16.0;5.9
45;2021-04-18;200;37;109458;40281;16.0;5.9
45;2021-04-19;1937;946;111395;41227;16.3;6.0
45;2021-04-20;3076;1696;114471;42923;16.8;6.3
45;2021-04-21;2722;1297;117193;44220;17.2;6.5
45;2021-04-22;3425;1837;120618;46057;17.7;6.7
45;2021-04-23;3276;1784;123894;47841;18.1;7.0
45;2021-04-24;2023;867;125917;48708;18.4;7.1
45;2021-04-25;292;84;126209;48792;18.5;7.1
45;2021-04-26;2228;1164;128437;49956;18.8;7.3
45;2021-04-27;3352;2350;131789;52306;19.3;7.7
45;2021-04-28;2802;1948;134591;54254;19.7;7.9
45;2021-04-29;3832;2337;138423;56591;20.3;8.3
45;2021-04-30;4389;1805;142812;58396;20.9;8.6
45;2021-05-01;451;61;143263;58457;21.0;8.6
45;2021-05-02;626;122;143889;58579;21.1;8.6
45;2021-05-03;2821;988;146710;59567;21.5;8.7
45;2021-05-04;3159;2342;149869;61909;21.9;9.1
45;2021-05-05;2713;2160;152582;64069;22.3;9.4
45;2021-05-06;3331;2538;155913;66607;22.8;9.8
45;2021-05-07;2874;3199;158787;69806;23.3;10.2
45;2021-05-08;611;245;159398;70051;23.3;10.3
45;2021-05-09;1498;125;160896;70176;23.6;10.3
45;2021-05-10;4140;2970;165036;73146;24.2;10.7
45;2021-05-11;5030;2965;170066;76111;24.9;11.1
45;2021-05-12;6078;2778;176144;78889;25.8;11.6
45;2021-05-13;2450;595;178594;79484;26.2;11.6
45;2021-05-14;4968;1626;183562;81110;26.9;11.9
45;2021-05-15;4066;606;187628;81716;27.5;12.0
45;2021-05-16;287;33;187915;81749;27.5;12.0
45;2021-05-17;3355;1536;191270;83285;28.0;12.2
45;2021-05-18;5118;1680;196388;84965;28.8;12.4
45;2021-05-19;4493;2058;200881;87023;29.4;12.7
45;2021-05-20;5264;2135;206145;89158;30.2;13.1
45;2021-05-21;5146;2226;211291;91384;30.9;13.4
45;2021-05-22;3041;631;214332;92015;31.4;13.5
45;2021-05-23;15;94;214347;92109;31.4;13.5
45;2021-05-24;2829;206;217176;92315;31.8;13.5
45;2021-05-25;4961;3031;222137;95346;32.5;14.0
45;2021-05-26;5111;2327;227248;97673;33.3;14.3
45;2021-05-27;5310;3203;232558;100876;34.1;14.8
45;2021-05-28;5662;3565;238220;104441;34.9;15.3
45;2021-05-29;3671;1285;241891;105726;35.4;15.5
45;2021-05-30;33;182;241924;105908;35.4;15.5
45;2021-05-31;4329;2520;246253;108428;36.1;15.9
45;2021-06-01;6090;2994;252343;111422;37.0;16.3
45;2021-06-02;4939;3095;257282;114517;37.7;16.8
45;2021-06-03;5618;3202;262900;117719;38.5;17.2
45;2021-06-04;5897;3186;268797;120905;39.4;17.7
45;2021-06-05;2028;1334;270825;122239;39.7;17.9
45;2021-06-06;86;198;270911;122437;39.7;17.9
45;2021-06-07;4081;2723;274992;125160;40.3;18.3
45;2021-06-08;4643;4073;279635;129233;40.9;18.9
45;2021-06-09;4355;3338;283990;132571;41.6;19.4
45;2021-06-10;4638;2683;288628;135254;42.3;19.8
45;2021-06-11;4115;3662;292743;138916;42.9;20.3
45;2021-06-12;2440;1505;295183;140421;43.2;20.6
45;2021-06-13;21;424;295204;140845;43.2;20.6
45;2021-06-14;3136;4149;298340;144994;43.7;21.2
45;2021-06-15;3389;4327;301729;149321;44.2;21.9
45;2021-06-16;3901;3453;305630;152774;44.8;22.4
45;2021-06-17;3525;3541;309155;156315;45.3;22.9
45;2021-06-18;3803;5028;312958;161343;45.8;23.6
45;2021-06-19;2393;1760;315351;163103;46.2;23.9
45;2021-06-20;45;140;315396;163243;46.2;23.9
45;2021-06-21;2163;5850;317559;169093;46.5;24.8
45;2021-06-22;2419;6526;319978;175619;46.9;25.7
45;2021-06-23;2284;5602;322262;181221;47.2;26.5
45;2021-06-24;2135;3530;324397;184751;47.5;27.1
45;2021-06-25;2440;6443;326837;191194;47.9;28.0
45;2021-06-26;1947;3091;328784;194285;48.1;28.5
45;2021-06-27;53;138;328837;194423;48.2;28.5
45;2021-06-28;2077;4829;330914;199252;48.5;29.2
45;2021-06-29;2833;6811;333747;206063;48.9;30.2
45;2021-06-30;2872;5845;336619;211908;49.3;31.0
45;2021-07-01;2382;5033;339001;216941;49.6;31.8
45;2021-07-02;2356;6285;341357;223226;50.0;32.7
45;2021-07-03;752;2540;342109;225766;50.1;33.1
45;2021-07-04;4;10;342113;225776;50.1;33.1
45;2021-07-05;2137;4989;344250;230765;50.4;33.8
45;2021-07-06;2794;6782;347044;237547;50.8;34.8
45;2021-07-07;2433;6069;349477;243616;51.2;35.7
45;2021-07-08;2816;5387;352293;249003;51.6;36.5
45;2021-07-09;2143;6987;354436;255990;51.9;37.5
45;2021-07-10;1539;3860;355975;259850;52.1;38.1
45;2021-07-11;23;31;355998;259881;52.1;38.1
45;2021-07-12;1588;6001;357586;265882;52.4;38.9
45;2021-07-13;2993;8232;360579;274114;52.8;40.1
45;2021-07-14;1467;1514;362046;275628;53.0;40.4
45;2021-07-15;3708;7291;365754;282919;53.6;41.4
45;2021-07-16;3236;7453;368990;290372;54.0;42.5
45;2021-07-17;1275;2330;370265;292702;54.2;42.9
45;2021-07-18;15;19;370280;292721;54.2;42.9
45;2021-07-19;1857;5960;372137;298681;54.5;43.7
45;2021-07-20;4684;6900;376821;305581;55.2;44.7
45;2021-07-21;5143;5463;381964;311044;55.9;45.5
45;2021-07-22;6155;4892;388119;315936;56.8;46.3
45;2021-07-23;4239;5480;392358;321416;57.5;47.1
45;2021-07-24;1850;2820;394208;324236;57.7;47.5
45;2021-07-25;5;14;394213;324250;57.7;47.5
45;2021-07-26;2891;4972;397104;329222;58.2;48.2
45;2021-07-27;5432;5065;402536;334287;58.9;49.0
45;2021-07-28;4975;4164;407511;338451;59.7;49.6
45;2021-07-29;5255;3238;412766;341689;60.4;50.0
45;2021-07-30;4728;4698;417494;346387;61.1;50.7
45;2021-07-31;845;1946;418339;348333;61.3;51.0
45;2021-08-01;1;4;418340;348337;61.3;51.0
45;2021-08-02;3591;3212;421931;351549;61.8;51.5
45;2021-08-03;4857;3000;426788;354549;62.5;51.9
45;2021-08-04;3710;2214;430498;356763;63.0;52.2
45;2021-08-05;3245;2614;433743;359377;63.5;52.6
46;2020-12-27;1;0;1;0;0.0;0.0
46;2020-12-28;0;0;1;0;0.0;0.0
46;2020-12-29;0;0;1;0;0.0;0.0
46;2020-12-30;0;0;1;0;0.0;0.0
46;2020-12-31;0;0;1;0;0.0;0.0
46;2021-01-01;0;0;1;0;0.0;0.0
46;2021-01-02;0;0;1;0;0.0;0.0
46;2021-01-03;1;0;2;0;0.0;0.0
46;2021-01-04;0;0;2;0;0.0;0.0
46;2021-01-05;0;0;2;0;0.0;0.0
46;2021-01-06;3;0;5;0;0.0;0.0
46;2021-01-07;135;0;140;0;0.1;0.0
46;2021-01-08;181;0;321;0;0.2;0.0
46;2021-01-09;1;0;322;0;0.2;0.0
46;2021-01-10;1;0;323;0;0.2;0.0
46;2021-01-11;117;0;440;0;0.3;0.0
46;2021-01-12;140;0;580;0;0.3;0.0
46;2021-01-13;234;0;814;0;0.5;0.0
46;2021-01-14;237;2;1051;2;0.6;0.0
46;2021-01-15;304;2;1355;4;0.8;0.0
46;2021-01-16;18;0;1373;4;0.8;0.0
46;2021-01-17;0;0;1373;4;0.8;0.0
46;2021-01-18;274;2;1647;6;1.0;0.0
46;2021-01-19;389;0;2036;6;1.2;0.0
46;2021-01-20;935;1;2971;7;1.7;0.0
46;2021-01-21;996;0;3967;7;2.3;0.0
46;2021-01-22;390;2;4357;9;2.5;0.0
46;2021-01-23;0;0;4357;9;2.5;0.0
46;2021-01-24;0;0;4357;9;2.5;0.0
46;2021-01-25;203;1;4560;10;2.6;0.0
46;2021-01-26;262;1;4822;11;2.8;0.0
46;2021-01-27;276;0;5098;11;2.9;0.0
46;2021-01-28;278;43;5376;54;3.1;0.0
46;2021-01-29;233;93;5609;147;3.2;0.1
46;2021-01-30;1;0;5610;147;3.2;0.1
46;2021-01-31;1;0;5611;147;3.2;0.1
46;2021-02-01;233;175;5844;322;3.4;0.2
46;2021-02-02;209;238;6053;560;3.5;0.3
46;2021-02-03;223;95;6276;655;3.6;0.4
46;2021-02-04;372;86;6648;741;3.8;0.4
46;2021-02-05;226;179;6874;920;4.0;0.5
46;2021-02-06;8;0;6882;920;4.0;0.5
46;2021-02-07;42;0;6924;920;4.0;0.5
46;2021-02-08;197;156;7121;1076;4.1;0.6
46;2021-02-09;269;230;7390;1306;4.3;0.8
46;2021-02-10;278;545;7668;1851;4.4;1.1
46;2021-02-11;655;558;8323;2409;4.8;1.4
46;2021-02-12;319;341;8642;2750;5.0;1.6
46;2021-02-13;0;0;8642;2750;5.0;1.6
46;2021-02-14;0;62;8642;2812;5.0;1.6
46;2021-02-15;195;298;8837;3110;5.1;1.8
46;2021-02-16;217;282;9054;3392;5.2;2.0
46;2021-02-17;200;328;9254;3720;5.3;2.1
46;2021-02-18;336;268;9590;3988;5.5;2.3
46;2021-02-19;277;234;9867;4222;5.7;2.4
46;2021-02-20;0;0;9867;4222;5.7;2.4
46;2021-02-21;1;0;9868;4222;5.7;2.4
46;2021-02-22;132;191;10000;4413;5.8;2.5
46;2021-02-23;225;168;10225;4581;5.9;2.6
46;2021-02-24;180;326;10405;4907;6.0;2.8
46;2021-02-25;247;342;10652;5249;6.2;3.0
46;2021-02-26;401;346;11053;5595;6.4;3.2
46;2021-02-27;120;0;11173;5595;6.5;3.2
46;2021-02-28;0;3;11173;5598;6.5;3.2
46;2021-03-01;168;180;11341;5778;6.5;3.3
46;2021-03-02;405;233;11746;6011;6.8;3.5
46;2021-03-03;456;331;12202;6342;7.0;3.7
46;2021-03-04;608;456;12810;6798;7.4;3.9
46;2021-03-05;809;364;13619;7162;7.9;4.1
46;2021-03-06;474;17;14093;7179;8.1;4.1
46;2021-03-07;101;19;14194;7198;8.2;4.2
46;2021-03-08;348;248;14542;7446;8.4;4.3
46;2021-03-09;744;271;15286;7717;8.8;4.5
46;2021-03-10;686;247;15972;7964;9.2;4.6
46;2021-03-11;846;254;16818;8218;9.7;4.7
46;2021-03-12;926;228;17744;8446;10.2;4.9
46;2021-03-13;512;3;18256;8449;10.5;4.9
46;2021-03-14;0;0;18256;8449;10.5;4.9
46;2021-03-15;505;166;18761;8615;10.8;5.0
46;2021-03-16;752;174;19513;8789;11.3;5.1
46;2021-03-17;671;203;20184;8992;11.7;5.2
46;2021-03-18;747;216;20931;9208;12.1;5.3
46;2021-03-19;810;149;21741;9357;12.6;5.4
46;2021-03-20;288;3;22029;9360;12.7;5.4
46;2021-03-21;2;0;22031;9360;12.7;5.4
46;2021-03-22;555;240;22586;9600;13.0;5.5
46;2021-03-23;701;213;23287;9813;13.4;5.7
46;2021-03-24;674;240;23961;10053;13.8;5.8
46;2021-03-25;1133;180;25094;10233;14.5;5.9
46;2021-03-26;1025;339;26119;10572;15.1;6.1
46;2021-03-27;420;71;26539;10643;15.3;6.1
46;2021-03-28;127;1;26666;10644;15.4;6.1
46;2021-03-29;732;252;27398;10896;15.8;6.3
46;2021-03-30;768;363;28166;11259;16.3;6.5
46;2021-03-31;866;420;29032;11679;16.8;6.7
46;2021-04-01;1169;343;30201;12022;17.4;6.9
46;2021-04-02;924;395;31125;12417;18.0;7.2
46;2021-04-03;167;166;31292;12583;18.1;7.3
46;2021-04-04;0;71;31292;12654;18.1;7.3
46;2021-04-05;1;0;31293;12654;18.1;7.3
46;2021-04-06;544;519;31837;13173;18.4;7.6
46;2021-04-07;783;644;32620;13817;18.8;8.0
46;2021-04-08;961;542;33581;14359;19.4;8.3
46;2021-04-09;1018;501;34599;14860;20.0;8.6
46;2021-04-10;501;208;35100;15068;20.3;8.7
46;2021-04-11;232;1;35332;15069;20.4;8.7
46;2021-04-12;845;548;36177;15617;20.9;9.0
46;2021-04-13;1186;716;37363;16333;21.6;9.4
46;2021-04-14;1532;614;38895;16947;22.5;9.8
46;2021-04-15;1495;664;40390;17611;23.3;10.2
46;2021-04-16;1580;564;41970;18175;24.2;10.5
46;2021-04-17;992;132;42962;18307;24.8;10.6
46;2021-04-18;516;8;43478;18315;25.1;10.6
46;2021-04-19;1069;570;44547;18885;25.7;10.9
46;2021-04-20;1222;725;45769;19610;26.4;11.3
46;2021-04-21;1230;713;46999;20323;27.1;11.7
46;2021-04-22;1390;727;48389;21050;27.9;12.2
46;2021-04-23;1132;730;49521;21780;28.6;12.6
46;2021-04-24;472;19;49993;21799;28.9;12.6
46;2021-04-25;351;9;50344;21808;29.1;12.6
46;2021-04-26;853;730;51197;22538;29.6;13.0
46;2021-04-27;1221;665;52418;23203;30.3;13.4
46;2021-04-28;1289;668;53707;23871;31.0;13.8
46;2021-04-29;1416;523;55123;24394;31.8;14.1
46;2021-04-30;1438;563;56561;24957;32.7;14.4
46;2021-05-01;697;71;57258;25028;33.1;14.5
46;2021-05-02;346;4;57604;25032;33.3;14.5
46;2021-05-03;853;568;58457;25600;33.8;14.8
46;2021-05-04;1036;1061;59493;26661;34.4;15.4
46;2021-05-05;1375;786;60868;27447;35.2;15.9
46;2021-05-06;1375;738;62243;28185;35.9;16.3
46;2021-05-07;1396;790;63639;28975;36.8;16.7
46;2021-05-08;281;411;63920;29386;36.9;17.0
46;2021-05-09;23;225;63943;29611;36.9;17.1
46;2021-05-10;519;1140;64462;30751;37.2;17.8
46;2021-05-11;1037;1258;65499;32009;37.8;18.5
46;2021-05-12;994;1560;66493;33569;38.4;19.4
46;2021-05-13;600;144;67093;33713;38.7;19.5
46;2021-05-14;960;1097;68053;34810;39.3;20.1
46;2021-05-15;256;653;68309;35463;39.4;20.5
46;2021-05-16;78;298;68387;35761;39.5;20.7
46;2021-05-17;652;957;69039;36718;39.9;21.2
46;2021-05-18;1404;1020;70443;37738;40.7;21.8
46;2021-05-19;1306;900;71749;38638;41.4;22.3
46;2021-05-20;1453;811;73202;39449;42.3;22.8
46;2021-05-21;997;1158;74199;40607;42.8;23.4
46;2021-05-22;145;369;74344;40976;42.9;23.7
46;2021-05-23;450;25;74794;41001;43.2;23.7
46;2021-05-24;411;113;75205;41114;43.4;23.7
46;2021-05-25;962;1330;76167;42444;44.0;24.5
46;2021-05-26;1236;1150;77403;43594;44.7;25.2
46;2021-05-27;1431;1193;78834;44787;45.5;25.9
46;2021-05-28;1433;1209;80267;45996;46.4;26.6
46;2021-05-29;1052;398;81319;46394;47.0;26.8
46;2021-05-30;408;39;81727;46433;47.2;26.8
46;2021-05-31;970;976;82697;47409;47.8;27.4
46;2021-06-01;1277;997;83974;48406;48.5;28.0
46;2021-06-02;1316;1114;85290;49520;49.3;28.6
46;2021-06-03;1415;1010;86705;50530;50.1;29.2
46;2021-06-04;1330;977;88035;51507;50.8;29.7
46;2021-06-05;380;413;88415;51920;51.1;30.0
46;2021-06-06;207;95;88622;52015;51.2;30.0
46;2021-06-07;813;617;89435;52632;51.6;30.4
46;2021-06-08;1020;896;90455;53528;52.2;30.9
46;2021-06-09;1505;972;91960;54500;53.1;31.5
46;2021-06-10;980;852;92940;55352;53.7;32.0
46;2021-06-11;970;1322;93910;56674;54.2;32.7
46;2021-06-12;459;549;94369;57223;54.5;33.0
46;2021-06-13;27;86;94396;57309;54.5;33.1
46;2021-06-14;592;1138;94988;58447;54.9;33.8
46;2021-06-15;751;1248;95739;59695;55.3;34.5
46;2021-06-16;998;1113;96737;60808;55.9;35.1
46;2021-06-17;525;896;97262;61704;56.2;35.6
46;2021-06-18;658;1255;97920;62959;56.5;36.4
46;2021-06-19;454;312;98374;63271;56.8;36.5
46;2021-06-20;39;161;98413;63432;56.8;36.6
46;2021-06-21;428;946;98841;64378;57.1;37.2
46;2021-06-22;350;1178;99191;65556;57.3;37.9
46;2021-06-23;519;1075;99710;66631;57.6;38.5
46;2021-06-24;251;822;99961;67453;57.7;39.0
46;2021-06-25;492;1117;100453;68570;58.0;39.6
46;2021-06-26;395;551;100848;69121;58.2;39.9
46;2021-06-27;2;4;100850;69125;58.2;39.9
46;2021-06-28;313;1338;101163;70463;58.4;40.7
46;2021-06-29;377;1684;101540;72147;58.6;41.7
46;2021-06-30;512;1580;102052;73727;58.9;42.6
46;2021-07-01;311;1153;102363;74880;59.1;43.2
46;2021-07-02;464;1085;102827;75965;59.4;43.9
46;2021-07-03;123;455;102950;76420;59.5;44.1
46;2021-07-04;57;127;103007;76547;59.5;44.2
46;2021-07-05;344;1188;103351;77735;59.7;44.9
46;2021-07-06;368;1459;103719;79194;59.9;45.7
46;2021-07-07;579;1720;104298;80914;60.2;46.7
46;2021-07-08;339;1168;104637;82082;60.4;47.4
46;2021-07-09;395;1706;105032;83788;60.7;48.4
46;2021-07-10;284;1043;105316;84831;60.8;49.0
46;2021-07-11;15;375;105331;85206;60.8;49.2
46;2021-07-12;248;1262;105579;86468;61.0;49.9
46;2021-07-13;624;1674;106203;88142;61.3;50.9
46;2021-07-14;63;144;106266;88286;61.4;51.0
46;2021-07-15;890;1463;107156;89749;61.9;51.8
46;2021-07-16;764;1396;107920;91145;62.3;52.6
46;2021-07-17;348;534;108268;91679;62.5;52.9
46;2021-07-18;0;0;108268;91679;62.5;52.9
46;2021-07-19;662;1186;108930;92865;62.9;53.6
46;2021-07-20;974;1425;109904;94290;63.5;54.5
46;2021-07-21;995;1381;110899;95671;64.0;55.2
46;2021-07-22;1382;1110;112281;96781;64.8;55.9
46;2021-07-23;743;1321;113024;98102;65.3;56.7
46;2021-07-24;933;662;113957;98764;65.8;57.0
46;2021-07-25;134;16;114091;98780;65.9;57.0
46;2021-07-26;861;883;114952;99663;66.4;57.6
46;2021-07-27;1191;973;116143;100636;67.1;58.1
46;2021-07-28;1247;1099;117390;101735;67.8;58.7
46;2021-07-29;1536;847;118926;102582;68.7;59.2
46;2021-07-30;1881;947;120807;103529;69.8;59.8
46;2021-07-31;913;647;121720;104176;70.3;60.2
46;2021-08-01;10;3;121730;104179;70.3;60.2
46;2021-08-02;961;583;122691;104762;70.9;60.5
46;2021-08-03;1346;674;124037;105436;71.6;60.9
46;2021-08-04;1735;602;125772;106038;72.6;61.2
46;2021-08-05;1367;837;127139;106875;73.4;61.7
47;2020-12-27;0;0;0;0;0.0;0.0
47;2020-12-28;0;0;0;0;0.0;0.0
47;2020-12-29;0;0;0;0;0.0;0.0
47;2020-12-30;0;0;0;0;0.0;0.0
47;2020-12-31;0;0;0;0;0.0;0.0
47;2021-01-01;4;0;4;0;0.0;0.0
47;2021-01-02;0;0;4;0;0.0;0.0
47;2021-01-03;0;0;4;0;0.0;0.0
47;2021-01-04;0;0;4;0;0.0;0.0
47;2021-01-05;0;0;4;0;0.0;0.0
47;2021-01-06;0;0;4;0;0.0;0.0
47;2021-01-07;71;1;75;1;0.0;0.0
47;2021-01-08;314;0;389;1;0.1;0.0
47;2021-01-09;113;0;502;1;0.2;0.0
47;2021-01-10;0;0;502;1;0.2;0.0
47;2021-01-11;249;0;751;1;0.2;0.0
47;2021-01-12;326;0;1077;1;0.3;0.0
47;2021-01-13;349;0;1426;1;0.4;0.0
47;2021-01-14;364;4;1790;5;0.5;0.0
47;2021-01-15;286;1;2076;6;0.6;0.0
47;2021-01-16;176;4;2252;10;0.7;0.0
47;2021-01-17;0;0;2252;10;0.7;0.0
47;2021-01-18;484;1;2736;11;0.8;0.0
47;2021-01-19;469;2;3205;13;1.0;0.0
47;2021-01-20;511;0;3716;13;1.1;0.0
47;2021-01-21;585;0;4301;13;1.3;0.0
47;2021-01-22;463;0;4764;13;1.4;0.0
47;2021-01-23;389;1;5153;14;1.6;0.0
47;2021-01-24;0;0;5153;14;1.6;0.0
47;2021-01-25;425;0;5578;14;1.7;0.0
47;2021-01-26;788;4;6366;18;1.9;0.0
47;2021-01-27;730;1;7096;19;2.1;0.0
47;2021-01-28;575;68;7671;87;2.3;0.0
47;2021-01-29;462;170;8133;257;2.5;0.1
47;2021-01-30;301;39;8434;296;2.6;0.1
47;2021-01-31;0;0;8434;296;2.6;0.1
47;2021-02-01;374;116;8808;412;2.7;0.1
47;2021-02-02;757;317;9565;729;2.9;0.2
47;2021-02-03;424;164;9989;893;3.0;0.3
47;2021-02-04;370;317;10359;1210;3.1;0.4
47;2021-02-05;300;311;10659;1521;3.2;0.5
47;2021-02-06;294;99;10953;1620;3.3;0.5
47;2021-02-07;0;0;10953;1620;3.3;0.5
47;2021-02-08;184;286;11137;1906;3.4;0.6
47;2021-02-09;232;260;11369;2166;3.4;0.7
47;2021-02-10;255;245;11624;2411;3.5;0.7
47;2021-02-11;357;378;11981;2789;3.6;0.8
47;2021-02-12;243;414;12224;3203;3.7;1.0
47;2021-02-13;224;111;12448;3314;3.8;1.0
47;2021-02-14;0;0;12448;3314;3.8;1.0
47;2021-02-15;194;385;12642;3699;3.8;1.1
47;2021-02-16;303;591;12945;4290;3.9;1.3
47;2021-02-17;326;456;13271;4746;4.0;1.4
47;2021-02-18;200;599;13471;5345;4.1;1.6
47;2021-02-19;194;368;13665;5713;4.1;1.7
47;2021-02-20;117;269;13782;5982;4.2;1.8
47;2021-02-21;0;0;13782;5982;4.2;1.8
47;2021-02-22;75;408;13857;6390;4.2;1.9
47;2021-02-23;152;650;14009;7040;4.2;2.1
47;2021-02-24;261;561;14270;7601;4.3;2.3
47;2021-02-25;305;413;14575;8014;4.4;2.4
47;2021-02-26;468;323;15043;8337;4.6;2.5
47;2021-02-27;324;213;15367;8550;4.7;2.6
47;2021-02-28;0;0;15367;8550;4.7;2.6
47;2021-03-01;124;397;15491;8947;4.7;2.7
47;2021-03-02;200;366;15691;9313;4.8;2.8
47;2021-03-03;244;350;15935;9663;4.8;2.9
47;2021-03-04;591;330;16526;9993;5.0;3.0
47;2021-03-05;844;288;17370;10281;5.3;3.1
47;2021-03-06;507;195;17877;10476;5.4;3.2
47;2021-03-07;331;5;18208;10481;5.5;3.2
47;2021-03-08;458;226;18666;10707;5.7;3.2
47;2021-03-09;509;493;19175;11200;5.8;3.4
47;2021-03-10;666;301;19841;11501;6.0;3.5
47;2021-03-11;938;376;20779;11877;6.3;3.6
47;2021-03-12;1370;295;22149;12172;6.7;3.7
47;2021-03-13;949;106;23098;12278;7.0;3.7
47;2021-03-14;51;0;23149;12278;7.0;3.7
47;2021-03-15;591;163;23740;12441;7.2;3.8
47;2021-03-16;750;177;24490;12618;7.4;3.8
47;2021-03-17;860;208;25350;12826;7.7;3.9
47;2021-03-18;916;173;26266;12999;8.0;3.9
47;2021-03-19;1270;123;27536;13122;8.3;4.0
47;2021-03-20;1085;56;28621;13178;8.7;4.0
47;2021-03-21;343;1;28964;13179;8.8;4.0
47;2021-03-22;1012;93;29976;13272;9.1;4.0
47;2021-03-23;1147;148;31123;13420;9.4;4.1
47;2021-03-24;1211;131;32334;13551;9.8;4.1
47;2021-03-25;1566;148;33900;13699;10.3;4.1
47;2021-03-26;1882;197;35782;13896;10.8;4.2
47;2021-03-27;979;129;36761;14025;11.1;4.2
47;2021-03-28;698;4;37459;14029;11.3;4.2
47;2021-03-29;1511;79;38970;14108;11.8;4.3
47;2021-03-30;1640;125;40610;14233;12.3;4.3
47;2021-03-31;1604;146;42214;14379;12.8;4.4
47;2021-04-01;1682;267;43896;14646;13.3;4.4
47;2021-04-02;1933;455;45829;15101;13.9;4.6
47;2021-04-03;1201;176;47030;15277;14.2;4.6
47;2021-04-04;474;12;47504;15289;14.4;4.6
47;2021-04-05;1295;54;48799;15343;14.8;4.6
47;2021-04-06;1386;385;50185;15728;15.2;4.8
47;2021-04-07;1693;585;51878;16313;15.7;4.9
47;2021-04-08;1833;471;53711;16784;16.3;5.1
47;2021-04-09;2082;539;55793;17323;16.9;5.2
47;2021-04-10;1564;322;57357;17645;17.4;5.3
47;2021-04-11;530;8;57887;17653;17.5;5.3
47;2021-04-12;1437;609;59324;18262;18.0;5.5
47;2021-04-13;1817;760;61141;19022;18.5;5.8
47;2021-04-14;1747;718;62888;19740;19.0;6.0
47;2021-04-15;2012;842;64900;20582;19.6;6.2
47;2021-04-16;1765;894;66665;21476;20.2;6.5
47;2021-04-17;1472;970;68137;22446;20.6;6.8
47;2021-04-18;23;0;68160;22446;20.6;6.8
47;2021-04-19;1332;931;69492;23377;21.0;7.1
47;2021-04-20;1624;901;71116;24278;21.5;7.3
47;2021-04-21;1623;769;72739;25047;22.0;7.6
47;2021-04-22;1870;1059;74609;26106;22.6;7.9
47;2021-04-23;1723;1070;76332;27176;23.1;8.2
47;2021-04-24;1548;800;77880;27976;23.6;8.5
47;2021-04-25;242;344;78122;28320;23.6;8.6
47;2021-04-26;1487;1363;79609;29683;24.1;9.0
47;2021-04-27;1923;1468;81532;31151;24.7;9.4
47;2021-04-28;2090;1588;83622;32739;25.3;9.9
47;2021-04-29;2529;1505;86151;34244;26.1;10.4
47;2021-04-30;2040;1777;88191;36021;26.7;10.9
47;2021-05-01;2262;982;90453;37003;27.4;11.2
47;2021-05-02;21;358;90474;37361;27.4;11.3
47;2021-05-03;1596;1417;92070;38778;27.9;11.7
47;2021-05-04;1649;1728;93719;40506;28.4;12.3
47;2021-05-05;1927;1643;95646;42149;29.0;12.8
47;2021-05-06;2104;1507;97750;43656;29.6;13.2
47;2021-05-07;1997;1623;99747;45279;30.2;13.7
47;2021-05-08;2096;464;101843;45743;30.8;13.8
47;2021-05-09;24;362;101867;46105;30.8;14.0
47;2021-05-10;1204;1671;103071;47776;31.2;14.5
47;2021-05-11;2172;1990;105243;49766;31.9;15.1
47;2021-05-12;2626;1450;107869;51216;32.7;15.5
47;2021-05-13;2380;656;110249;51872;33.4;15.7
47;2021-05-14;2062;858;112311;52730;34.0;16.0
47;2021-05-15;1934;861;114245;53591;34.6;16.2
47;2021-05-16;367;8;114612;53599;34.7;16.2
47;2021-05-17;1883;1124;116495;54723;35.3;16.6
47;2021-05-18;2355;1137;118850;55860;36.0;16.9
47;2021-05-19;2344;760;121194;56620;36.7;17.1
47;2021-05-20;2584;966;123778;57586;37.5;17.4
47;2021-05-21;1537;1129;125315;58715;37.9;17.8
47;2021-05-22;2367;834;127682;59549;38.7;18.0
47;2021-05-23;25;185;127707;59734;38.7;18.1
47;2021-05-24;1550;234;129257;59968;39.1;18.2
47;2021-05-25;1483;1317;130740;61285;39.6;18.6
47;2021-05-26;1600;1081;132340;62366;40.1;18.9
47;2021-05-27;1943;1266;134283;63632;40.7;19.3
47;2021-05-28;1458;1536;135741;65168;41.1;19.7
47;2021-05-29;1152;1127;136893;66295;41.4;20.1
47;2021-05-30;12;45;136905;66340;41.4;20.1
47;2021-05-31;1867;1421;138772;67761;42.0;20.5
47;2021-06-01;1922;1337;140694;69098;42.6;20.9
47;2021-06-02;2099;1333;142793;70431;43.2;21.3
47;2021-06-03;2485;1607;145278;72038;44.0;21.8
47;2021-06-04;1969;2112;147247;74150;44.6;22.4
47;2021-06-05;1637;1475;148884;75625;45.1;22.9
47;2021-06-06;212;71;149096;75696;45.1;22.9
47;2021-06-07;1664;2244;150760;77940;45.6;23.6
47;2021-06-08;1628;1905;152388;79845;46.1;24.2
47;2021-06-09;1822;2124;154210;81969;46.7;24.8
47;2021-06-10;2367;1609;156577;83578;47.4;25.3
47;2021-06-11;1824;2100;158401;85678;48.0;25.9
47;2021-06-12;1352;2102;159753;87780;48.4;26.6
47;2021-06-13;4;10;159757;87790;48.4;26.6
47;2021-06-14;1282;2449;161039;90239;48.8;27.3
47;2021-06-15;1464;2034;162503;92273;49.2;27.9
47;2021-06-16;1207;2183;163710;94456;49.6;28.6
47;2021-06-17;1653;1524;165363;95980;50.1;29.1
47;2021-06-18;1438;2495;166801;98475;50.5;29.8
47;2021-06-19;1537;2455;168338;100930;51.0;30.6
47;2021-06-20;4;33;168342;100963;51.0;30.6
47;2021-06-21;1135;2510;169477;103473;51.3;31.3
47;2021-06-22;759;2502;170236;105975;51.5;32.1
47;2021-06-23;997;2014;171233;107989;51.8;32.7
47;2021-06-24;1208;1934;172441;109923;52.2;33.3
47;2021-06-25;1006;2608;173447;112531;52.5;34.1
47;2021-06-26;988;2784;174435;115315;52.8;34.9
47;2021-06-27;15;349;174450;115664;52.8;35.0
47;2021-06-28;875;2403;175325;118067;53.1;35.7
47;2021-06-29;795;2315;176120;120382;53.3;36.4
47;2021-06-30;730;2309;176850;122691;53.5;37.1
47;2021-07-01;818;2109;177668;124800;53.8;37.8
47;2021-07-02;886;2274;178554;127074;54.1;38.5
47;2021-07-03;724;3041;179278;130115;54.3;39.4
47;2021-07-04;34;12;179312;130127;54.3;39.4
47;2021-07-05;977;2142;180289;132269;54.6;40.0
47;2021-07-06;1003;1961;181292;134230;54.9;40.6
47;2021-07-07;1296;2060;182588;136290;55.3;41.3
47;2021-07-08;1143;2194;183731;138484;55.6;41.9
47;2021-07-09;1046;2406;184777;140890;55.9;42.7
47;2021-07-10;954;2133;185731;143023;56.2;43.3
47;2021-07-11;0;6;185731;143029;56.2;43.3
47;2021-07-12;556;2581;186287;145610;56.4;44.1
47;2021-07-13;1091;2591;187378;148201;56.7;44.9
47;2021-07-14;1160;1577;188538;149778;57.1;45.3
47;2021-07-15;1706;3136;190244;152914;57.6;46.3
47;2021-07-16;1710;2679;191954;155593;58.1;47.1
47;2021-07-17;1174;2457;193128;158050;58.5;47.8
47;2021-07-18;36;188;193164;158238;58.5;47.9
47;2021-07-19;1113;2563;194277;160801;58.8;48.7
47;2021-07-20;1609;2337;195886;163138;59.3;49.4
47;2021-07-21;2170;2240;198056;165378;60.0;50.1
47;2021-07-22;2145;2291;200201;167669;60.6;50.8
47;2021-07-23;2103;2247;202304;169916;61.2;51.4
47;2021-07-24;1109;1910;203413;171826;61.6;52.0
47;2021-07-25;11;1;203424;171827;61.6;52.0
47;2021-07-26;1222;1940;204646;173767;62.0;52.6
47;2021-07-27;2088;1623;206734;175390;62.6;53.1
47;2021-07-28;1868;1594;208602;176984;63.1;53.6
47;2021-07-29;2300;1590;210902;178574;63.8;54.1
47;2021-07-30;1848;1619;212750;180193;64.4;54.5
47;2021-07-31;1473;1661;214223;181854;64.9;55.1
47;2021-08-01;17;8;214240;181862;64.9;55.1
47;2021-08-02;2020;1212;216260;183074;65.5;55.4
47;2021-08-03;2126;1094;218386;184168;66.1;55.8
47;2021-08-04;2155;1505;220541;185673;66.8;56.2
47;2021-08-05;2390;1428;222931;187101;67.5;56.6
48;2020-12-27;0;0;0;0;0.0;0.0
48;2020-12-28;0;0;0;0;0.0;0.0
48;2020-12-29;0;0;0;0;0.0;0.0
48;2020-12-30;0;0;0;0;0.0;0.0
48;2020-12-31;0;0;0;0;0.0;0.0
48;2021-01-01;0;0;0;0;0.0;0.0
48;2021-01-02;0;0;0;0;0.0;0.0
48;2021-01-03;0;0;0;0;0.0;0.0
48;2021-01-04;0;0;0;0;0.0;0.0
48;2021-01-05;0;0;0;0;0.0;0.0
48;2021-01-06;0;0;0;0;0.0;0.0
48;2021-01-07;54;0;54;0;0.1;0.0
48;2021-01-08;87;0;141;0;0.2;0.0
48;2021-01-09;1;0;142;0;0.2;0.0
48;2021-01-10;0;0;142;0;0.2;0.0
48;2021-01-11;13;0;155;0;0.2;0.0
48;2021-01-12;19;1;174;1;0.2;0.0
48;2021-01-13;104;0;278;1;0.4;0.0
48;2021-01-14;90;1;368;2;0.5;0.0
48;2021-01-15;63;0;431;2;0.6;0.0
48;2021-01-16;0;0;431;2;0.6;0.0
48;2021-01-17;0;0;431;2;0.6;0.0
48;2021-01-18;117;0;548;2;0.7;0.0
48;2021-01-19;345;0;893;2;1.2;0.0
48;2021-01-20;364;0;1257;2;1.6;0.0
48;2021-01-21;465;0;1722;2;2.3;0.0
48;2021-01-22;269;0;1991;2;2.6;0.0
48;2021-01-23;36;0;2027;2;2.7;0.0
48;2021-01-24;0;0;2027;2;2.7;0.0
48;2021-01-25;109;0;2136;2;2.8;0.0
48;2021-01-26;261;0;2397;2;3.1;0.0
48;2021-01-27;257;2;2654;4;3.5;0.0
48;2021-01-28;270;10;2924;14;3.8;0.0
48;2021-01-29;175;60;3099;74;4.1;0.1
48;2021-01-30;1;7;3100;81;4.1;0.1
48;2021-01-31;0;6;3100;87;4.1;0.1
48;2021-02-01;97;47;3197;134;4.2;0.2
48;2021-02-02;191;36;3388;170;4.4;0.2
48;2021-02-03;177;82;3565;252;4.7;0.3
48;2021-02-04;234;13;3799;265;5.0;0.3
48;2021-02-05;144;35;3943;300;5.2;0.4
48;2021-02-06;34;0;3977;300;5.2;0.4
48;2021-02-07;0;0;3977;300;5.2;0.4
48;2021-02-08;50;61;4027;361;5.3;0.5
48;2021-02-09;66;166;4093;527;5.4;0.7
48;2021-02-10;65;303;4158;830;5.5;1.1
48;2021-02-11;165;407;4323;1237;5.7;1.6
48;2021-02-12;119;155;4442;1392;5.8;1.8
48;2021-02-13;8;55;4450;1447;5.8;1.9
48;2021-02-14;0;0;4450;1447;5.8;1.9
48;2021-02-15;51;106;4501;1553;5.9;2.0
48;2021-02-16;43;173;4544;1726;6.0;2.3
48;2021-02-17;35;285;4579;2011;6.0;2.6
48;2021-02-18;252;96;4831;2107;6.3;2.8
48;2021-02-19;60;183;4891;2290;6.4;3.0
48;2021-02-20;0;1;4891;2291;6.4;3.0
48;2021-02-21;0;14;4891;2305;6.4;3.0
48;2021-02-22;24;129;4915;2434;6.4;3.2
48;2021-02-23;74;222;4989;2656;6.5;3.5
48;2021-02-24;66;264;5055;2920;6.6;3.8
48;2021-02-25;148;263;5203;3183;6.8;4.2
48;2021-02-26;51;228;5254;3411;6.9;4.5
48;2021-02-27;28;1;5282;3412;6.9;4.5
48;2021-02-28;3;14;5285;3426;6.9;4.5
48;2021-03-01;102;96;5387;3522;7.1;4.6
48;2021-03-02;199;87;5586;3609;7.3;4.7
48;2021-03-03;155;111;5741;3720;7.5;4.9
48;2021-03-04;192;183;5933;3903;7.8;5.1
48;2021-03-05;136;141;6069;4044;8.0;5.3
48;2021-03-06;180;53;6249;4097;8.2;5.4
48;2021-03-07;75;1;6324;4098;8.3;5.4
48;2021-03-08;352;121;6676;4219;8.8;5.5
48;2021-03-09;377;86;7053;4305;9.2;5.6
48;2021-03-10;263;61;7316;4366;9.6;5.7
48;2021-03-11;334;90;7650;4456;10.0;5.8
48;2021-03-12;256;155;7906;4611;10.4;6.0
48;2021-03-13;301;5;8207;4616;10.8;6.1
48;2021-03-14;8;0;8215;4616;10.8;6.1
48;2021-03-15;174;63;8389;4679;11.0;6.1
48;2021-03-16;164;65;8553;4744;11.2;6.2
48;2021-03-17;156;110;8709;4854;11.4;6.4
48;2021-03-18;190;104;8899;4958;11.7;6.5
48;2021-03-19;116;95;9015;5053;11.8;6.6
48;2021-03-20;101;0;9116;5053;11.9;6.6
48;2021-03-21;0;0;9116;5053;11.9;6.6
48;2021-03-22;160;22;9276;5075;12.2;6.7
48;2021-03-23;328;102;9604;5177;12.6;6.8
48;2021-03-24;284;100;9888;5277;13.0;6.9
48;2021-03-25;757;114;10645;5391;14.0;7.1
48;2021-03-26;269;60;10914;5451;14.3;7.1
48;2021-03-27;104;0;11018;5451;14.4;7.1
48;2021-03-28;78;19;11096;5470;14.5;7.2
48;2021-03-29;304;80;11400;5550;14.9;7.3
48;2021-03-30;362;129;11762;5679;15.4;7.4
48;2021-03-31;447;83;12209;5762;16.0;7.6
48;2021-04-01;729;66;12938;5828;17.0;7.6
48;2021-04-02;486;124;13424;5952;17.6;7.8
48;2021-04-03;140;83;13564;6035;17.8;7.9
48;2021-04-04;0;0;13564;6035;17.8;7.9
48;2021-04-05;43;1;13607;6036;17.8;7.9
48;2021-04-06;465;157;14072;6193;18.4;8.1
48;2021-04-07;465;140;14537;6333;19.1;8.3
48;2021-04-08;618;184;15155;6517;19.9;8.5
48;2021-04-09;446;119;15601;6636;20.5;8.7
48;2021-04-10;95;58;15696;6694;20.6;8.8
48;2021-04-11;2;0;15698;6694;20.6;8.8
48;2021-04-12;364;70;16062;6764;21.1;8.9
48;2021-04-13;361;92;16423;6856;21.5;9.0
48;2021-04-14;624;185;17047;7041;22.3;9.2
48;2021-04-15;698;355;17745;7396;23.3;9.7
48;2021-04-16;538;223;18283;7619;24.0;10.0
48;2021-04-17;89;69;18372;7688;24.1;10.1
48;2021-04-18;0;0;18372;7688;24.1;10.1
48;2021-04-19;197;107;18569;7795;24.3;10.2
48;2021-04-20;216;178;18785;7973;24.6;10.5
48;2021-04-21;284;205;19069;8178;25.0;10.7
48;2021-04-22;308;479;19377;8657;25.4;11.3
48;2021-04-23;254;241;19631;8898;25.7;11.7
48;2021-04-24;97;93;19728;8991;25.9;11.8
48;2021-04-25;1;9;19729;9000;25.9;11.8
48;2021-04-26;87;208;19816;9208;26.0;12.1
48;2021-04-27;172;292;19988;9500;26.2;12.5
48;2021-04-28;149;414;20137;9914;26.4;13.0
48;2021-04-29;204;490;20341;10404;26.7;13.6
48;2021-04-30;172;225;20513;10629;26.9;13.9
48;2021-05-01;0;0;20513;10629;26.9;13.9
48;2021-05-02;0;0;20513;10629;26.9;13.9
48;2021-05-03;105;386;20618;11015;27.0;14.4
48;2021-05-04;227;420;20845;11435;27.3;15.0
48;2021-05-05;84;484;20929;11919;27.4;15.6
48;2021-05-06;742;638;21671;12557;28.4;16.5
48;2021-05-07;96;504;21767;13061;28.5;17.1
48;2021-05-08;309;43;22076;13104;28.9;17.2
48;2021-05-09;285;9;22361;13113;29.3;17.2
48;2021-05-10;55;325;22416;13438;29.4;17.6
48;2021-05-11;221;291;22637;13729;29.7;18.0
48;2021-05-12;249;312;22886;14041;30.0;18.4
48;2021-05-13;472;157;23358;14198;30.6;18.6
48;2021-05-14;244;221;23602;14419;30.9;18.9
48;2021-05-15;84;47;23686;14466;31.0;19.0
48;2021-05-16;1;8;23687;14474;31.1;19.0
48;2021-05-17;474;266;24161;14740;31.7;19.3
48;2021-05-18;263;228;24424;14968;32.0;19.6
48;2021-05-19;207;278;24631;15246;32.3;20.0
48;2021-05-20;320;254;24951;15500;32.7;20.3
48;2021-05-21;172;267;25123;15767;32.9;20.7
48;2021-05-22;25;50;25148;15817;33.0;20.7
48;2021-05-23;0;6;25148;15823;33.0;20.7
48;2021-05-24;0;14;25148;15837;33.0;20.8
48;2021-05-25;180;265;25328;16102;33.2;21.1
48;2021-05-26;416;298;25744;16400;33.7;21.5
48;2021-05-27;1176;374;26920;16774;35.3;22.0
48;2021-05-28;315;343;27235;17117;35.7;22.4
48;2021-05-29;79;50;27314;17167;35.8;22.5
48;2021-05-30;0;1;27314;17168;35.8;22.5
48;2021-05-31;625;263;27939;17431;36.6;22.8
48;2021-06-01;272;305;28211;17736;37.0;23.2
48;2021-06-02;407;423;28618;18159;37.5;23.8
48;2021-06-03;628;428;29246;18587;38.3;24.4
48;2021-06-04;291;280;29537;18867;38.7;24.7
48;2021-06-05;121;75;29658;18942;38.9;24.8
48;2021-06-06;1;1;29659;18943;38.9;24.8
48;2021-06-07;440;161;30099;19104;39.5;25.0
48;2021-06-08;613;304;30712;19408;40.3;25.4
48;2021-06-09;379;188;31091;19596;40.8;25.7
48;2021-06-10;1000;235;32091;19831;42.1;26.0
48;2021-06-11;372;159;32463;19990;42.6;26.2
48;2021-06-12;74;56;32537;20046;42.7;26.3
48;2021-06-13;0;2;32537;20048;42.7;26.3
48;2021-06-14;124;115;32661;20163;42.8;26.4
48;2021-06-15;407;384;33068;20547;43.3;26.9
48;2021-06-16;259;143;33327;20690;43.7;27.1
48;2021-06-17;486;574;33813;21264;44.3;27.9
48;2021-06-18;254;312;34067;21576;44.7;28.3
48;2021-06-19;35;291;34102;21867;44.7;28.7
48;2021-06-20;123;224;34225;22091;44.9;29.0
48;2021-06-21;125;132;34350;22223;45.0;29.1
48;2021-06-22;258;332;34608;22555;45.4;29.6
48;2021-06-23;111;546;34719;23101;45.5;30.3
48;2021-06-24;364;606;35083;23707;46.0;31.1
48;2021-06-25;148;274;35231;23981;46.2;31.4
48;2021-06-26;14;45;35245;24026;46.2;31.5
48;2021-06-27;1;1;35246;24027;46.2;31.5
48;2021-06-28;81;177;35327;24204;46.3;31.7
48;2021-06-29;298;413;35625;24617;46.7;32.3
48;2021-06-30;96;465;35721;25082;46.8;32.9
48;2021-07-01;196;664;35917;25746;47.1;33.7
48;2021-07-02;148;368;36065;26114;47.3;34.2
48;2021-07-03;41;89;36106;26203;47.3;34.3
48;2021-07-04;7;0;36113;26203;47.3;34.3
48;2021-07-05;40;116;36153;26319;47.4;34.5
48;2021-07-06;277;597;36430;26916;47.8;35.3
48;2021-07-07;200;484;36630;27400;48.0;35.9
48;2021-07-08;222;1189;36852;28589;48.3;37.5
48;2021-07-09;156;551;37008;29140;48.5;38.2
48;2021-07-10;95;147;37103;29287;48.6;38.4
48;2021-07-11;0;4;37103;29291;48.6;38.4
48;2021-07-12;140;672;37243;29963;48.8;39.3
48;2021-07-13;213;431;37456;30394;49.1;39.8
48;2021-07-14;178;142;37634;30536;49.3;40.0
48;2021-07-15;187;458;37821;30994;49.6;40.6
48;2021-07-16;233;313;38054;31307;49.9;41.0
48;2021-07-17;127;117;38181;31424;50.0;41.2
48;2021-07-18;4;4;38185;31428;50.1;41.2
48;2021-07-19;102;303;38287;31731;50.2;41.6
48;2021-07-20;600;993;38887;32724;51.0;42.9
48;2021-07-21;68;371;38955;33095;51.1;43.4
48;2021-07-22;778;1121;39733;34216;52.1;44.9
48;2021-07-23;354;435;40087;34651;52.5;45.4
48;2021-07-24;505;167;40592;34818;53.2;45.6
48;2021-07-25;137;46;40729;34864;53.4;45.7
48;2021-07-26;100;198;40829;35062;53.5;46.0
48;2021-07-27;1190;641;42019;35703;55.1;46.8
48;2021-07-28;176;316;42195;36019;55.3;47.2
48;2021-07-29;702;634;42897;36653;56.2;48.0
48;2021-07-30;200;291;43097;36944;56.5;48.4
48;2021-07-31;335;174;43432;37118;56.9;48.7
48;2021-08-01;18;55;43450;37173;57.0;48.7
48;2021-08-02;225;158;43675;37331;57.3;48.9
48;2021-08-03;892;555;44567;37886;58.4;49.7
48;2021-08-04;326;218;44893;38104;58.8;49.9
48;2021-08-05;670;465;45563;38569;59.7;50.6
49;2020-12-27;0;0;0;0;0.0;0.0
49;2020-12-28;2;0;2;0;0.0;0.0
49;2020-12-29;0;0;2;0;0.0;0.0
49;2020-12-30;0;0;2;0;0.0;0.0
49;2020-12-31;0;0;2;0;0.0;0.0
49;2021-01-01;2;0;4;0;0.0;0.0
49;2021-01-02;1;1;5;1;0.0;0.0
49;2021-01-03;0;0;5;1;0.0;0.0
49;2021-01-04;9;0;14;1;0.0;0.0
49;2021-01-05;92;0;106;1;0.0;0.0
49;2021-01-06;232;0;338;1;0.0;0.0
49;2021-01-07;366;0;704;1;0.1;0.0
49;2021-01-08;330;1;1034;2;0.1;0.0
49;2021-01-09;118;0;1152;2;0.1;0.0
49;2021-01-10;114;0;1266;2;0.2;0.0
49;2021-01-11;287;0;1553;2;0.2;0.0
49;2021-01-12;622;0;2175;2;0.3;0.0
49;2021-01-13;601;2;2776;4;0.3;0.0
49;2021-01-14;589;6;3365;10;0.4;0.0
49;2021-01-15;774;1;4139;11;0.5;0.0
49;2021-01-16;147;0;4286;11;0.5;0.0
49;2021-01-17;111;2;4397;13;0.5;0.0
49;2021-01-18;691;0;5088;13;0.6;0.0
49;2021-01-19;1204;1;6292;14;0.8;0.0
49;2021-01-20;1508;3;7800;17;1.0;0.0
49;2021-01-21;1937;4;9737;21;1.2;0.0
49;2021-01-22;1317;4;11054;25;1.4;0.0
49;2021-01-23;263;1;11317;26;1.4;0.0
49;2021-01-24;0;0;11317;26;1.4;0.0
49;2021-01-25;549;5;11866;31;1.5;0.0
49;2021-01-26;987;75;12853;106;1.6;0.0
49;2021-01-27;1852;37;14705;143;1.8;0.0
49;2021-01-28;2876;86;17581;229;2.2;0.0
49;2021-01-29;1589;94;19170;323;2.3;0.0
49;2021-01-30;300;47;19470;370;2.4;0.0
49;2021-01-31;62;51;19532;421;2.4;0.1
49;2021-02-01;659;156;20191;577;2.5;0.1
49;2021-02-02;743;386;20934;963;2.6;0.1
49;2021-02-03;675;380;21609;1343;2.6;0.2
49;2021-02-04;757;445;22366;1788;2.7;0.2
49;2021-02-05;706;597;23072;2385;2.8;0.3
49;2021-02-06;229;111;23301;2496;2.9;0.3
49;2021-02-07;59;85;23360;2581;2.9;0.3
49;2021-02-08;549;481;23909;3062;2.9;0.4
49;2021-02-09;711;647;24620;3709;3.0;0.5
49;2021-02-10;802;951;25422;4660;3.1;0.6
49;2021-02-11;1000;1409;26422;6069;3.2;0.7
49;2021-02-12;869;977;27291;7046;3.3;0.9
49;2021-02-13;266;117;27557;7163;3.4;0.9
49;2021-02-14;9;106;27566;7269;3.4;0.9
49;2021-02-15;733;664;28299;7933;3.5;1.0
49;2021-02-16;1110;1124;29409;9057;3.6;1.1
49;2021-02-17;1159;1870;30568;10927;3.7;1.3
49;2021-02-18;1810;2439;32378;13366;4.0;1.6
49;2021-02-19;1395;1108;33773;14474;4.1;1.8
49;2021-02-20;233;384;34006;14858;4.2;1.8
49;2021-02-21;0;64;34006;14922;4.2;1.8
49;2021-02-22;646;582;34652;15504;4.2;1.9
49;2021-02-23;735;862;35387;16366;4.3;2.0
49;2021-02-24;818;644;36205;17010;4.4;2.1
49;2021-02-25;1207;819;37412;17829;4.6;2.2
49;2021-02-26;1668;850;39080;18679;4.8;2.3
49;2021-02-27;435;282;39515;18961;4.8;2.3
49;2021-02-28;49;38;39564;18999;4.8;2.3
49;2021-03-01;766;583;40330;19582;4.9;2.4
49;2021-03-02;1083;702;41413;20284;5.1;2.5
49;2021-03-03;1556;673;42969;20957;5.3;2.6
49;2021-03-04;1766;937;44735;21894;5.5;2.7
49;2021-03-05;2213;695;46948;22589;5.8;2.8
49;2021-03-06;715;187;47663;22776;5.8;2.8
49;2021-03-07;627;12;48290;22788;5.9;2.8
49;2021-03-08;1395;712;49685;23500;6.1;2.9
49;2021-03-09;2051;742;51736;24242;6.3;3.0
49;2021-03-10;2526;862;54262;25104;6.7;3.1
49;2021-03-11;3194;1466;57456;26570;7.0;3.3
49;2021-03-12;3766;1003;61222;27573;7.5;3.4
49;2021-03-13;1499;219;62721;27792;7.7;3.4
49;2021-03-14;6;0;62727;27792;7.7;3.4
49;2021-03-15;2084;540;64811;28332;7.9;3.5
49;2021-03-16;1732;961;66543;29293;8.2;3.6
49;2021-03-17;1811;668;68354;29961;8.4;3.7
49;2021-03-18;2199;729;70553;30690;8.6;3.8
49;2021-03-19;3330;561;73883;31251;9.1;3.8
49;2021-03-20;1743;207;75626;31458;9.3;3.9
49;2021-03-21;497;23;76123;31481;9.3;3.9
49;2021-03-22;2247;545;78370;32026;9.6;3.9
49;2021-03-23;3402;675;81772;32701;10.0;4.0
49;2021-03-24;3601;495;85373;33196;10.5;4.1
49;2021-03-25;4225;641;89598;33837;11.0;4.1
49;2021-03-26;4883;500;94481;34337;11.6;4.2
49;2021-03-27;1673;98;96154;34435;11.8;4.2
49;2021-03-28;399;30;96553;34465;11.8;4.2
49;2021-03-29;2371;609;98924;35074;12.1;4.3
49;2021-03-30;3266;939;102190;36013;12.5;4.4
49;2021-03-31;2977;748;105167;36761;12.9;4.5
49;2021-04-01;4120;863;109287;37624;13.4;4.6
49;2021-04-02;4294;934;113581;38558;13.9;4.7
49;2021-04-03;971;195;114552;38753;14.0;4.7
49;2021-04-04;314;3;114866;38756;14.1;4.8
49;2021-04-05;941;21;115807;38777;14.2;4.8
49;2021-04-06;2331;1321;118138;40098;14.5;4.9
49;2021-04-07;3308;1366;121446;41464;14.9;5.1
49;2021-04-08;5180;1403;126626;42867;15.5;5.3
49;2021-04-09;6207;1417;132833;44284;16.3;5.4
49;2021-04-10;2067;493;134900;44777;16.5;5.5
49;2021-04-11;389;7;135289;44784;16.6;5.5
49;2021-04-12;4073;1573;139362;46357;17.1;5.7
49;2021-04-13;5379;1909;144741;48266;17.7;5.9
49;2021-04-14;4539;1865;149280;50131;18.3;6.1
49;2021-04-15;5378;1890;154658;52021;19.0;6.4
49;2021-04-16;5758;2133;160416;54154;19.7;6.6
49;2021-04-17;3336;844;163752;54998;20.1;6.7
49;2021-04-18;381;477;164133;55475;20.1;6.8
49;2021-04-19;3710;2059;167843;57534;20.6;7.1
49;2021-04-20;4373;2112;172216;59646;21.1;7.3
49;2021-04-21;3954;2204;176170;61850;21.6;7.6
49;2021-04-22;4834;2101;181004;63951;22.2;7.8
49;2021-04-23;4810;2330;185814;66281;22.8;8.1
49;2021-04-24;2938;1155;188752;67436;23.1;8.3
49;2021-04-25;40;282;188792;67718;23.1;8.3
49;2021-04-26;3741;2121;192533;69839;23.6;8.6
49;2021-04-27;4472;2507;197005;72346;24.1;8.9
49;2021-04-28;4615;2491;201620;74837;24.7;9.2
49;2021-04-29;5206;3016;206826;77853;25.4;9.5
49;2021-04-30;5553;3199;212379;81052;26.0;9.9
49;2021-05-01;2364;664;214743;81716;26.3;10.0
49;2021-05-02;4;40;214747;81756;26.3;10.0
49;2021-05-03;5012;2405;219759;84161;26.9;10.3
49;2021-05-04;4969;3043;224728;87204;27.5;10.7
49;2021-05-05;4785;3002;229513;90206;28.1;11.1
49;2021-05-06;5329;3080;234842;93286;28.8;11.4
49;2021-05-07;4275;5027;239117;98313;29.3;12.0
49;2021-05-08;3576;436;242693;98749;29.7;12.1
49;2021-05-09;9;41;242702;98790;29.7;12.1
49;2021-05-10;4830;4276;247532;103066;30.3;12.6
49;2021-05-11;5397;5088;252929;108154;31.0;13.3
49;2021-05-12;4802;4593;257731;112747;31.6;13.8
49;2021-05-13;4778;684;262509;113431;32.2;13.9
49;2021-05-14;5172;3271;267681;116702;32.8;14.3
49;2021-05-15;4156;1807;271837;118509;33.3;14.5
49;2021-05-16;2788;117;274625;118626;33.7;14.5
49;2021-05-17;4832;3683;279457;122309;34.3;15.0
49;2021-05-18;5467;3759;284924;126068;34.9;15.5
49;2021-05-19;5916;3228;290840;129296;35.6;15.8
49;2021-05-20;6790;2964;297630;132260;36.5;16.2
49;2021-05-21;6456;3742;304086;136002;37.3;16.7
49;2021-05-22;5185;1191;309271;137193;37.9;16.8
49;2021-05-23;1;12;309272;137205;37.9;16.8
49;2021-05-24;4218;445;313490;137650;38.4;16.9
49;2021-05-25;6331;3313;319821;140963;39.2;17.3
49;2021-05-26;6273;2662;326094;143625;40.0;17.6
49;2021-05-27;7107;2719;333201;146344;40.8;17.9
49;2021-05-28;6876;4011;340077;150355;41.7;18.4
49;2021-05-29;5024;1896;345101;152251;42.3;18.7
49;2021-05-30;20;13;345121;152264;42.3;18.7
49;2021-05-31;6039;3216;351160;155480;43.0;19.1
49;2021-06-01;6588;3974;357748;159454;43.8;19.5
49;2021-06-02;5792;3740;363540;163194;44.6;20.0
49;2021-06-03;6603;3418;370143;166612;45.4;20.4
49;2021-06-04;6470;4857;376613;171469;46.2;21.0
49;2021-06-05;4386;2695;380999;174164;46.7;21.3
49;2021-06-06;35;52;381034;174216;46.7;21.4
49;2021-06-07;4632;4762;385666;178978;47.3;21.9
49;2021-06-08;5185;5094;390851;184072;47.9;22.6
49;2021-06-09;5320;4499;396171;188571;48.6;23.1
49;2021-06-10;5992;3782;402163;192353;49.3;23.6
49;2021-06-11;4852;6031;407015;198384;49.9;24.3
49;2021-06-12;4102;3202;411117;201586;50.4;24.7
49;2021-06-13;19;989;411136;202575;50.4;24.8
49;2021-06-14;3408;6010;414544;208585;50.8;25.6
49;2021-06-15;4242;6397;418786;214982;51.3;26.3
49;2021-06-16;4147;5679;422933;220661;51.8;27.0
49;2021-06-17;5069;5076;428002;225737;52.5;27.7
49;2021-06-18;4129;6881;432131;232618;53.0;28.5
49;2021-06-19;3525;3971;435656;236589;53.4;29.0
49;2021-06-20;29;23;435685;236612;53.4;29.0
49;2021-06-21;2825;6509;438510;243121;53.7;29.8
49;2021-06-22;3200;7003;441710;250124;54.1;30.7
49;2021-06-23;3253;6312;444963;256436;54.5;31.4
49;2021-06-24;4308;4972;449271;261408;55.1;32.0
49;2021-06-25;3318;7439;452589;268847;55.5;33.0
49;2021-06-26;2567;4629;455156;273476;55.8;33.5
49;2021-06-27;13;1543;455169;275019;55.8;33.7
49;2021-06-28;2230;7173;457399;282192;56.1;34.6
49;2021-06-29;3023;7256;460422;289448;56.4;35.5
49;2021-06-30;2809;6804;463231;296252;56.8;36.3
49;2021-07-01;3080;6267;466311;302519;57.2;37.1
49;2021-07-02;2897;8074;469208;310593;57.5;38.1
49;2021-07-03;1990;5488;471198;316081;57.8;38.7
49;2021-07-04;6;53;471204;316134;57.8;38.7
49;2021-07-05;1624;7079;472828;323213;58.0;39.6
49;2021-07-06;1883;7558;474711;330771;58.2;40.5
49;2021-07-07;2053;6627;476764;337398;58.4;41.4
49;2021-07-08;2505;6358;479269;343756;58.7;42.1
49;2021-07-09;2297;8255;481566;352011;59.0;43.1
49;2021-07-10;1776;5341;483342;357352;59.2;43.8
49;2021-07-11;11;35;483353;357387;59.2;43.8
49;2021-07-12;1915;7724;485268;365111;59.5;44.8
49;2021-07-13;2552;8308;487820;373419;59.8;45.8
49;2021-07-14;2876;3372;490696;376791;60.1;46.2
49;2021-07-15;3110;7559;493806;384350;60.5;47.1
49;2021-07-16;3301;8309;497107;392659;60.9;48.1
49;2021-07-17;2066;5489;499173;398148;61.2;48.8
49;2021-07-18;3737;570;502910;398718;61.6;48.9
49;2021-07-19;2557;7457;505467;406175;62.0;49.8
49;2021-07-20;3345;7486;508812;413661;62.4;50.7
49;2021-07-21;4141;6463;512953;420124;62.9;51.5
49;2021-07-22;4637;5849;517590;425973;63.4;52.2
49;2021-07-23;4904;6622;522494;432595;64.0;53.0
49;2021-07-24;3589;4997;526083;437592;64.5;53.6
49;2021-07-25;37;32;526120;437624;64.5;53.6
49;2021-07-26;4169;5892;530289;443516;65.0;54.4
49;2021-07-27;5544;5440;535833;448956;65.7;55.0
49;2021-07-28;5926;4347;541759;453303;66.4;55.6
49;2021-07-29;6541;4130;548300;457433;67.2;56.1
49;2021-07-30;6009;4779;554309;462212;67.9;56.7
49;2021-07-31;3937;3408;558246;465620;68.4;57.1
49;2021-08-01;18;22;558264;465642;68.4;57.1
49;2021-08-02;4252;4634;562516;470276;68.9;57.6
49;2021-08-03;5408;3788;567924;474064;69.6;58.1
49;2021-08-04;5190;3680;573114;477744;70.2;58.6
49;2021-08-05;5216;3269;578330;481013;70.9;59.0
50;2020-12-27;0;0;0;0;0.0;0.0
50;2020-12-28;0;0;0;0;0.0;0.0
50;2020-12-29;1;0;1;0;0.0;0.0
50;2020-12-30;0;0;1;0;0.0;0.0
50;2020-12-31;0;0;1;0;0.0;0.0
50;2021-01-01;0;0;1;0;0.0;0.0
50;2021-01-02;0;0;1;0;0.0;0.0
50;2021-01-03;0;0;1;0;0.0;0.0
50;2021-01-04;1;0;2;0;0.0;0.0
50;2021-01-05;0;0;2;0;0.0;0.0
50;2021-01-06;126;0;128;0;0.0;0.0
50;2021-01-07;321;0;449;0;0.1;0.0
50;2021-01-08;436;2;885;2;0.2;0.0
50;2021-01-09;236;0;1121;2;0.2;0.0
50;2021-01-10;23;0;1144;2;0.2;0.0
50;2021-01-11;389;1;1533;3;0.3;0.0
50;2021-01-12;600;0;2133;3;0.4;0.0
50;2021-01-13;694;4;2827;7;0.6;0.0
50;2021-01-14;1046;4;3873;11;0.8;0.0
50;2021-01-15;708;2;4581;13;0.9;0.0
50;2021-01-16;214;3;4795;16;1.0;0.0
50;2021-01-17;0;0;4795;16;1.0;0.0
50;2021-01-18;619;0;5414;16;1.1;0.0
50;2021-01-19;892;1;6306;17;1.3;0.0
50;2021-01-20;965;0;7271;17;1.5;0.0
50;2021-01-21;917;4;8188;21;1.7;0.0
50;2021-01-22;713;2;8901;23;1.8;0.0
50;2021-01-23;667;4;9568;27;1.9;0.0
50;2021-01-24;880;2;10448;29;2.1;0.0
50;2021-01-25;2670;10;13118;39;2.7;0.0
50;2021-01-26;1335;13;14453;52;2.9;0.0
50;2021-01-27;747;55;15200;107;3.1;0.0
50;2021-01-28;718;169;15918;276;3.2;0.1
50;2021-01-29;580;306;16498;582;3.4;0.1
50;2021-01-30;381;165;16879;747;3.4;0.2
50;2021-01-31;0;0;16879;747;3.4;0.2
50;2021-02-01;449;225;17328;972;3.5;0.2
50;2021-02-02;416;236;17744;1208;3.6;0.2
50;2021-02-03;390;378;18134;1586;3.7;0.3
50;2021-02-04;483;453;18617;2039;3.8;0.4
50;2021-02-05;422;449;19039;2488;3.9;0.5
50;2021-02-06;178;114;19217;2602;3.9;0.5
50;2021-02-07;0;0;19217;2602;3.9;0.5
50;2021-02-08;255;509;19472;3111;4.0;0.6
50;2021-02-09;245;643;19717;3754;4.0;0.8
50;2021-02-10;570;558;20287;4312;4.1;0.9
50;2021-02-11;438;915;20725;5227;4.2;1.1
50;2021-02-12;329;672;21054;5899;4.3;1.2
50;2021-02-13;305;489;21359;6388;4.4;1.3
50;2021-02-14;185;826;21544;7214;4.4;1.5
50;2021-02-15;661;2021;22205;9235;4.5;1.9
50;2021-02-16;743;1623;22948;10858;4.7;2.2
50;2021-02-17;632;828;23580;11686;4.8;2.4
50;2021-02-18;570;810;24150;12496;4.9;2.5
50;2021-02-19;629;523;24779;13019;5.1;2.7
50;2021-02-20;423;193;25202;13212;5.1;2.7
50;2021-02-21;85;29;25287;13241;5.2;2.7
50;2021-02-22;291;727;25578;13968;5.2;2.8
50;2021-02-23;502;568;26080;14536;5.3;3.0
50;2021-02-24;623;571;26703;15107;5.4;3.1
50;2021-02-25;778;591;27481;15698;5.6;3.2
50;2021-02-26;999;399;28480;16097;5.8;3.3
50;2021-02-27;887;112;29367;16209;6.0;3.3
50;2021-02-28;111;0;29478;16209;6.0;3.3
50;2021-03-01;489;559;29967;16768;6.1;3.4
50;2021-03-02;650;519;30617;17287;6.2;3.5
50;2021-03-03;797;458;31414;17745;6.4;3.6
50;2021-03-04;1248;340;32662;18085;6.7;3.7
50;2021-03-05;1550;349;34212;18434;7.0;3.8
50;2021-03-06;1319;160;35531;18594;7.2;3.8
50;2021-03-07;549;43;36080;18637;7.4;3.8
50;2021-03-08;1024;620;37104;19257;7.6;3.9
50;2021-03-09;1554;575;38658;19832;7.9;4.0
50;2021-03-10;1605;322;40263;20154;8.2;4.1
50;2021-03-11;2352;355;42615;20509;8.7;4.2
50;2021-03-12;2866;245;45481;20754;9.3;4.2
50;2021-03-13;1992;134;47473;20888;9.7;4.3
50;2021-03-14;279;41;47752;20929;9.7;4.3
50;2021-03-15;1377;296;49129;21225;10.0;4.3
50;2021-03-16;1339;281;50468;21506;10.3;4.4
50;2021-03-17;1295;410;51763;21916;10.5;4.5
50;2021-03-18;1160;424;52923;22340;10.8;4.6
50;2021-03-19;1731;590;54654;22930;11.1;4.7
50;2021-03-20;1683;224;56337;23154;11.5;4.7
50;2021-03-21;794;10;57131;23164;11.6;4.7
50;2021-03-22;1507;335;58638;23499;12.0;4.8
50;2021-03-23;2070;395;60708;23894;12.4;4.9
50;2021-03-24;2279;553;62987;24447;12.8;5.0
50;2021-03-25;2808;465;65795;24912;13.4;5.1
50;2021-03-26;3205;467;69000;25379;14.1;5.2
50;2021-03-27;1823;375;70823;25754;14.4;5.2
50;2021-03-28;403;18;71226;25772;14.5;5.3
50;2021-03-29;2137;719;73363;26491;15.0;5.4
50;2021-03-30;2282;647;75645;27138;15.4;5.5
50;2021-03-31;2478;569;78123;27707;15.9;5.6
50;2021-04-01;3100;860;81223;28567;16.6;5.8
50;2021-04-02;2962;942;84185;29509;17.2;6.0
50;2021-04-03;1245;690;85430;30199;17.4;6.2
50;2021-04-04;321;134;85751;30333;17.5;6.2
50;2021-04-05;400;27;86151;30360;17.6;6.2
50;2021-04-06;2125;1224;88276;31584;18.0;6.4
50;2021-04-07;2560;1180;90836;32764;18.5;6.7
50;2021-04-08;3596;1222;94432;33986;19.2;6.9
50;2021-04-09;3933;1294;98365;35280;20.0;7.2
50;2021-04-10;2535;880;100900;36160;20.6;7.4
50;2021-04-11;411;147;101311;36307;20.6;7.4
50;2021-04-12;2438;1383;103749;37690;21.1;7.7
50;2021-04-13;2677;1536;106426;39226;21.7;8.0
50;2021-04-14;2608;1348;109034;40574;22.2;8.3
50;2021-04-15;3160;1109;112194;41683;22.9;8.5
50;2021-04-16;3364;1100;115558;42783;23.6;8.7
50;2021-04-17;2400;1184;117958;43967;24.0;9.0
50;2021-04-18;425;663;118383;44630;24.1;9.1
50;2021-04-19;2000;1474;120383;46104;24.5;9.4
50;2021-04-20;2277;1589;122660;47693;25.0;9.7
50;2021-04-21;2551;1760;125211;49453;25.5;10.1
50;2021-04-22;3078;1823;128289;51276;26.1;10.5
50;2021-04-23;2754;1907;131043;53183;26.7;10.8
50;2021-04-24;1897;1434;132940;54617;27.1;11.1
50;2021-04-25;470;272;133410;54889;27.2;11.2
50;2021-04-26;2120;1889;135530;56778;27.6;11.6
50;2021-04-27;2409;1999;137939;58777;28.1;12.0
50;2021-04-28;2708;1968;140647;60745;28.7;12.4
50;2021-04-29;3285;2039;143932;62784;29.3;12.8
50;2021-04-30;2997;1927;146929;64711;29.9;13.2
50;2021-05-01;1013;592;147942;65303;30.2;13.3
50;2021-05-02;523;448;148465;65751;30.3;13.4
50;2021-05-03;1767;1805;150232;67556;30.6;13.8
50;2021-05-04;1773;2325;152005;69881;31.0;14.2
50;2021-05-05;1661;2955;153666;72836;31.3;14.8
50;2021-05-06;2532;2580;156198;75416;31.8;15.4
50;2021-05-07;2150;2861;158348;78277;32.3;16.0
50;2021-05-08;1167;790;159515;79067;32.5;16.1
50;2021-05-09;624;361;160139;79428;32.6;16.2
50;2021-05-10;1704;2604;161843;82032;33.0;16.7
50;2021-05-11;2543;2844;164386;84876;33.5;17.3
50;2021-05-12;3179;2437;167565;87313;34.2;17.8
50;2021-05-13;3381;610;170946;87923;34.8;17.9
50;2021-05-14;3571;2278;174517;90201;35.6;18.4
50;2021-05-15;3998;1872;178515;92073;36.4;18.8
50;2021-05-16;946;267;179461;92340;36.6;18.8
50;2021-05-17;2138;1875;181599;94215;37.0;19.2
50;2021-05-18;2522;1622;184121;95837;37.5;19.5
50;2021-05-19;2504;1440;186625;97277;38.0;19.8
50;2021-05-20;3255;1623;189880;98900;38.7;20.2
50;2021-05-21;3158;1913;193038;100813;39.3;20.5
50;2021-05-22;2651;1327;195689;102140;39.9;20.8
50;2021-05-23;604;285;196293;102425;40.0;20.9
50;2021-05-24;1527;490;197820;102915;40.3;21.0
50;2021-05-25;2450;1675;200270;104590;40.8;21.3
50;2021-05-26;2994;1449;203264;106039;41.4;21.6
50;2021-05-27;3030;1970;206294;108009;42.0;22.0
50;2021-05-28;2946;2121;209240;110130;42.6;22.4
50;2021-05-29;2758;1402;211998;111532;43.2;22.7
50;2021-05-30;812;323;212810;111855;43.4;22.8
50;2021-05-31;2652;1815;215462;113670;43.9;23.2
50;2021-06-01;3332;2065;218794;115735;44.6;23.6
50;2021-06-02;3258;1786;222052;117521;45.3;24.0
50;2021-06-03;3912;2061;225964;119582;46.1;24.4
50;2021-06-04;3823;2881;229787;122463;46.8;25.0
50;2021-06-05;2959;1847;232746;124310;47.4;25.3
50;2021-06-06;813;444;233559;124754;47.6;25.4
50;2021-06-07;3514;2083;237073;126837;48.3;25.8
50;2021-06-08;4072;2225;241145;129062;49.1;26.3
50;2021-06-09;4252;1991;245397;131053;50.0;26.7
50;2021-06-10;4191;2115;249588;133168;50.9;27.1
50;2021-06-11;4225;2710;253813;135878;51.7;27.7
50;2021-06-12;3735;1605;257548;137483;52.5;28.0
50;2021-06-13;1142;451;258690;137934;52.7;28.1
50;2021-06-14;2690;2965;261380;140899;53.3;28.7
50;2021-06-15;3019;2601;264399;143500;53.9;29.2
50;2021-06-16;3098;1970;267497;145470;54.5;29.6
50;2021-06-17;2794;2483;270291;147953;55.1;30.2
50;2021-06-18;3240;3046;273531;150999;55.7;30.8
50;2021-06-19;3176;1921;276707;152920;56.4;31.2
50;2021-06-20;731;710;277438;153630;56.5;31.3
50;2021-06-21;1817;3132;279255;156762;56.9;31.9
50;2021-06-22;2062;3392;281317;160154;57.3;32.6
50;2021-06-23;1868;3872;283185;164026;57.7;33.4
50;2021-06-24;1711;4011;284896;168037;58.1;34.2
50;2021-06-25;2133;4006;287029;172043;58.5;35.1
50;2021-06-26;2136;3696;289165;175739;58.9;35.8
50;2021-06-27;612;893;289777;176632;59.1;36.0
50;2021-06-28;1925;3353;291702;179985;59.4;36.7
50;2021-06-29;1878;3399;293580;183384;59.8;37.4
50;2021-06-30;2173;3404;295753;186788;60.3;38.1
50;2021-07-01;1940;3276;297693;190064;60.7;38.7
50;2021-07-02;1887;3934;299580;193998;61.1;39.5
50;2021-07-03;1440;3447;301020;197445;61.3;40.2
50;2021-07-04;444;1069;301464;198514;61.4;40.5
50;2021-07-05;1263;3410;302727;201924;61.7;41.2
50;2021-07-06;1560;3891;304287;205815;62.0;41.9
50;2021-07-07;1786;3621;306073;209436;62.4;42.7
50;2021-07-08;1365;4105;307438;213541;62.7;43.5
50;2021-07-09;1384;4587;308822;218128;62.9;44.5
50;2021-07-10;1015;3612;309837;221740;63.1;45.2
50;2021-07-11;367;1022;310204;222762;63.2;45.4
50;2021-07-12;1304;4638;311508;227400;63.5;46.3
50;2021-07-13;1611;4873;313119;232273;63.8;47.3
50;2021-07-14;1471;2361;314590;234634;64.1;47.8
50;2021-07-15;1671;5062;316261;239696;64.5;48.9
50;2021-07-16;2960;5252;319221;244948;65.1;49.9
50;2021-07-17;2126;3732;321347;248680;65.5;50.7
50;2021-07-18;401;1093;321748;249773;65.6;50.9
50;2021-07-19;1558;5189;323306;254962;65.9;52.0
50;2021-07-20;1917;5417;325223;260379;66.3;53.1
50;2021-07-21;1776;5265;326999;265644;66.6;54.1
50;2021-07-22;1919;5004;328918;270648;67.0;55.2
50;2021-07-23;2053;5391;330971;276039;67.5;56.3
50;2021-07-24;1303;3839;332274;279878;67.7;57.0
50;2021-07-25;267;1040;332541;280918;67.8;57.3
50;2021-07-26;2271;3498;334812;284416;68.2;58.0
50;2021-07-27;2878;3351;337690;287767;68.8;58.6
50;2021-07-28;2967;3681;340657;291448;69.4;59.4
50;2021-07-29;3542;3230;344199;294678;70.1;60.1
50;2021-07-30;3049;3002;347248;297680;70.8;60.7
50;2021-07-31;2377;2667;349625;300347;71.3;61.2
50;2021-08-01;481;683;350106;301030;71.4;61.4
50;2021-08-02;2445;2735;352551;303765;71.9;61.9
50;2021-08-03;3371;2452;355922;306217;72.5;62.4
50;2021-08-04;3569;2314;359491;308531;73.3;62.9
50;2021-08-05;3120;2133;362611;310664;73.9;63.3
51;2020-12-27;0;0;0;0;0.0;0.0
51;2020-12-28;0;0;0;0;0.0;0.0
51;2020-12-29;0;0;0;0;0.0;0.0
51;2020-12-30;0;0;0;0;0.0;0.0
51;2020-12-31;1;0;1;0;0.0;0.0
51;2021-01-01;0;0;1;0;0.0;0.0
51;2021-01-02;0;0;1;0;0.0;0.0
51;2021-01-03;0;0;1;0;0.0;0.0
51;2021-01-04;1;0;2;0;0.0;0.0
51;2021-01-05;1;0;3;0;0.0;0.0
51;2021-01-06;6;0;9;0;0.0;0.0
51;2021-01-07;261;1;270;1;0.0;0.0
51;2021-01-08;506;1;776;2;0.1;0.0
51;2021-01-09;91;0;867;2;0.2;0.0
51;2021-01-10;0;0;867;2;0.2;0.0
51;2021-01-11;544;2;1411;4;0.3;0.0
51;2021-01-12;1537;4;2948;8;0.5;0.0
51;2021-01-13;1288;5;4236;13;0.8;0.0
51;2021-01-14;1467;6;5703;19;1.0;0.0
51;2021-01-15;605;3;6308;22;1.1;0.0
51;2021-01-16;177;1;6485;23;1.2;0.0
51;2021-01-17;101;0;6586;23;1.2;0.0
51;2021-01-18;843;3;7429;26;1.3;0.0
51;2021-01-19;997;4;8426;30;1.5;0.0
51;2021-01-20;954;7;9380;37;1.7;0.0
51;2021-01-21;790;3;10170;40;1.8;0.0
51;2021-01-22;392;2;10562;42;1.9;0.0
51;2021-01-23;294;0;10856;42;1.9;0.0
51;2021-01-24;130;1;10986;43;1.9;0.0
51;2021-01-25;712;3;11698;46;2.1;0.0
51;2021-01-26;778;5;12476;51;2.2;0.0
51;2021-01-27;656;3;13132;54;2.3;0.0
51;2021-01-28;645;70;13777;124;2.4;0.0
51;2021-01-29;472;142;14249;266;2.5;0.0
51;2021-01-30;126;5;14375;271;2.5;0.0
51;2021-01-31;83;0;14458;271;2.6;0.0
51;2021-02-01;275;58;14733;329;2.6;0.1
51;2021-02-02;737;722;15470;1051;2.7;0.2
51;2021-02-03;642;470;16112;1521;2.9;0.3
51;2021-02-04;970;822;17082;2343;3.0;0.4
51;2021-02-05;972;514;18054;2857;3.2;0.5
51;2021-02-06;30;149;18084;3006;3.2;0.5
51;2021-02-07;0;18;18084;3024;3.2;0.5
51;2021-02-08;115;415;18199;3439;3.2;0.6
51;2021-02-09;222;471;18421;3910;3.3;0.7
51;2021-02-10;219;640;18640;4550;3.3;0.8
51;2021-02-11;298;528;18938;5078;3.4;0.9
51;2021-02-12;340;565;19278;5643;3.4;1.0
51;2021-02-13;8;116;19286;5759;3.4;1.0
51;2021-02-14;8;171;19294;5930;3.4;1.1
51;2021-02-15;265;854;19559;6784;3.5;1.2
51;2021-02-16;401;972;19960;7756;3.5;1.4
51;2021-02-17;367;879;20327;8635;3.6;1.5
51;2021-02-18;435;594;20762;9229;3.7;1.6
51;2021-02-19;530;422;21292;9651;3.8;1.7
51;2021-02-20;205;296;21497;9947;3.8;1.8
51;2021-02-21;10;101;21507;10048;3.8;1.8
51;2021-02-22;195;690;21702;10738;3.8;1.9
51;2021-02-23;262;1100;21964;11838;3.9;2.1
51;2021-02-24;413;697;22377;12535;4.0;2.2
51;2021-02-25;1050;887;23427;13422;4.2;2.4
51;2021-02-26;1226;664;24653;14086;4.4;2.5
51;2021-02-27;590;125;25243;14211;4.5;2.5
51;2021-02-28;7;71;25250;14282;4.5;2.5
51;2021-03-01;766;311;26016;14593;4.6;2.6
51;2021-03-02;1125;450;27141;15043;4.8;2.7
51;2021-03-03;1193;463;28334;15506;5.0;2.8
51;2021-03-04;1059;702;29393;16208;5.2;2.9
51;2021-03-05;1559;671;30952;16879;5.5;3.0
51;2021-03-06;1433;54;32385;16933;5.7;3.0
51;2021-03-07;250;4;32635;16937;5.8;3.0
51;2021-03-08;992;98;33627;17035;6.0;3.0
51;2021-03-09;1663;181;35290;17216;6.3;3.1
51;2021-03-10;1993;103;37283;17319;6.6;3.1
51;2021-03-11;2370;166;39653;17485;7.0;3.1
51;2021-03-12;3249;153;42902;17638;7.6;3.1
51;2021-03-13;2550;46;45452;17684;8.1;3.1
51;2021-03-14;190;5;45642;17689;8.1;3.1
51;2021-03-15;1577;144;47219;17833;8.4;3.2
51;2021-03-16;1479;183;48698;18016;8.6;3.2
51;2021-03-17;1496;205;50194;18221;8.9;3.2
51;2021-03-18;1612;282;51806;18503;9.2;3.3
51;2021-03-19;2310;299;54116;18802;9.6;3.3
51;2021-03-20;1660;212;55776;19014;9.9;3.4
51;2021-03-21;133;1;55909;19015;9.9;3.4
51;2021-03-22;1415;118;57324;19133;10.2;3.4
51;2021-03-23;2466;157;59790;19290;10.6;3.4
51;2021-03-24;2840;126;62630;19416;11.1;3.4
51;2021-03-25;3253;329;65883;19745;11.7;3.5
51;2021-03-26;3410;500;69293;20245;12.3;3.6
51;2021-03-27;1843;251;71136;20496;12.6;3.6
51;2021-03-28;213;2;71349;20498;12.7;3.6
51;2021-03-29;991;641;72340;21139;12.8;3.7
51;2021-03-30;1751;854;74091;21993;13.1;3.9
51;2021-03-31;1736;757;75827;22750;13.4;4.0
51;2021-04-01;2281;443;78108;23193;13.9;4.1
51;2021-04-02;2425;638;80533;23831;14.3;4.2
51;2021-04-03;1303;409;81836;24240;14.5;4.3
51;2021-04-04;106;2;81942;24242;14.5;4.3
51;2021-04-05;72;141;82014;24383;14.5;4.3
51;2021-04-06;764;1234;82778;25617;14.7;4.5
51;2021-04-07;1313;1410;84091;27027;14.9;4.8
51;2021-04-08;2206;1769;86297;28796;15.3;5.1
51;2021-04-09;2863;1730;89160;30526;15.8;5.4
51;2021-04-10;2216;496;91376;31022;16.2;5.5
51;2021-04-11;105;85;91481;31107;16.2;5.5
51;2021-04-12;1449;1341;92930;32448;16.5;5.8
51;2021-04-13;1937;1683;94867;34131;16.8;6.1
51;2021-04-14;2459;1550;97326;35681;17.3;6.3
51;2021-04-15;2853;1666;100179;37347;17.8;6.6
51;2021-04-16;3214;1600;103393;38947;18.3;6.9
51;2021-04-17;1966;775;105359;39722;18.7;7.0
51;2021-04-18;296;109;105655;39831;18.7;7.1
51;2021-04-19;1562;1160;107217;40991;19.0;7.3
51;2021-04-20;1792;1660;109009;42651;19.3;7.6
51;2021-04-21;2007;1738;111016;44389;19.7;7.9
51;2021-04-22;2384;1650;113400;46039;20.1;8.2
51;2021-04-23;2978;1827;116378;47866;20.6;8.5
51;2021-04-24;1749;951;118127;48817;21.0;8.7
51;2021-04-25;123;162;118250;48979;21.0;8.7
51;2021-04-26;1849;760;120099;49739;21.3;8.8
51;2021-04-27;2442;1231;122541;50970;21.7;9.0
51;2021-04-28;2551;1306;125092;52276;22.2;9.3
51;2021-04-29;2674;1459;127766;53735;22.7;9.5
51;2021-04-30;2975;1672;130741;55407;23.2;9.8
51;2021-05-01;1455;412;132196;55819;23.4;9.9
51;2021-05-02;107;99;132303;55918;23.5;9.9
51;2021-05-03;2485;758;134788;56676;23.9;10.1
51;2021-05-04;2787;1348;137575;58024;24.4;10.3
51;2021-05-05;2859;1637;140434;59661;24.9;10.6
51;2021-05-06;5344;1943;145778;61604;25.9;10.9
51;2021-05-07;3703;1933;149481;63537;26.5;11.3
51;2021-05-08;2859;821;152340;64358;27.0;11.4
51;2021-05-09;211;89;152551;64447;27.1;11.4
51;2021-05-10;3215;1862;155766;66309;27.6;11.8
51;2021-05-11;3628;2039;159394;68348;28.3;12.1
51;2021-05-12;4184;2240;163578;70588;29.0;12.5
51;2021-05-13;1776;502;165354;71090;29.3;12.6
51;2021-05-14;5402;1747;170756;72837;30.3;12.9
51;2021-05-15;4227;1354;174983;74191;31.0;13.2
51;2021-05-16;284;46;175267;74237;31.1;13.2
51;2021-05-17;3132;1526;178399;75763;31.6;13.4
51;2021-05-18;3917;1771;182316;77534;32.3;13.8
51;2021-05-19;4015;1731;186331;79265;33.0;14.1
51;2021-05-20;4648;1970;190979;81235;33.9;14.4
51;2021-05-21;3595;2481;194574;83716;34.5;14.8
51;2021-05-22;2076;1547;196650;85263;34.9;15.1
51;2021-05-23;307;210;196957;85473;34.9;15.2
51;2021-05-24;2018;720;198975;86193;35.3;15.3
51;2021-05-25;3128;1829;202103;88022;35.8;15.6
51;2021-05-26;3297;1707;205400;89729;36.4;15.9
51;2021-05-27;3271;2062;208671;91791;37.0;16.3
51;2021-05-28;3605;2829;212276;94620;37.6;16.8
51;2021-05-29;2402;1997;214678;96617;38.1;17.1
51;2021-05-30;401;133;215079;96750;38.1;17.2
51;2021-05-31;3350;1783;218429;98533;38.7;17.5
51;2021-06-01;3854;2333;222283;100866;39.4;17.9
51;2021-06-02;6096;2325;228379;103191;40.5;18.3
51;2021-06-03;3580;2430;231959;105621;41.1;18.7
51;2021-06-04;6347;2945;238306;108566;42.3;19.3
51;2021-06-05;2597;1819;240903;110385;42.7;19.6
51;2021-06-06;171;156;241074;110541;42.8;19.6
51;2021-06-07;4301;2166;245375;112707;43.5;20.0
51;2021-06-08;3924;2533;249299;115240;44.2;20.4
51;2021-06-09;4018;2750;253317;117990;44.9;20.9
51;2021-06-10;3201;2482;256518;120472;45.5;21.4
51;2021-06-11;3357;3426;259875;123898;46.1;22.0
51;2021-06-12;2165;2172;262040;126070;46.5;22.4
51;2021-06-13;191;148;262231;126218;46.5;22.4
51;2021-06-14;1626;3337;263857;129555;46.8;23.0
51;2021-06-15;3187;3577;267044;133132;47.4;23.6
51;2021-06-16;2205;3684;269249;136816;47.8;24.3
51;2021-06-17;2608;5405;271857;142221;48.2;25.2
51;2021-06-18;2357;5214;274214;147435;48.6;26.1
51;2021-06-19;1684;4427;275898;151862;48.9;26.9
51;2021-06-20;184;228;276082;152090;49.0;27.0
51;2021-06-21;1230;4441;277312;156531;49.2;27.8
51;2021-06-22;1556;4043;278868;160574;49.5;28.5
51;2021-06-23;3665;4234;282533;164808;50.1;29.2
51;2021-06-24;2243;3228;284776;168036;50.5;29.8
51;2021-06-25;1905;6523;286681;174559;50.8;31.0
51;2021-06-26;1199;5068;287880;179627;51.1;31.9
51;2021-06-27;103;336;287983;179963;51.1;31.9
51;2021-06-28;1400;4409;289383;184372;51.3;32.7
51;2021-06-29;1171;4464;290554;188836;51.5;33.5
51;2021-06-30;1682;6041;292236;194877;51.8;34.6
51;2021-07-01;1975;3765;294211;198642;52.2;35.2
51;2021-07-02;1831;6886;296042;205528;52.5;36.5
51;2021-07-03;1003;3199;297045;208727;52.7;37.0
51;2021-07-04;172;254;297217;208981;52.7;37.1
51;2021-07-05;764;5529;297981;214510;52.9;38.0
51;2021-07-06;1244;4785;299225;219295;53.1;38.9
51;2021-07-07;1606;4944;300831;224239;53.4;39.8
51;2021-07-08;2061;3428;302892;227667;53.7;40.4
51;2021-07-09;1853;5057;304745;232724;54.0;41.3
51;2021-07-10;1226;3209;305971;235933;54.3;41.8
51;2021-07-11;187;280;306158;236213;54.3;41.9
51;2021-07-12;991;4382;307149;240595;54.5;42.7
51;2021-07-13;1470;4781;308619;245376;54.7;43.5
51;2021-07-14;1068;1686;309687;247062;54.9;43.8
51;2021-07-15;2920;4911;312607;251973;55.4;44.7
51;2021-07-16;2347;5286;314954;257259;55.9;45.6
51;2021-07-17;1807;3485;316761;260744;56.2;46.2
51;2021-07-18;162;329;316923;261073;56.2;46.3
51;2021-07-19;1885;3980;318808;265053;56.5;47.0
51;2021-07-20;2574;5148;321382;270201;57.0;47.9
51;2021-07-21;3600;4059;324982;274260;57.6;48.6
51;2021-07-22;4383;3750;329365;278010;58.4;49.3
51;2021-07-23;3621;4382;332986;282392;59.1;50.1
51;2021-07-24;2072;2717;335058;285109;59.4;50.6
51;2021-07-25;349;258;335407;285367;59.5;50.6
51;2021-07-26;3101;2799;338508;288166;60.0;51.1
51;2021-07-27;5807;3249;344315;291415;61.1;51.7
51;2021-07-28;4118;4308;348433;295723;61.8;52.4
51;2021-07-29;4673;2709;353106;298432;62.6;52.9
51;2021-07-30;3593;3145;356699;301577;63.3;53.5
51;2021-07-31;2509;2122;359208;303699;63.7;53.9
51;2021-08-01;367;233;359575;303932;63.8;53.9
51;2021-08-02;3264;2304;362839;306236;64.4;54.3
51;2021-08-03;3757;1897;366596;308133;65.0;54.7
51;2021-08-04;4429;2099;371025;310232;65.8;55.0
51;2021-08-05;2585;1524;373610;311756;66.3;55.3
52;2020-12-27;0;0;0;0;0.0;0.0
52;2020-12-28;0;0;0;0;0.0;0.0
52;2020-12-29;0;0;0;0;0.0;0.0
52;2020-12-30;0;0;0;0;0.0;0.0
52;2020-12-31;0;0;0;0;0.0;0.0
52;2021-01-01;0;0;0;0;0.0;0.0
52;2021-01-02;0;0;0;0;0.0;0.0
52;2021-01-03;0;0;0;0;0.0;0.0
52;2021-01-04;0;0;0;0;0.0;0.0
52;2021-01-05;0;0;0;0;0.0;0.0
52;2021-01-06;2;0;2;0;0.0;0.0
52;2021-01-07;0;0;2;0;0.0;0.0
52;2021-01-08;201;1;203;1;0.1;0.0
52;2021-01-09;93;0;296;1;0.2;0.0
52;2021-01-10;0;0;296;1;0.2;0.0
52;2021-01-11;206;0;502;1;0.3;0.0
52;2021-01-12;171;0;673;1;0.4;0.0
52;2021-01-13;562;2;1235;3;0.7;0.0
52;2021-01-14;677;8;1912;11;1.1;0.0
52;2021-01-15;411;1;2323;12;1.4;0.0
52;2021-01-16;16;1;2339;13;1.4;0.0
52;2021-01-17;0;0;2339;13;1.4;0.0
52;2021-01-18;426;0;2765;13;1.6;0.0
52;2021-01-19;439;0;3204;13;1.9;0.0
52;2021-01-20;420;0;3624;13;2.1;0.0
52;2021-01-21;424;1;4048;14;2.4;0.0
52;2021-01-22;321;0;4369;14;2.6;0.0
52;2021-01-23;72;0;4441;14;2.6;0.0
52;2021-01-24;0;0;4441;14;2.6;0.0
52;2021-01-25;235;0;4676;14;2.8;0.0
52;2021-01-26;306;1;4982;15;2.9;0.0
52;2021-01-27;237;1;5219;16;3.1;0.0
52;2021-01-28;174;4;5393;20;3.2;0.0
52;2021-01-29;74;124;5467;144;3.2;0.1
52;2021-01-30;91;95;5558;239;3.3;0.1
52;2021-01-31;0;0;5558;239;3.3;0.1
52;2021-02-01;117;192;5675;431;3.4;0.3
52;2021-02-02;61;178;5736;609;3.4;0.4
52;2021-02-03;90;416;5826;1025;3.4;0.6
52;2021-02-04;231;597;6057;1622;3.6;1.0
52;2021-02-05;113;505;6170;2127;3.6;1.3
52;2021-02-06;22;0;6192;2127;3.7;1.3
52;2021-02-07;0;1;6192;2128;3.7;1.3
52;2021-02-08;34;207;6226;2335;3.7;1.4
52;2021-02-09;47;216;6273;2551;3.7;1.5
52;2021-02-10;88;191;6361;2742;3.8;1.6
52;2021-02-11;129;146;6490;2888;3.8;1.7
52;2021-02-12;188;130;6678;3018;3.9;1.8
52;2021-02-13;5;1;6683;3019;3.9;1.8
52;2021-02-14;0;16;6683;3035;3.9;1.8
52;2021-02-15;80;277;6763;3312;4.0;2.0
52;2021-02-16;50;357;6813;3669;4.0;2.2
52;2021-02-17;37;316;6850;3985;4.0;2.4
52;2021-02-18;82;281;6932;4266;4.1;2.5
52;2021-02-19;51;193;6983;4459;4.1;2.6
52;2021-02-20;14;111;6997;4570;4.1;2.7
52;2021-02-21;0;0;6997;4570;4.1;2.7
52;2021-02-22;42;384;7039;4954;4.2;2.9
52;2021-02-23;56;279;7095;5233;4.2;3.1
52;2021-02-24;82;248;7177;5481;4.2;3.2
52;2021-02-25;161;236;7338;5717;4.3;3.4
52;2021-02-26;296;182;7634;5899;4.5;3.5
52;2021-02-27;149;49;7783;5948;4.6;3.5
52;2021-02-28;0;0;7783;5948;4.6;3.5
52;2021-03-01;163;14;7946;5962;4.7;3.5
52;2021-03-02;196;51;8142;6013;4.8;3.6
52;2021-03-03;356;35;8498;6048;5.0;3.6
52;2021-03-04;377;58;8875;6106;5.2;3.6
52;2021-03-05;531;52;9406;6158;5.6;3.6
52;2021-03-06;409;35;9815;6193;5.8;3.7
52;2021-03-07;0;0;9815;6193;5.8;3.7
52;2021-03-08;397;111;10212;6304;6.0;3.7
52;2021-03-09;550;105;10762;6409;6.4;3.8
52;2021-03-10;308;107;11070;6516;6.5;3.8
52;2021-03-11;585;35;11655;6551;6.9;3.9
52;2021-03-12;582;65;12237;6616;7.2;3.9
52;2021-03-13;490;6;12727;6622;7.5;3.9
52;2021-03-14;15;3;12742;6625;7.5;3.9
52;2021-03-15;316;25;13058;6650;7.7;3.9
52;2021-03-16;203;15;13261;6665;7.8;3.9
52;2021-03-17;363;13;13624;6678;8.0;3.9
52;2021-03-18;442;8;14066;6686;8.3;4.0
52;2021-03-19;450;53;14516;6739;8.6;4.0
52;2021-03-20;259;11;14775;6750;8.7;4.0
52;2021-03-21;15;1;14790;6751;8.7;4.0
52;2021-03-22;375;48;15165;6799;9.0;4.0
52;2021-03-23;683;89;15848;6888;9.4;4.1
52;2021-03-24;771;69;16619;6957;9.8;4.1
52;2021-03-25;1139;85;17758;7042;10.5;4.2
52;2021-03-26;1031;138;18789;7180;11.1;4.2
52;2021-03-27;476;75;19265;7255;11.4;4.3
52;2021-03-28;53;0;19318;7255;11.4;4.3
52;2021-03-29;506;185;19824;7440;11.7;4.4
52;2021-03-30;868;289;20692;7729;12.2;4.6
52;2021-03-31;957;290;21649;8019;12.8;4.7
52;2021-04-01;1146;178;22795;8197;13.5;4.8
52;2021-04-02;958;102;23753;8299;14.0;4.9
52;2021-04-03;459;3;24212;8302;14.3;4.9
52;2021-04-04;1;1;24213;8303;14.3;4.9
52;2021-04-05;1;0;24214;8303;14.3;4.9
52;2021-04-06;431;294;24645;8597;14.6;5.1
52;2021-04-07;503;450;25148;9047;14.9;5.3
52;2021-04-08;846;209;25994;9256;15.4;5.5
52;2021-04-09;1060;126;27054;9382;16.0;5.5
52;2021-04-10;852;100;27906;9482;16.5;5.6
52;2021-04-11;96;1;28002;9483;16.5;5.6
52;2021-04-12;931;275;28933;9758;17.1;5.8
52;2021-04-13;1248;376;30181;10134;17.8;6.0
52;2021-04-14;1344;453;31525;10587;18.6;6.3
52;2021-04-15;1511;433;33036;11020;19.5;6.5
52;2021-04-16;1573;364;34609;11384;20.4;6.7
52;2021-04-17;1309;129;35918;11513;21.2;6.8
52;2021-04-18;510;29;36428;11542;21.5;6.8
52;2021-04-19;697;611;37125;12153;21.9;7.2
52;2021-04-20;1078;672;38203;12825;22.6;7.6
52;2021-04-21;1059;676;39262;13501;23.2;8.0
52;2021-04-22;1468;731;40730;14232;24.1;8.4
52;2021-04-23;1254;660;41984;14892;24.8;8.8
52;2021-04-24;477;293;42461;15185;25.1;9.0
52;2021-04-25;3;77;42464;15262;25.1;9.0
52;2021-04-26;631;559;43095;15821;25.5;9.3
52;2021-04-27;933;671;44028;16492;26.0;9.7
52;2021-04-28;1440;559;45468;17051;26.9;10.1
52;2021-04-29;1451;575;46919;17626;27.7;10.4
52;2021-04-30;1315;605;48234;18231;28.5;10.8
52;2021-05-01;8;232;48242;18463;28.5;10.9
52;2021-05-02;0;1;48242;18464;28.5;10.9
52;2021-05-03;1160;627;49402;19091;29.2;11.3
52;2021-05-04;1445;720;50847;19811;30.0;11.7
52;2021-05-05;1768;647;52615;20458;31.1;12.1
52;2021-05-06;1974;509;54589;20967;32.3;12.4
52;2021-05-07;1443;1162;56032;22129;33.1;13.1
52;2021-05-08;588;317;56620;22446;33.5;13.3
52;2021-05-09;1;47;56621;22493;33.5;13.3
52;2021-05-10;791;1101;57412;23594;33.9;13.9
52;2021-05-11;868;1395;58280;24989;34.4;14.8
52;2021-05-12;1209;1382;59489;26371;35.1;15.6
52;2021-05-13;67;184;59556;26555;35.2;15.7
52;2021-05-14;1185;1363;60741;27918;35.9;16.5
52;2021-05-15;492;929;61233;28847;36.2;17.0
52;2021-05-16;8;43;61241;28890;36.2;17.1
52;2021-05-17;1144;706;62385;29596;36.9;17.5
52;2021-05-18;1217;672;63602;30268;37.6;17.9
52;2021-05-19;1543;415;65145;30683;38.5;18.1
52;2021-05-20;1545;420;66690;31103;39.4;18.4
52;2021-05-21;1624;613;68314;31716;40.4;18.7
52;2021-05-22;1088;208;69402;31924;41.0;18.9
52;2021-05-23;1;0;69403;31924;41.0;18.9
52;2021-05-24;403;33;69806;31957;41.2;18.9
52;2021-05-25;1351;384;71157;32341;42.0;19.1
52;2021-05-26;1479;672;72636;33013;42.9;19.5
52;2021-05-27;1566;789;74202;33802;43.8;20.0
52;2021-05-28;1492;671;75694;34473;44.7;20.4
52;2021-05-29;696;835;76390;35308;45.1;20.9
52;2021-05-30;16;550;76406;35858;45.1;21.2
52;2021-05-31;823;830;77229;36688;45.6;21.7
52;2021-06-01;957;815;78186;37503;46.2;22.2
52;2021-06-02;895;753;79081;38256;46.7;22.6
52;2021-06-03;825;825;79906;39081;47.2;23.1
52;2021-06-04;884;1341;80790;40422;47.7;23.9
52;2021-06-05;579;638;81369;41060;48.1;24.3
52;2021-06-06;27;55;81396;41115;48.1;24.3
52;2021-06-07;359;931;81755;42046;48.3;24.8
52;2021-06-08;553;1467;82308;43513;48.6;25.7
52;2021-06-09;613;1474;82921;44987;49.0;26.6
52;2021-06-10;793;1158;83714;46145;49.5;27.3
52;2021-06-11;829;1349;84543;47494;50.0;28.1
52;2021-06-12;422;586;84965;48080;50.2;28.4
52;2021-06-13;1;6;84966;48086;50.2;28.4
52;2021-06-14;171;1413;85137;49499;50.3;29.2
52;2021-06-15;221;1810;85358;51309;50.4;30.3
52;2021-06-16;354;1995;85712;53304;50.6;31.5
52;2021-06-17;266;1156;85978;54460;50.8;32.2
52;2021-06-18;306;1553;86284;56013;51.0;33.1
52;2021-06-19;502;690;86786;56703;51.3;33.5
52;2021-06-20;0;17;86786;56720;51.3;33.5
52;2021-06-21;524;896;87310;57616;51.6;34.0
52;2021-06-22;503;1048;87813;58664;51.9;34.7
52;2021-06-23;561;1043;88374;59707;52.2;35.3
52;2021-06-24;607;717;88981;60424;52.6;35.7
52;2021-06-25;660;1312;89641;61736;53.0;36.5
52;2021-06-26;264;721;89905;62457;53.1;36.9
52;2021-06-27;1;8;89906;62465;53.1;36.9
52;2021-06-28;182;1443;90088;63908;53.2;37.8
52;2021-06-29;163;1414;90251;65322;53.3;38.6
52;2021-06-30;216;1467;90467;66789;53.5;39.5
52;2021-07-01;317;1023;90784;67812;53.6;40.1
52;2021-07-02;430;1454;91214;69266;53.9;40.9
52;2021-07-03;301;1148;91515;70414;54.1;41.6
52;2021-07-04;0;11;91515;70425;54.1;41.6
52;2021-07-05;172;1450;91687;71875;54.2;42.5
52;2021-07-06;284;1452;91971;73327;54.3;43.3
52;2021-07-07;305;1165;92276;74492;54.5;44.0
52;2021-07-08;471;1163;92747;75655;54.8;44.7
52;2021-07-09;287;1621;93034;77276;55.0;45.7
52;2021-07-10;148;822;93182;78098;55.1;46.1
52;2021-07-11;11;12;93193;78110;55.1;46.2
52;2021-07-12;282;1467;93475;79577;55.2;47.0
52;2021-07-13;590;1371;94065;80948;55.6;47.8
52;2021-07-14;436;150;94501;81098;55.8;47.9
52;2021-07-15;605;1430;95106;82528;56.2;48.8
52;2021-07-16;889;1340;95995;83868;56.7;49.6
52;2021-07-17;527;340;96522;84208;57.0;49.8
52;2021-07-18;3;12;96525;84220;57.0;49.8
52;2021-07-19;679;985;97204;85205;57.4;50.3
52;2021-07-20;1097;834;98301;86039;58.1;50.8
52;2021-07-21;1145;736;99446;86775;58.8;51.3
52;2021-07-22;1426;860;100872;87635;59.6;51.8
52;2021-07-23;1383;955;102255;88590;60.4;52.3
52;2021-07-24;872;487;103127;89077;60.9;52.6
52;2021-07-25;20;21;103147;89098;60.9;52.6
52;2021-07-26;995;615;104142;89713;61.5;53.0
52;2021-07-27;1325;654;105467;90367;62.3;53.4
52;2021-07-28;1373;640;106840;91007;63.1;53.8
52;2021-07-29;1243;618;108083;91625;63.9;54.1
52;2021-07-30;1350;706;109433;92331;64.7;54.6
52;2021-07-31;869;544;110302;92875;65.2;54.9
52;2021-08-01;5;14;110307;92889;65.2;54.9
52;2021-08-02;1171;561;111478;93450;65.9;55.2
52;2021-08-03;1348;534;112826;93984;66.7;55.5
52;2021-08-04;1133;578;113959;94562;67.3;55.9
52;2021-08-05;1013;575;114972;95137;67.9;56.2
53;2020-12-27;0;0;0;0;0.0;0.0
53;2020-12-28;0;0;0;0;0.0;0.0
53;2020-12-29;0;0;0;0;0.0;0.0
53;2020-12-30;0;0;0;0;0.0;0.0
53;2020-12-31;0;0;0;0;0.0;0.0
53;2021-01-01;0;0;0;0;0.0;0.0
53;2021-01-02;0;0;0;0;0.0;0.0
53;2021-01-03;0;0;0;0;0.0;0.0
53;2021-01-04;0;0;0;0;0.0;0.0
53;2021-01-05;0;0;0;0;0.0;0.0
53;2021-01-06;0;0;0;0;0.0;0.0
53;2021-01-07;102;0;102;0;0.0;0.0
53;2021-01-08;284;1;386;1;0.1;0.0
53;2021-01-09;134;1;520;2;0.2;0.0
53;2021-01-10;15;0;535;2;0.2;0.0
53;2021-01-11;176;0;711;2;0.2;0.0
53;2021-01-12;453;1;1164;3;0.4;0.0
53;2021-01-13;252;0;1416;3;0.5;0.0
53;2021-01-14;289;7;1705;10;0.6;0.0
53;2021-01-15;343;4;2048;14;0.7;0.0
53;2021-01-16;61;0;2109;14;0.7;0.0
53;2021-01-17;24;1;2133;15;0.7;0.0
53;2021-01-18;364;0;2497;15;0.8;0.0
53;2021-01-19;593;0;3090;15;1.0;0.0
53;2021-01-20;742;0;3832;15;1.3;0.0
53;2021-01-21;769;2;4601;17;1.5;0.0
53;2021-01-22;705;2;5306;19;1.7;0.0
53;2021-01-23;160;1;5466;20;1.8;0.0
53;2021-01-24;6;0;5472;20;1.8;0.0
53;2021-01-25;550;0;6022;20;2.0;0.0
53;2021-01-26;1198;6;7220;26;2.4;0.0
53;2021-01-27;696;6;7916;32;2.6;0.0
53;2021-01-28;738;95;8654;127;2.8;0.0
53;2021-01-29;422;189;9076;316;3.0;0.1
53;2021-01-30;128;0;9204;316;3.0;0.1
53;2021-01-31;0;0;9204;316;3.0;0.1
53;2021-02-01;298;149;9502;465;3.1;0.2
53;2021-02-02;309;231;9811;696;3.2;0.2
53;2021-02-03;227;378;10038;1074;3.3;0.4
53;2021-02-04;184;332;10222;1406;3.3;0.5
53;2021-02-05;234;303;10456;1709;3.4;0.6
53;2021-02-06;152;23;10608;1732;3.5;0.6
53;2021-02-07;0;0;10608;1732;3.5;0.6
53;2021-02-08;166;107;10774;1839;3.5;0.6
53;2021-02-09;369;213;11143;2052;3.6;0.7
53;2021-02-10;266;435;11409;2487;3.7;0.8
53;2021-02-11;433;491;11842;2978;3.9;1.0
53;2021-02-12;318;574;12160;3552;4.0;1.2
53;2021-02-13;96;66;12256;3618;4.0;1.2
53;2021-02-14;0;99;12256;3717;4.0;1.2
53;2021-02-15;240;434;12496;4151;4.1;1.4
53;2021-02-16;528;844;13024;4995;4.3;1.6
53;2021-02-17;391;618;13415;5613;4.4;1.8
53;2021-02-18;546;577;13961;6190;4.6;2.0
53;2021-02-19;895;421;14856;6611;4.9;2.2
53;2021-02-20;139;112;14995;6723;4.9;2.2
53;2021-02-21;1;20;14996;6743;4.9;2.2
53;2021-02-22;161;587;15157;7330;5.0;2.4
53;2021-02-23;59;657;15216;7987;5.0;2.6
53;2021-02-24;137;517;15353;8504;5.0;2.8
53;2021-02-25;457;359;15810;8863;5.2;2.9
53;2021-02-26;439;263;16249;9126;5.3;3.0
53;2021-02-27;86;115;16335;9241;5.3;3.0
53;2021-02-28;0;0;16335;9241;5.3;3.0
53;2021-03-01;230;280;16565;9521;5.4;3.1
53;2021-03-02;245;253;16810;9774;5.5;3.2
53;2021-03-03;320;393;17130;10167;5.6;3.3
53;2021-03-04;859;335;17989;10502;5.9;3.4
53;2021-03-05;659;279;18648;10781;6.1;3.5
53;2021-03-06;445;212;19093;10993;6.3;3.6
53;2021-03-07;276;5;19369;10998;6.3;3.6
53;2021-03-08;376;178;19745;11176;6.5;3.7
53;2021-03-09;878;244;20623;11420;6.8;3.7
53;2021-03-10;807;106;21430;11526;7.0;3.8
53;2021-03-11;1247;222;22677;11748;7.4;3.8
53;2021-03-12;1602;144;24279;11892;8.0;3.9
53;2021-03-13;824;5;25103;11897;8.2;3.9
53;2021-03-14;1;0;25104;11897;8.2;3.9
53;2021-03-15;1002;298;26106;12195;8.5;4.0
53;2021-03-16;1033;325;27139;12520;8.9;4.1
53;2021-03-17;683;259;27822;12779;9.1;4.2
53;2021-03-18;972;339;28794;13118;9.4;4.3
53;2021-03-19;1341;593;30135;13711;9.9;4.5
53;2021-03-20;591;14;30726;13725;10.1;4.5
53;2021-03-21;2;0;30728;13725;10.1;4.5
53;2021-03-22;1209;151;31937;13876;10.5;4.5
53;2021-03-23;1696;63;33633;13939;11.0;4.6
53;2021-03-24;1323;116;34956;14055;11.4;4.6
53;2021-03-25;2323;228;37279;14283;12.2;4.7
53;2021-03-26;1882;148;39161;14431;12.8;4.7
53;2021-03-27;339;2;39500;14433;12.9;4.7
53;2021-03-28;2;0;39502;14433;12.9;4.7
53;2021-03-29;1474;208;40976;14641;13.4;4.8
53;2021-03-30;1945;197;42921;14838;14.1;4.9
53;2021-03-31;1791;218;44712;15056;14.6;4.9
53;2021-04-01;1945;672;46657;15728;15.3;5.2
53;2021-04-02;2074;219;48731;15947;16.0;5.2
53;2021-04-03;414;1;49145;15948;16.1;5.2
53;2021-04-04;10;0;49155;15948;16.1;5.2
53;2021-04-05;9;15;49164;15963;16.1;5.2
53;2021-04-06;1304;500;50468;16463;16.5;5.4
53;2021-04-07;1177;922;51645;17385;16.9;5.7
53;2021-04-08;1662;1002;53307;18387;17.5;6.0
53;2021-04-09;1956;398;55263;18785;18.1;6.2
53;2021-04-10;543;12;55806;18797;18.3;6.2
53;2021-04-11;12;0;55818;18797;18.3;6.2
53;2021-04-12;695;1065;56513;19862;18.5;6.5
53;2021-04-13;1473;1106;57986;20968;19.0;6.9
53;2021-04-14;1022;732;59008;21700;19.3;7.1
53;2021-04-15;1159;1108;60167;22808;19.7;7.5
53;2021-04-16;1272;816;61439;23624;20.1;7.7
53;2021-04-17;281;274;61720;23898;20.2;7.8
53;2021-04-18;0;0;61720;23898;20.2;7.8
53;2021-04-19;679;1065;62399;24963;20.4;8.2
53;2021-04-20;936;1449;63335;26412;20.7;8.6
53;2021-04-21;850;1010;64185;27422;21.0;9.0
53;2021-04-22;1046;1611;65231;29033;21.4;9.5
53;2021-04-23;1328;1053;66559;30086;21.8;9.9
53;2021-04-24;68;7;66627;30093;21.8;9.9
53;2021-04-25;6;39;66633;30132;21.8;9.9
53;2021-04-26;368;1238;67001;31370;21.9;10.3
53;2021-04-27;724;1971;67725;33341;22.2;10.9
53;2021-04-28;979;1392;68704;34733;22.5;11.4
53;2021-04-29;1050;1710;69754;36443;22.8;11.9
53;2021-04-30;1367;1307;71121;37750;23.3;12.4
53;2021-05-01;35;50;71156;37800;23.3;12.4
53;2021-05-02;0;0;71156;37800;23.3;12.4
53;2021-05-03;1570;702;72726;38502;23.8;12.6
53;2021-05-04;1305;1437;74031;39939;24.2;13.1
53;2021-05-05;1609;823;75640;40762;24.8;13.3
53;2021-05-06;1393;1394;77033;42156;25.2;13.8
53;2021-05-07;1538;1300;78571;43456;25.7;14.2
53;2021-05-08;939;36;79510;43492;26.0;14.2
53;2021-05-09;11;2;79521;43494;26.0;14.2
53;2021-05-10;2416;809;81937;44303;26.8;14.5
53;2021-05-11;3096;1285;85033;45588;27.8;14.9
53;2021-05-12;2749;1088;87782;46676;28.7;15.3
53;2021-05-13;350;27;88132;46703;28.9;15.3
53;2021-05-14;2019;675;90151;47378;29.5;15.5
53;2021-05-15;1058;62;91209;47440;29.9;15.5
53;2021-05-16;2;0;91211;47440;29.9;15.5
53;2021-05-17;1701;1197;92912;48637;30.4;15.9
53;2021-05-18;1881;1545;94793;50182;31.0;16.4
53;2021-05-19;2303;743;97096;50925;31.8;16.7
53;2021-05-20;3217;858;100313;51783;32.9;17.0
53;2021-05-21;2797;826;103110;52609;33.8;17.2
53;2021-05-22;20;60;103130;52669;33.8;17.2
53;2021-05-23;0;0;103130;52669;33.8;17.2
53;2021-05-24;8;6;103138;52675;33.8;17.2
53;2021-05-25;1819;804;104957;53479;34.4;17.5
53;2021-05-26;1852;903;106809;54382;35.0;17.8
53;2021-05-27;3071;1075;109880;55457;36.0;18.2
53;2021-05-28;2562;876;112442;56333;36.8;18.4
53;2021-05-29;844;244;113286;56577;37.1;18.5
53;2021-05-30;18;6;113304;56583;37.1;18.5
53;2021-05-31;2564;801;115868;57384;37.9;18.8
53;2021-06-01;3491;1257;119359;58641;39.1;19.2
53;2021-06-02;3183;523;122542;59164;40.1;19.4
53;2021-06-03;4198;783;126740;59947;41.5;19.6
53;2021-06-04;3181;1264;129921;61211;42.5;20.0
53;2021-06-05;136;245;130057;61456;42.6;20.1
53;2021-06-06;0;4;130057;61460;42.6;20.1
53;2021-06-07;2628;923;132685;62383;43.5;20.4
53;2021-06-08;3584;1125;136269;63508;44.6;20.8
53;2021-06-09;2453;937;138722;64445;45.4;21.1
53;2021-06-10;3520;846;142242;65291;46.6;21.4
53;2021-06-11;2964;1212;145206;66503;47.6;21.8
53;2021-06-12;108;138;145314;66641;47.6;21.8
53;2021-06-13;10;2;145324;66643;47.6;21.8
53;2021-06-14;1600;1791;146924;68434;48.1;22.4
53;2021-06-15;1898;2264;148822;70698;48.7;23.2
53;2021-06-16;1827;1730;150649;72428;49.3;23.7
53;2021-06-17;3013;1649;153662;74077;50.3;24.3
53;2021-06-18;2701;1807;156363;75884;51.2;24.9
53;2021-06-19;762;1166;157125;77050;51.5;25.2
53;2021-06-20;3;479;157128;77529;51.5;25.4
53;2021-06-21;918;2526;158046;80055;51.8;26.2
53;2021-06-22;1299;3455;159345;83510;52.2;27.3
53;2021-06-23;1364;2893;160709;86403;52.6;28.3
53;2021-06-24;1802;2033;162511;88436;53.2;29.0
53;2021-06-25;1785;2043;164296;90479;53.8;29.6
53;2021-06-26;977;350;165273;90829;54.1;29.7
53;2021-06-27;8;8;165281;90837;54.1;29.7
53;2021-06-28;661;2901;165942;93738;54.3;30.7
53;2021-06-29;857;3646;166799;97384;54.6;31.9
53;2021-06-30;748;1518;167547;98902;54.9;32.4
53;2021-07-01;1501;2633;169048;101535;55.4;33.3
53;2021-07-02;1483;2023;170531;103558;55.8;33.9
53;2021-07-03;856;571;171387;104129;56.1;34.1
53;2021-07-04;0;4;171387;104133;56.1;34.1
53;2021-07-05;533;2062;171920;106195;56.3;34.8
53;2021-07-06;853;3617;172773;109812;56.6;36.0
53;2021-07-07;1020;2653;173793;112465;56.9;36.8
53;2021-07-08;1307;3118;175100;115583;57.3;37.9
53;2021-07-09;1114;3398;176214;118981;57.7;39.0
53;2021-07-10;422;1000;176636;119981;57.8;39.3
53;2021-07-11;12;20;176648;120001;57.8;39.3
53;2021-07-12;500;3716;177148;123717;58.0;40.5
53;2021-07-13;892;4773;178040;128490;58.3;42.1
53;2021-07-14;104;284;178144;128774;58.3;42.2
53;2021-07-15;1111;4354;179255;133128;58.7;43.6
53;2021-07-16;1244;3848;180499;136976;59.1;44.9
53;2021-07-17;1314;297;181813;137273;59.5;45.0
53;2021-07-18;25;19;181838;137292;59.5;45.0
53;2021-07-19;734;3436;182572;140728;59.8;46.1
53;2021-07-20;975;4129;183547;144857;60.1;47.4
53;2021-07-21;680;3280;184227;148137;60.3;48.5
53;2021-07-22;1510;3525;185737;151662;60.8;49.7
53;2021-07-23;1599;3759;187336;155421;61.3;50.9
53;2021-07-24;953;280;188289;155701;61.7;51.0
53;2021-07-25;60;25;188349;155726;61.7;51.0
53;2021-07-26;1721;1939;190070;157665;62.2;51.6
53;2021-07-27;2348;2826;192418;160491;63.0;52.6
53;2021-07-28;2135;2814;194553;163305;63.7;53.5
53;2021-07-29;2486;2543;197039;165848;64.5;54.3
53;2021-07-30;1822;2651;198861;168499;65.1;55.2
53;2021-07-31;626;231;199487;168730;65.3;55.3
53;2021-08-01;37;25;199524;168755;65.3;55.3
53;2021-08-02;2079;1726;201603;170481;66.0;55.8
53;2021-08-03;2406;1898;204009;172379;66.8;56.5
53;2021-08-04;2467;1847;206476;174226;67.6;57.1
53;2021-08-05;2838;1532;209314;175758;68.5;57.6
54;2020-12-27;0;0;0;0;0.0;0.0
54;2020-12-28;1;0;1;0;0.0;0.0
54;2020-12-29;0;0;1;0;0.0;0.0
54;2020-12-30;0;0;1;0;0.0;0.0
54;2020-12-31;10;0;11;0;0.0;0.0
54;2021-01-01;0;0;11;0;0.0;0.0
54;2021-01-02;0;0;11;0;0.0;0.0
54;2021-01-03;1;0;12;0;0.0;0.0
54;2021-01-04;163;0;175;0;0.0;0.0
54;2021-01-05;395;0;570;0;0.1;0.0
54;2021-01-06;648;1;1218;1;0.2;0.0
54;2021-01-07;817;2;2035;3;0.3;0.0
54;2021-01-08;705;3;2740;6;0.4;0.0
54;2021-01-09;81;0;2821;6;0.4;0.0
54;2021-01-10;78;0;2899;6;0.4;0.0
54;2021-01-11;974;3;3873;9;0.5;0.0
54;2021-01-12;1180;1;5053;10;0.7;0.0
54;2021-01-13;2383;10;7436;20;1.0;0.0
54;2021-01-14;3376;30;10812;50;1.5;0.0
54;2021-01-15;2688;13;13500;63;1.8;0.0
54;2021-01-16;814;3;14314;66;2.0;0.0
54;2021-01-17;210;0;14524;66;2.0;0.0
54;2021-01-18;1557;6;16081;72;2.2;0.0
54;2021-01-19;1699;0;17780;72;2.4;0.0
54;2021-01-20;1495;5;19275;77;2.6;0.0
54;2021-01-21;1341;3;20616;80;2.8;0.0
54;2021-01-22;1088;8;21704;88;3.0;0.0
54;2021-01-23;478;0;22182;88;3.0;0.0
54;2021-01-24;66;0;22248;88;3.0;0.0
54;2021-01-25;940;29;23188;117;3.2;0.0
54;2021-01-26;142;5;23330;122;3.2;0.0
54;2021-01-27;12;172;23342;294;3.2;0.0
54;2021-01-28;31;236;23373;530;3.2;0.1
54;2021-01-29;18;279;23391;809;3.2;0.1
54;2021-01-30;4;0;23395;809;3.2;0.1
54;2021-01-31;1;0;23396;809;3.2;0.1
54;2021-02-01;13;787;23409;1596;3.2;0.2
54;2021-02-02;22;971;23431;2567;3.2;0.4
54;2021-02-03;360;1532;23791;4099;3.3;0.6
54;2021-02-04;730;2455;24521;6554;3.4;0.9
54;2021-02-05;793;1898;25314;8452;3.5;1.2
54;2021-02-06;203;338;25517;8790;3.5;1.2
54;2021-02-07;4;126;25521;8916;3.5;1.2
54;2021-02-08;117;1000;25638;9916;3.5;1.4
54;2021-02-09;303;1070;25941;10986;3.6;1.5
54;2021-02-10;385;799;26326;11785;3.6;1.6
54;2021-02-11;292;820;26618;12605;3.6;1.7
54;2021-02-12;449;1302;27067;13907;3.7;1.9
54;2021-02-13;147;236;27214;14143;3.7;1.9
54;2021-02-14;9;11;27223;14154;3.7;1.9
54;2021-02-15;432;1138;27655;15292;3.8;2.1
54;2021-02-16;402;1225;28057;16517;3.8;2.3
54;2021-02-17;518;961;28575;17478;3.9;2.4
54;2021-02-18;593;792;29168;18270;4.0;2.5
54;2021-02-19;520;777;29688;19047;4.1;2.6
54;2021-02-20;33;284;29721;19331;4.1;2.6
54;2021-02-21;3;25;29724;19356;4.1;2.7
54;2021-02-22;485;604;30209;19960;4.1;2.7
54;2021-02-23;678;565;30887;20525;4.2;2.8
54;2021-02-24;727;364;31614;20889;4.3;2.9
54;2021-02-25;1475;735;33089;21624;4.5;3.0
54;2021-02-26;1769;786;34858;22410;4.8;3.1
54;2021-02-27;699;107;35557;22517;4.9;3.1
54;2021-02-28;11;28;35568;22545;4.9;3.1
54;2021-03-01;649;216;36217;22761;5.0;3.1
54;2021-03-02;1503;138;37720;22899;5.2;3.1
54;2021-03-03;1760;57;39480;22956;5.4;3.1
54;2021-03-04;2024;97;41504;23053;5.7;3.2
54;2021-03-05;2796;140;44300;23193;6.1;3.2
54;2021-03-06;4041;102;48341;23295;6.6;3.2
54;2021-03-07;2625;69;50966;23364;7.0;3.2
54;2021-03-08;1336;62;52302;23426;7.2;3.2
54;2021-03-09;2644;100;54946;23526;7.5;3.2
54;2021-03-10;3199;108;58145;23634;8.0;3.2
54;2021-03-11;3391;96;61536;23730;8.4;3.2
54;2021-03-12;4980;176;66516;23906;9.1;3.3
54;2021-03-13;4200;114;70716;24020;9.7;3.3
54;2021-03-14;543;38;71259;24058;9.8;3.3
54;2021-03-15;1719;100;72978;24158;10.0;3.3
54;2021-03-16;1733;174;74711;24332;10.2;3.3
54;2021-03-17;2081;150;76792;24482;10.5;3.4
54;2021-03-18;2058;168;78850;24650;10.8;3.4
54;2021-03-19;3318;257;82168;24907;11.2;3.4
54;2021-03-20;2304;76;84472;24983;11.6;3.4
54;2021-03-21;295;15;84767;24998;11.6;3.4
54;2021-03-22;1033;333;85800;25331;11.7;3.5
54;2021-03-23;1936;518;87736;25849;12.0;3.5
54;2021-03-24;2194;711;89930;26560;12.3;3.6
54;2021-03-25;3173;722;93103;27282;12.7;3.7
54;2021-03-26;3512;810;96615;28092;13.2;3.8
54;2021-03-27;2416;285;99031;28377;13.6;3.9
54;2021-03-28;278;5;99309;28382;13.6;3.9
54;2021-03-29;1669;384;100978;28766;13.8;3.9
54;2021-03-30;2555;978;103533;29744;14.2;4.1
54;2021-03-31;2594;1143;106127;30887;14.5;4.2
54;2021-04-01;3219;1266;109346;32153;15.0;4.4
54;2021-04-02;2967;1675;112313;33828;15.4;4.6
54;2021-04-03;1258;1312;113571;35140;15.5;4.8
54;2021-04-04;136;421;113707;35561;15.6;4.9
54;2021-04-05;145;575;113852;36136;15.6;4.9
54;2021-04-06;1262;1662;115114;37798;15.8;5.2
54;2021-04-07;911;2269;116025;40067;15.9;5.5
54;2021-04-08;2304;2442;118329;42509;16.2;5.8
54;2021-04-09;4119;3153;122448;45662;16.8;6.3
54;2021-04-10;3208;1669;125656;47331;17.2;6.5
54;2021-04-11;206;1001;125862;48332;17.2;6.6
54;2021-04-12;2195;1536;128057;49868;17.5;6.8
54;2021-04-13;3003;1969;131060;51837;17.9;7.1
54;2021-04-14;3257;1862;134317;53699;18.4;7.4
54;2021-04-15;2881;2291;137198;55990;18.8;7.7
54;2021-04-16;3139;2594;140337;58584;19.2;8.0
54;2021-04-17;3473;1486;143810;60070;19.7;8.2
54;2021-04-18;61;245;143871;60315;19.7;8.3
54;2021-04-19;2461;1074;146332;61389;20.0;8.4
54;2021-04-20;3015;1241;149347;62630;20.4;8.6
54;2021-04-21;4401;1614;153748;64244;21.0;8.8
54;2021-04-22;3721;2367;157469;66611;21.6;9.1
54;2021-04-23;3867;2066;161336;68677;22.1;9.4
54;2021-04-24;2345;1033;163681;69710;22.4;9.5
54;2021-04-25;284;276;163965;69986;22.4;9.6
54;2021-04-26;2303;1268;166268;71254;22.8;9.8
54;2021-04-27;3267;1425;169535;72679;23.2;10.0
54;2021-04-28;2973;1939;172508;74618;23.6;10.2
54;2021-04-29;3794;2076;176302;76694;24.1;10.5
54;2021-04-30;4491;1950;180793;78644;24.8;10.8
54;2021-05-01;2262;801;183055;79445;25.1;10.9
54;2021-05-02;229;68;183284;79513;25.1;10.9
54;2021-05-03;3093;936;186377;80449;25.5;11.0
54;2021-05-04;3517;1439;189894;81888;26.0;11.2
54;2021-05-05;4892;1395;194786;83283;26.7;11.4
54;2021-05-06;4437;2790;199223;86073;27.3;11.8
54;2021-05-07;4825;3393;204048;89466;27.9;12.2
54;2021-05-08;2023;635;206071;90101;28.2;12.3
54;2021-05-09;375;134;206446;90235;28.3;12.4
54;2021-05-10;3206;2234;209652;92469;28.7;12.7
54;2021-05-11;5487;2927;215139;95396;29.5;13.1
54;2021-05-12;4143;3382;219282;98778;30.0;13.5
54;2021-05-13;2643;486;221925;99264;30.4;13.6
54;2021-05-14;6883;1984;228808;101248;31.3;13.9
54;2021-05-15;5477;1307;234285;102555;32.1;14.0
54;2021-05-16;945;107;235230;102662;32.2;14.1
54;2021-05-17;3792;815;239022;103477;32.7;14.2
54;2021-05-18;3287;1097;242309;104574;33.2;14.3
54;2021-05-19;3463;1513;245772;106087;33.6;14.5
54;2021-05-20;4537;1616;250309;107703;34.3;14.7
54;2021-05-21;6738;2490;257047;110193;35.2;15.1
54;2021-05-22;5641;1361;262688;111554;36.0;15.3
54;2021-05-23;504;54;263192;111608;36.0;15.3
54;2021-05-24;1444;341;264636;111949;36.2;15.3
54;2021-05-25;4165;1533;268801;113482;36.8;15.5
54;2021-05-26;3530;2208;272331;115690;37.3;15.8
54;2021-05-27;4174;2434;276505;118124;37.9;16.2
54;2021-05-28;4962;3557;281467;121681;38.5;16.7
54;2021-05-29;3841;3983;285308;125664;39.1;17.2
54;2021-05-30;127;83;285435;125747;39.1;17.2
54;2021-05-31;2934;3063;288369;128810;39.5;17.6
54;2021-06-01;2618;4202;290987;133012;39.8;18.2
54;2021-06-02;2162;4087;293149;137099;40.1;18.8
54;2021-06-03;3141;5652;296290;142751;40.6;19.5
54;2021-06-04;5077;5472;301367;148223;41.3;20.3
54;2021-06-05;2344;3286;303711;151509;41.6;20.7
54;2021-06-06;70;236;303781;151745;41.6;20.8
54;2021-06-07;3705;2931;307486;154676;42.1;21.2
54;2021-06-08;4536;4262;312022;158938;42.7;21.8
54;2021-06-09;5979;3293;318001;162231;43.5;22.2
54;2021-06-10;5293;4426;323294;166657;44.3;22.8
54;2021-06-11;5007;4900;328301;171557;44.9;23.5
54;2021-06-12;4225;3223;332526;174780;45.5;23.9
54;2021-06-13;56;210;332582;174990;45.5;24.0
54;2021-06-14;2329;3585;334911;178575;45.9;24.4
54;2021-06-15;2827;4728;337738;183303;46.2;25.1
54;2021-06-16;3483;5632;341221;188935;46.7;25.9
54;2021-06-17;3140;5218;344361;194153;47.1;26.6
54;2021-06-18;4144;6227;348505;200380;47.7;27.4
54;2021-06-19;2657;3123;351162;203503;48.1;27.9
54;2021-06-20;119;338;351281;203841;48.1;27.9
54;2021-06-21;2553;4759;353834;208600;48.4;28.6
54;2021-06-22;2044;6224;355878;214824;48.7;29.4
54;2021-06-23;2236;5591;358114;220415;49.0;30.2
54;2021-06-24;2093;3459;360207;223874;49.3;30.7
54;2021-06-25;2197;7039;362404;230913;49.6;31.6
54;2021-06-26;2383;5654;364787;236567;49.9;32.4
54;2021-06-27;136;609;364923;237176;50.0;32.5
54;2021-06-28;1954;4340;366877;241516;50.2;33.1
54;2021-06-29;1938;5207;368815;246723;50.5;33.8
54;2021-06-30;1976;5120;370791;251843;50.8;34.5
54;2021-07-01;2112;5976;372903;257819;51.1;35.3
54;2021-07-02;2806;7551;375709;265370;51.4;36.3
54;2021-07-03;2806;4077;378515;269447;51.8;36.9
54;2021-07-04;195;499;378710;269946;51.8;37.0
54;2021-07-05;1666;4242;380376;274188;52.1;37.5
54;2021-07-06;2011;5053;382387;279241;52.4;38.2
54;2021-07-07;1837;4839;384224;284080;52.6;38.9
54;2021-07-08;1673;4109;385897;288189;52.8;39.5
54;2021-07-09;3169;6013;389066;294202;53.3;40.3
54;2021-07-10;2528;4357;391594;298559;53.6;40.9
54;2021-07-11;12;104;391606;298663;53.6;40.9
54;2021-07-12;2083;4665;393689;303328;53.9;41.5
54;2021-07-13;2597;4967;396286;308295;54.3;42.2
54;2021-07-14;1472;1503;397758;309798;54.5;42.4
54;2021-07-15;3160;4840;400918;314638;54.9;43.1
54;2021-07-16;4601;6217;405519;320855;55.5;43.9
54;2021-07-17;3985;4774;409504;325629;56.1;44.6
54;2021-07-18;1796;1668;411300;327297;56.3;44.8
54;2021-07-19;2534;4033;413834;331330;56.7;45.4
54;2021-07-20;2860;4811;416694;336141;57.1;46.0
54;2021-07-21;3088;6323;419782;342464;57.5;46.9
54;2021-07-22;3200;5714;422982;348178;57.9;47.7
54;2021-07-23;3916;7009;426898;355187;58.4;48.6
54;2021-07-24;2906;5308;429804;360495;58.8;49.4
54;2021-07-25;69;49;429873;360544;58.9;49.4
54;2021-07-26;2936;4155;432809;364699;59.3;49.9
54;2021-07-27;3664;3995;436473;368694;59.8;50.5
54;2021-07-28;4900;3826;441373;372520;60.4;51.0
54;2021-07-29;5079;3194;446452;375714;61.1;51.4
54;2021-07-30;5011;4959;451463;380673;61.8;52.1
54;2021-07-31;4471;3193;455934;383866;62.4;52.6
54;2021-08-01;256;74;456190;383940;62.5;52.6
54;2021-08-02;3031;3686;459221;387626;62.9;53.1
54;2021-08-03;4043;2908;463264;390534;63.4;53.5
54;2021-08-04;4152;2656;467416;393190;64.0;53.8
54;2021-08-05;4454;2396;471870;395586;64.6;54.2
55;2020-12-27;0;0;0;0;0.0;0.0
55;2020-12-28;0;0;0;0;0.0;0.0
55;2020-12-29;0;0;0;0;0.0;0.0
55;2020-12-30;0;0;0;0;0.0;0.0
55;2020-12-31;0;0;0;0;0.0;0.0
55;2021-01-01;0;0;0;0;0.0;0.0
55;2021-01-02;0;0;0;0;0.0;0.0
55;2021-01-03;0;0;0;0;0.0;0.0
55;2021-01-04;1;0;1;0;0.0;0.0
55;2021-01-05;0;0;1;0;0.0;0.0
55;2021-01-06;0;0;1;0;0.0;0.0
55;2021-01-07;122;0;123;0;0.1;0.0
55;2021-01-08;127;0;250;0;0.1;0.0
55;2021-01-09;52;0;302;0;0.2;0.0
55;2021-01-10;0;0;302;0;0.2;0.0
55;2021-01-11;127;1;429;1;0.2;0.0
55;2021-01-12;119;0;548;1;0.3;0.0
55;2021-01-13;135;0;683;1;0.4;0.0
55;2021-01-14;641;5;1324;6;0.7;0.0
55;2021-01-15;237;0;1561;6;0.9;0.0
55;2021-01-16;62;0;1623;6;0.9;0.0
55;2021-01-17;1;0;1624;6;0.9;0.0
55;2021-01-18;413;1;2037;7;1.1;0.0
55;2021-01-19;351;3;2388;10;1.3;0.0
55;2021-01-20;451;2;2839;12;1.6;0.0
55;2021-01-21;430;0;3269;12;1.8;0.0
55;2021-01-22;391;0;3660;12;2.0;0.0
55;2021-01-23;49;0;3709;12;2.0;0.0
55;2021-01-24;0;0;3709;12;2.0;0.0
55;2021-01-25;436;0;4145;12;2.3;0.0
55;2021-01-26;431;0;4576;12;2.5;0.0
55;2021-01-27;424;0;5000;12;2.8;0.0
55;2021-01-28;485;100;5485;112;3.0;0.1
55;2021-01-29;159;54;5644;166;3.1;0.1
55;2021-01-30;92;28;5736;194;3.2;0.1
55;2021-01-31;0;0;5736;194;3.2;0.1
55;2021-02-01;153;177;5889;371;3.2;0.2
55;2021-02-02;159;148;6048;519;3.3;0.3
55;2021-02-03;53;161;6101;680;3.4;0.4
55;2021-02-04;234;398;6335;1078;3.5;0.6
55;2021-02-05;174;139;6509;1217;3.6;0.7
55;2021-02-06;59;56;6568;1273;3.6;0.7
55;2021-02-07;2;53;6570;1326;3.6;0.7
55;2021-02-08;0;19;6570;1345;3.6;0.7
55;2021-02-09;92;116;6662;1461;3.7;0.8
55;2021-02-10;64;22;6726;1483;3.7;0.8
55;2021-02-11;175;98;6901;1581;3.8;0.9
55;2021-02-12;95;27;6996;1608;3.9;0.9
55;2021-02-13;0;0;6996;1608;3.9;0.9
55;2021-02-14;0;0;6996;1608;3.9;0.9
55;2021-02-15;15;418;7011;2026;3.9;1.1
55;2021-02-16;143;396;7154;2422;3.9;1.3
55;2021-02-17;26;493;7180;2915;4.0;1.6
55;2021-02-18;20;344;7200;3259;4.0;1.8
55;2021-02-19;120;290;7320;3549;4.0;2.0
55;2021-02-20;11;0;7331;3549;4.0;2.0
55;2021-02-21;0;0;7331;3549;4.0;2.0
55;2021-02-22;55;458;7386;4007;4.1;2.2
55;2021-02-23;85;443;7471;4450;4.1;2.4
55;2021-02-24;72;415;7543;4865;4.2;2.7
55;2021-02-25;270;681;7813;5546;4.3;3.1
55;2021-02-26;324;234;8137;5780;4.5;3.2
55;2021-02-27;125;87;8262;5867;4.5;3.2
55;2021-02-28;2;8;8264;5875;4.5;3.2
55;2021-03-01;77;141;8341;6016;4.6;3.3
55;2021-03-02;124;172;8465;6188;4.7;3.4
55;2021-03-03;198;3;8663;6191;4.8;3.4
55;2021-03-04;238;44;8901;6235;4.9;3.4
55;2021-03-05;362;45;9263;6280;5.1;3.5
55;2021-03-06;223;5;9486;6285;5.2;3.5
55;2021-03-07;69;1;9555;6286;5.3;3.5
55;2021-03-08;327;50;9882;6336;5.4;3.5
55;2021-03-09;634;50;10516;6386;5.8;3.5
55;2021-03-10;396;24;10912;6410;6.0;3.5
55;2021-03-11;595;137;11507;6547;6.3;3.6
55;2021-03-12;815;90;12322;6637;6.8;3.7
55;2021-03-13;523;11;12845;6648;7.1;3.7
55;2021-03-14;14;0;12859;6648;7.1;3.7
55;2021-03-15;392;24;13251;6672;7.3;3.7
55;2021-03-16;568;110;13819;6782;7.6;3.7
55;2021-03-17;683;19;14502;6801;8.0;3.7
55;2021-03-18;321;22;14823;6823;8.2;3.8
55;2021-03-19;471;59;15294;6882;8.4;3.8
55;2021-03-20;253;14;15547;6896;8.6;3.8
55;2021-03-21;1;1;15548;6897;8.6;3.8
55;2021-03-22;473;18;16021;6915;8.8;3.8
55;2021-03-23;972;61;16993;6976;9.4;3.8
55;2021-03-24;802;38;17795;7014;9.8;3.9
55;2021-03-25;1096;78;18891;7092;10.4;3.9
55;2021-03-26;602;34;19493;7126;10.7;3.9
55;2021-03-27;255;22;19748;7148;10.9;3.9
55;2021-03-28;0;0;19748;7148;10.9;3.9
55;2021-03-29;943;37;20691;7185;11.4;4.0
55;2021-03-30;1423;69;22114;7254;12.2;4.0
55;2021-03-31;1481;66;23595;7320;13.0;4.0
55;2021-04-01;1202;119;24797;7439;13.7;4.1
55;2021-04-02;897;71;25694;7510;14.1;4.1
55;2021-04-03;82;3;25776;7513;14.2;4.1
55;2021-04-04;2;0;25778;7513;14.2;4.1
55;2021-04-05;6;12;25784;7525;14.2;4.1
55;2021-04-06;933;275;26717;7800;14.7;4.3
55;2021-04-07;993;235;27710;8035;15.3;4.4
55;2021-04-08;1647;415;29357;8450;16.2;4.7
55;2021-04-09;1429;261;30786;8711;16.9;4.8
55;2021-04-10;242;173;31028;8884;17.1;4.9
55;2021-04-11;452;20;31480;8904;17.3;4.9
55;2021-04-12;855;327;32335;9231;17.8;5.1
55;2021-04-13;1355;528;33690;9759;18.5;5.4
55;2021-04-14;1371;728;35061;10487;19.3;5.8
55;2021-04-15;1634;456;36695;10943;20.2;6.0
55;2021-04-16;705;378;37400;11321;20.6;6.2
55;2021-04-17;677;28;38077;11349;21.0;6.2
55;2021-04-18;38;18;38115;11367;21.0;6.3
55;2021-04-19;961;345;39076;11712;21.5;6.4
55;2021-04-20;1172;772;40248;12484;22.2;6.9
55;2021-04-21;990;638;41238;13122;22.7;7.2
55;2021-04-22;1071;650;42309;13772;23.3;7.6
55;2021-04-23;1416;581;43725;14353;24.1;7.9
55;2021-04-24;312;123;44037;14476;24.2;8.0
55;2021-04-25;384;51;44421;14527;24.5;8.0
55;2021-04-26;478;817;44899;15344;24.7;8.4
55;2021-04-27;570;993;45469;16337;25.0;9.0
55;2021-04-28;931;816;46400;17153;25.5;9.4
55;2021-04-29;1118;855;47518;18008;26.2;9.9
55;2021-04-30;1279;618;48797;18626;26.9;10.3
55;2021-05-01;153;132;48950;18758;26.9;10.3
55;2021-05-02;2;3;48952;18761;26.9;10.3
55;2021-05-03;1208;629;50160;19390;27.6;10.7
55;2021-05-04;683;1176;50843;20566;28.0;11.3
55;2021-05-05;658;1074;51501;21640;28.4;11.9
55;2021-05-06;1347;1160;52848;22800;29.1;12.6
55;2021-05-07;1433;554;54281;23354;29.9;12.9
55;2021-05-08;156;77;54437;23431;30.0;12.9
55;2021-05-09;62;523;54499;23954;30.0;13.2
55;2021-05-10;860;1030;55359;24984;30.5;13.8
55;2021-05-11;1070;1379;56429;26363;31.1;14.5
55;2021-05-12;1032;1767;57461;28130;31.6;15.5
55;2021-05-13;99;75;57560;28205;31.7;15.5
55;2021-05-14;352;558;57912;28763;31.9;15.8
55;2021-05-15;291;492;58203;29255;32.0;16.1
55;2021-05-16;3;10;58206;29265;32.0;16.1
55;2021-05-17;1028;840;59234;30105;32.6;16.6
55;2021-05-18;1569;892;60803;30997;33.5;17.1
55;2021-05-19;1810;782;62613;31779;34.5;17.5
55;2021-05-20;2215;730;64828;32509;35.7;17.9
55;2021-05-21;2009;801;66837;33310;36.8;18.3
55;2021-05-22;198;167;67035;33477;36.9;18.4
55;2021-05-23;23;120;67058;33597;36.9;18.5
55;2021-05-24;0;0;67058;33597;36.9;18.5
55;2021-05-25;1348;652;68406;34249;37.7;18.9
55;2021-05-26;1671;1016;70077;35265;38.6;19.4
55;2021-05-27;1318;981;71395;36246;39.3;20.0
55;2021-05-28;1520;931;72915;37177;40.1;20.5
55;2021-05-29;1402;697;74317;37874;40.9;20.9
55;2021-05-30;15;206;74332;38080;40.9;21.0
55;2021-05-31;1049;1131;75381;39211;41.5;21.6
55;2021-06-01;918;957;76299;40168;42.0;22.1
55;2021-06-02;1160;985;77459;41153;42.6;22.7
55;2021-06-03;703;545;78162;41698;43.0;23.0
55;2021-06-04;1390;1101;79552;42799;43.8;23.6
55;2021-06-05;1364;277;80916;43076;44.5;23.7
55;2021-06-06;0;2;80916;43078;44.5;23.7
55;2021-06-07;790;714;81706;43792;45.0;24.1
55;2021-06-08;697;1074;82403;44866;45.4;24.7
55;2021-06-09;851;870;83254;45736;45.8;25.2
55;2021-06-10;379;275;83633;46011;46.0;25.3
55;2021-06-11;527;1287;84160;47298;46.3;26.0
55;2021-06-12;760;519;84920;47817;46.8;26.3
55;2021-06-13;265;33;85185;47850;46.9;26.3
55;2021-06-14;385;1363;85570;49213;47.1;27.1
55;2021-06-15;573;1214;86143;50427;47.4;27.8
55;2021-06-16;734;830;86877;51257;47.8;28.2
55;2021-06-17;425;858;87302;52115;48.1;28.7
55;2021-06-18;664;1473;87966;53588;48.4;29.5
55;2021-06-19;593;457;88559;54045;48.8;29.8
55;2021-06-20;0;0;88559;54045;48.8;29.8
55;2021-06-21;434;1022;88993;55067;49.0;30.3
55;2021-06-22;335;1014;89328;56081;49.2;30.9
55;2021-06-23;626;1214;89954;57295;49.5;31.5
55;2021-06-24;164;433;90118;57728;49.6;31.8
55;2021-06-25;642;1224;90760;58952;50.0;32.5
55;2021-06-26;418;339;91178;59291;50.2;32.6
55;2021-06-27;1;2;91179;59293;50.2;32.6
55;2021-06-28;148;1380;91327;60673;50.3;33.4
55;2021-06-29;200;1289;91527;61962;50.4;34.1
55;2021-06-30;269;1932;91796;63894;50.5;35.2
55;2021-07-01;385;1978;92181;65872;50.7;36.3
55;2021-07-02;390;1720;92571;67592;51.0;37.2
55;2021-07-03;108;261;92679;67853;51.0;37.4
55;2021-07-04;12;19;92691;67872;51.0;37.4
55;2021-07-05;222;1510;92913;69382;51.2;38.2
55;2021-07-06;316;893;93229;70275;51.3;38.7
55;2021-07-07;387;1802;93616;72077;51.5;39.7
55;2021-07-08;531;1594;94147;73671;51.8;40.6
55;2021-07-09;448;1481;94595;75152;52.1;41.4
55;2021-07-10;352;1111;94947;76263;52.3;42.0
55;2021-07-11;0;9;94947;76272;52.3;42.0
55;2021-07-12;602;1169;95549;77441;52.6;42.6
55;2021-07-13;598;1487;96147;78928;52.9;43.5
55;2021-07-14;0;13;96147;78941;52.9;43.5
55;2021-07-15;774;1645;96921;80586;53.4;44.4
55;2021-07-16;1252;1810;98173;82396;54.0;45.4
55;2021-07-17;1275;816;99448;83212;54.7;45.8
55;2021-07-18;1;2;99449;83214;54.8;45.8
55;2021-07-19;595;785;100044;83999;55.1;46.2
55;2021-07-20;993;1027;101037;85026;55.6;46.8
55;2021-07-21;1471;1369;102508;86395;56.4;47.6
55;2021-07-22;1164;565;103672;86960;57.1;47.9
55;2021-07-23;1105;1354;104777;88314;57.7;48.6
55;2021-07-24;808;761;105585;89075;58.1;49.0
55;2021-07-25;119;229;105704;89304;58.2;49.2
55;2021-07-26;665;441;106369;89745;58.6;49.4
55;2021-07-27;1153;474;107522;90219;59.2;49.7
55;2021-07-28;1031;1065;108553;91284;59.8;50.3
55;2021-07-29;668;448;109221;91732;60.1;50.5
55;2021-07-30;1265;959;110486;92691;60.8;51.0
55;2021-07-31;708;611;111194;93302;61.2;51.4
55;2021-08-01;8;5;111202;93307;61.2;51.4
55;2021-08-02;611;444;111813;93751;61.6;51.6
55;2021-08-03;638;420;112451;94171;61.9;51.8
55;2021-08-04;1241;951;113692;95122;62.6;52.4
55;2021-08-05;996;319;114688;95441;63.1;52.5
56;2020-12-27;0;0;0;0;0.0;0.0
56;2020-12-28;1;0;1;0;0.0;0.0
56;2020-12-29;0;0;1;0;0.0;0.0
56;2020-12-30;0;0;1;0;0.0;0.0
56;2020-12-31;0;0;1;0;0.0;0.0
56;2021-01-01;0;0;1;0;0.0;0.0
56;2021-01-02;1;0;2;0;0.0;0.0
56;2021-01-03;0;0;2;0;0.0;0.0
56;2021-01-04;1;0;3;0;0.0;0.0
56;2021-01-05;1;0;4;0;0.0;0.0
56;2021-01-06;1;0;5;0;0.0;0.0
56;2021-01-07;198;0;203;0;0.0;0.0
56;2021-01-08;119;0;322;0;0.0;0.0
56;2021-01-09;1;0;323;0;0.0;0.0
56;2021-01-10;1;0;324;0;0.0;0.0
56;2021-01-11;242;0;566;0;0.1;0.0
56;2021-01-12;754;0;1320;0;0.2;0.0
56;2021-01-13;637;1;1957;1;0.3;0.0
56;2021-01-14;969;2;2926;3;0.4;0.0
56;2021-01-15;840;5;3766;8;0.5;0.0
56;2021-01-16;234;3;4000;11;0.5;0.0
56;2021-01-17;26;0;4026;11;0.5;0.0
56;2021-01-18;1004;1;5030;12;0.7;0.0
56;2021-01-19;851;1;5881;13;0.8;0.0
56;2021-01-20;884;1;6765;14;0.9;0.0
56;2021-01-21;1459;2;8224;16;1.1;0.0
56;2021-01-22;1178;1;9402;17;1.2;0.0
56;2021-01-23;319;2;9721;19;1.3;0.0
56;2021-01-24;6;0;9727;19;1.3;0.0
56;2021-01-25;825;0;10552;19;1.4;0.0
56;2021-01-26;1035;4;11587;23;1.5;0.0
56;2021-01-27;1082;62;12669;85;1.7;0.0
56;2021-01-28;975;125;13644;210;1.8;0.0
56;2021-01-29;873;107;14517;317;1.9;0.0
56;2021-01-30;138;19;14655;336;1.9;0.0
56;2021-01-31;0;0;14655;336;1.9;0.0
56;2021-02-01;479;158;15134;494;2.0;0.1
56;2021-02-02;942;257;16076;751;2.1;0.1
56;2021-02-03;1022;270;17098;1021;2.3;0.1
56;2021-02-04;4693;348;21791;1369;2.9;0.2
56;2021-02-05;3588;431;25379;1800;3.4;0.2
56;2021-02-06;548;170;25927;1970;3.4;0.3
56;2021-02-07;136;26;26063;1996;3.4;0.3
56;2021-02-08;296;288;26359;2284;3.5;0.3
56;2021-02-09;794;509;27153;2793;3.6;0.4
56;2021-02-10;863;701;28016;3494;3.7;0.5
56;2021-02-11;972;1077;28988;4571;3.8;0.6
56;2021-02-12;1150;642;30138;5213;4.0;0.7
56;2021-02-13;220;104;30358;5317;4.0;0.7
56;2021-02-14;6;46;30364;5363;4.0;0.7
56;2021-02-15;621;1089;30985;6452;4.1;0.9
56;2021-02-16;1219;739;32204;7191;4.3;1.0
56;2021-02-17;1189;960;33393;8151;4.4;1.1
56;2021-02-18;1352;884;34745;9035;4.6;1.2
56;2021-02-19;1320;915;36065;9950;4.8;1.3
56;2021-02-20;365;262;36430;10212;4.8;1.4
56;2021-02-21;0;0;36430;10212;4.8;1.4
56;2021-02-22;374;700;36804;10912;4.9;1.4
56;2021-02-23;739;965;37543;11877;5.0;1.6
56;2021-02-24;914;1183;38457;13060;5.1;1.7
56;2021-02-25;2028;4245;40485;17305;5.4;2.3
56;2021-02-26;2355;2258;42840;19563;5.7;2.6
56;2021-02-27;744;446;43584;20009;5.8;2.6
56;2021-02-28;14;114;43598;20123;5.8;2.7
56;2021-03-01;647;560;44245;20683;5.9;2.7
56;2021-03-02;977;790;45222;21473;6.0;2.8
56;2021-03-03;1149;912;46371;22385;6.1;3.0
56;2021-03-04;1965;1039;48336;23424;6.4;3.1
56;2021-03-05;2576;1429;50912;24853;6.7;3.3
56;2021-03-06;1206;216;52118;25069;6.9;3.3
56;2021-03-07;282;24;52400;25093;6.9;3.3
56;2021-03-08;1139;391;53539;25484;7.1;3.4
56;2021-03-09;2034;630;55573;26114;7.4;3.5
56;2021-03-10;2001;936;57574;27050;7.6;3.6
56;2021-03-11;3253;737;60827;27787;8.1;3.7
56;2021-03-12;4206;828;65033;28615;8.6;3.8
56;2021-03-13;1879;147;66912;28762;8.9;3.8
56;2021-03-14;192;2;67104;28764;8.9;3.8
56;2021-03-15;1282;529;68386;29293;9.1;3.9
56;2021-03-16;1088;1035;69474;30328;9.2;4.0
56;2021-03-17;1359;779;70833;31107;9.4;4.1
56;2021-03-18;1998;1869;72831;32976;9.6;4.4
56;2021-03-19;2938;1396;75769;34372;10.0;4.5
56;2021-03-20;1491;206;77260;34578;10.2;4.6
56;2021-03-21;208;24;77468;34602;10.3;4.6
56;2021-03-22;1609;402;79077;35004;10.5;4.6
56;2021-03-23;2806;686;81883;35690;10.8;4.7
56;2021-03-24;3450;528;85333;36218;11.3;4.8
56;2021-03-25;4234;717;89567;36935;11.9;4.9
56;2021-03-26;5088;779;94655;37714;12.5;5.0
56;2021-03-27;1499;294;96154;38008;12.7;5.0
56;2021-03-28;263;11;96417;38019;12.8;5.0
56;2021-03-29;2231;503;98648;38522;13.1;5.1
56;2021-03-30;3519;782;102167;39304;13.5;5.2
56;2021-03-31;3114;710;105281;40014;13.9;5.3
56;2021-04-01;4068;817;109349;40831;14.5;5.4
56;2021-04-02;3926;938;113275;41769;15.0;5.5
56;2021-04-03;1186;269;114461;42038;15.1;5.6
56;2021-04-04;231;3;114692;42041;15.2;5.6
56;2021-04-05;244;8;114936;42049;15.2;5.6
56;2021-04-06;2822;1232;117758;43281;15.6;5.7
56;2021-04-07;4020;1180;121778;44461;16.1;5.9
56;2021-04-08;5289;1164;127067;45625;16.8;6.0
56;2021-04-09;7388;1280;134455;46905;17.8;6.2
56;2021-04-10;2580;421;137035;47326;18.1;6.3
56;2021-04-11;194;102;137229;47428;18.2;6.3
56;2021-04-12;3932;835;141161;48263;18.7;6.4
56;2021-04-13;5964;1256;147125;49519;19.5;6.6
56;2021-04-14;5167;1423;152292;50942;20.2;6.7
56;2021-04-15;7139;1766;159431;52708;21.1;7.0
56;2021-04-16;7840;2007;167271;54715;22.1;7.2
56;2021-04-17;3131;640;170402;55355;22.6;7.3
56;2021-04-18;528;106;170930;55461;22.6;7.3
56;2021-04-19;3719;1260;174649;56721;23.1;7.5
56;2021-04-20;4102;1975;178751;58696;23.7;7.8
56;2021-04-21;4060;2321;182811;61017;24.2;8.1
56;2021-04-22;5171;1919;187982;62936;24.9;8.3
56;2021-04-23;5161;2406;193143;65342;25.6;8.6
56;2021-04-24;2899;645;196042;65987;25.9;8.7
56;2021-04-25;465;148;196507;66135;26.0;8.8
56;2021-04-26;4705;1664;201212;67799;26.6;9.0
56;2021-04-27;5093;2548;206305;70347;27.3;9.3
56;2021-04-28;4968;2244;211273;72591;28.0;9.6
56;2021-04-29;5836;2933;217109;75524;28.7;10.0
56;2021-04-30;6243;2806;223352;78330;29.6;10.4
56;2021-05-01;2487;361;225839;78691;29.9;10.4
56;2021-05-02;307;254;226146;78945;29.9;10.4
56;2021-05-03;3865;2069;230011;81014;30.4;10.7
56;2021-05-04;4380;3902;234391;84916;31.0;11.2
56;2021-05-05;3524;3867;237915;88783;31.5;11.8
56;2021-05-06;4378;5427;242293;94210;32.1;12.5
56;2021-05-07;4267;5012;246560;99222;32.6;13.1
56;2021-05-08;1643;316;248203;99538;32.8;13.2
56;2021-05-09;495;223;248698;99761;32.9;13.2
56;2021-05-10;3749;3808;252447;103569;33.4;13.7
56;2021-05-11;4165;5049;256612;108618;34.0;14.4
56;2021-05-12;4341;4775;260953;113393;34.5;15.0
56;2021-05-13;2395;1010;263348;114403;34.9;15.1
56;2021-05-14;4221;4361;267569;118764;35.4;15.7
56;2021-05-15;2486;1893;270055;120657;35.7;16.0
56;2021-05-16;237;488;270292;121145;35.8;16.0
56;2021-05-17;2511;3666;272803;124811;36.1;16.5
56;2021-05-18;3520;4081;276323;128892;36.6;17.1
56;2021-05-19;3529;3389;279852;132281;37.0;17.5
56;2021-05-20;3803;4803;283655;137084;37.5;18.1
56;2021-05-21;3742;5220;287397;142304;38.0;18.8
56;2021-05-22;1698;2208;289095;144512;38.3;19.1
56;2021-05-23;284;197;289379;144709;38.3;19.2
56;2021-05-24;2056;499;291435;145208;38.6;19.2
56;2021-05-25;3139;4464;294574;149672;39.0;19.8
56;2021-05-26;3736;3899;298310;153571;39.5;20.3
56;2021-05-27;4358;4869;302668;158440;40.1;21.0
56;2021-05-28;4633;5958;307301;164398;40.7;21.8
56;2021-05-29;1886;1634;309187;166032;40.9;22.0
56;2021-05-30;317;66;309504;166098;41.0;22.0
56;2021-05-31;4502;3220;314006;169318;41.6;22.4
56;2021-06-01;5664;3387;319670;172705;42.3;22.9
56;2021-06-02;5638;2957;325308;175662;43.1;23.2
56;2021-06-03;6186;3304;331494;178966;43.9;23.7
56;2021-06-04;5810;4414;337304;183380;44.6;24.3
56;2021-06-05;4346;2386;341650;185766;45.2;24.6
56;2021-06-06;496;616;342146;186382;45.3;24.7
56;2021-06-07;5105;3170;347251;189552;46.0;25.1
56;2021-06-08;6066;3378;353317;192930;46.8;25.5
56;2021-06-09;6433;2814;359750;195744;47.6;25.9
56;2021-06-10;7475;2869;367225;198613;48.6;26.3
56;2021-06-11;6762;3871;373987;202484;49.5;26.8
56;2021-06-12;5100;2066;379087;204550;50.2;27.1
56;2021-06-13;1977;438;381064;204988;50.4;27.1
56;2021-06-14;3310;4594;384374;209582;50.9;27.7
56;2021-06-15;4206;4901;388580;214483;51.4;28.4
56;2021-06-16;4495;4504;393075;218987;52.0;29.0
56;2021-06-17;4255;4753;397330;223740;52.6;29.6
56;2021-06-18;4517;5973;401847;229713;53.2;30.4
56;2021-06-19;3835;2142;405682;231855;53.7;30.7
56;2021-06-20;1504;340;407186;232195;53.9;30.7
56;2021-06-21;3308;4466;410494;236661;54.3;31.3
56;2021-06-22;3484;5440;413978;242101;54.8;32.0
56;2021-06-23;3747;5065;417725;247166;55.3;32.7
56;2021-06-24;3475;5318;421200;252484;55.7;33.4
56;2021-06-25;3875;6275;425075;258759;56.3;34.2
56;2021-06-26;3190;2913;428265;261672;56.7;34.6
56;2021-06-27;306;163;428571;261835;56.7;34.7
56;2021-06-28;1569;3982;430140;265817;56.9;35.2
56;2021-06-29;2404;5747;432544;271564;57.2;35.9
56;2021-06-30;2485;5560;435029;277124;57.6;36.7
56;2021-07-01;2726;4958;437755;282082;57.9;37.3
56;2021-07-02;2648;6208;440403;288290;58.3;38.2
56;2021-07-03;2199;2683;442602;290973;58.6;38.5
56;2021-07-04;776;810;443378;291783;58.7;38.6
56;2021-07-05;1863;5445;445241;297228;58.9;39.3
56;2021-07-06;2177;5942;447418;303170;59.2;40.1
56;2021-07-07;2838;5646;450256;308816;59.6;40.9
56;2021-07-08;3063;6039;453319;314855;60.0;41.7
56;2021-07-09;2211;7107;455530;321962;60.3;42.6
56;2021-07-10;1125;3002;456655;324964;60.4;43.0
56;2021-07-11;255;343;456910;325307;60.5;43.1
56;2021-07-12;2169;6606;459079;331913;60.8;43.9
56;2021-07-13;3237;7473;462316;339386;61.2;44.9
56;2021-07-14;1778;2589;464094;341975;61.4;45.3
56;2021-07-15;3805;7067;467899;349042;61.9;46.2
56;2021-07-16;4059;8097;471958;357139;62.5;47.3
56;2021-07-17;2305;3521;474263;360660;62.8;47.7
56;2021-07-18;253;477;474516;361137;62.8;47.8
56;2021-07-19;2845;6353;477361;367490;63.2;48.6
56;2021-07-20;3701;7927;481062;375417;63.7;49.7
56;2021-07-21;3062;7527;484124;382944;64.1;50.7
56;2021-07-22;4338;8022;488462;390966;64.6;51.7
56;2021-07-23;4352;8400;492814;399366;65.2;52.9
56;2021-07-24;1682;4600;494496;403966;65.4;53.5
56;2021-07-25;547;1918;495043;405884;65.5;53.7
56;2021-07-26;3656;5461;498699;411345;66.0;54.4
56;2021-07-27;5337;6198;504036;417543;66.7;55.3
56;2021-07-28;4654;5457;508690;423000;67.3;56.0
56;2021-07-29;5355;5621;514045;428621;68.0;56.7
56;2021-07-30;5336;5843;519381;434464;68.7;57.5
56;2021-07-31;2131;2683;521512;437147;69.0;57.9
56;2021-08-01;1142;971;522654;438118;69.2;58.0
56;2021-08-02;4488;4595;527142;442713;69.8;58.6
56;2021-08-03;6352;4939;533494;447652;70.6;59.2
56;2021-08-04;5918;4324;539412;451976;71.4;59.8
56;2021-08-05;6025;4584;545437;456560;72.2;60.4
57;2020-12-27;2;0;2;0;0.0;0.0
57;2020-12-28;0;0;2;0;0.0;0.0
57;2020-12-29;1;0;3;0;0.0;0.0
57;2020-12-30;1;0;4;0;0.0;0.0
57;2020-12-31;0;0;4;0;0.0;0.0
57;2021-01-01;0;0;4;0;0.0;0.0
57;2021-01-02;3;0;7;0;0.0;0.0
57;2021-01-03;0;0;7;0;0.0;0.0
57;2021-01-04;15;0;22;0;0.0;0.0
57;2021-01-05;199;0;221;0;0.0;0.0
57;2021-01-06;226;1;447;1;0.0;0.0
57;2021-01-07;584;2;1031;3;0.1;0.0
57;2021-01-08;509;2;1540;5;0.1;0.0
57;2021-01-09;200;0;1740;5;0.2;0.0
57;2021-01-10;108;1;1848;6;0.2;0.0
57;2021-01-11;470;1;2318;7;0.2;0.0
57;2021-01-12;613;5;2931;12;0.3;0.0
57;2021-01-13;695;2;3626;14;0.4;0.0
57;2021-01-14;706;6;4332;20;0.4;0.0
57;2021-01-15;634;2;4966;22;0.5;0.0
57;2021-01-16;452;1;5418;23;0.5;0.0
57;2021-01-17;492;1;5910;24;0.6;0.0
57;2021-01-18;2705;18;8615;42;0.8;0.0
57;2021-01-19;2568;17;11183;59;1.1;0.0
57;2021-01-20;2762;16;13945;75;1.3;0.0
57;2021-01-21;1792;5;15737;80;1.5;0.0
57;2021-01-22;1322;6;17059;86;1.6;0.0
57;2021-01-23;543;15;17602;101;1.7;0.0
57;2021-01-24;1;0;17603;101;1.7;0.0
57;2021-01-25;869;185;18472;286;1.8;0.0
57;2021-01-26;1112;215;19584;501;1.9;0.0
57;2021-01-27;1069;183;20653;684;2.0;0.1
57;2021-01-28;1040;299;21693;983;2.1;0.1
57;2021-01-29;981;396;22674;1379;2.2;0.1
57;2021-01-30;440;94;23114;1473;2.2;0.1
57;2021-01-31;11;27;23125;1500;2.2;0.1
57;2021-02-01;826;351;23951;1851;2.3;0.2
57;2021-02-02;989;363;24940;2214;2.4;0.2
57;2021-02-03;986;320;25926;2534;2.5;0.2
57;2021-02-04;1137;810;27063;3344;2.6;0.3
57;2021-02-05;928;356;27991;3700;2.7;0.4
57;2021-02-06;480;349;28471;4049;2.7;0.4
57;2021-02-07;103;334;28574;4383;2.8;0.4
57;2021-02-08;1255;1557;29829;5940;2.9;0.6
57;2021-02-09;1762;1677;31591;7617;3.0;0.7
57;2021-02-10;1709;2077;33300;9694;3.2;0.9
57;2021-02-11;1486;1331;34786;11025;3.4;1.1
57;2021-02-12;1226;677;36012;11702;3.5;1.1
57;2021-02-13;1152;177;37164;11879;3.6;1.1
57;2021-02-14;1210;27;38374;11906;3.7;1.1
57;2021-02-15;765;863;39139;12769;3.8;1.2
57;2021-02-16;1072;800;40211;13569;3.9;1.3
57;2021-02-17;1008;961;41219;14530;4.0;1.4
57;2021-02-18;974;1160;42193;15690;4.1;1.5
57;2021-02-19;954;939;43147;16629;4.2;1.6
57;2021-02-20;1173;616;44320;17245;4.3;1.7
57;2021-02-21;323;11;44643;17256;4.3;1.7
57;2021-02-22;1230;913;45873;18169;4.4;1.8
57;2021-02-23;2234;1087;48107;19256;4.6;1.9
57;2021-02-24;2267;1000;50374;20256;4.9;2.0
57;2021-02-25;3296;1118;53670;21374;5.2;2.1
57;2021-02-26;3576;965;57246;22339;5.5;2.2
57;2021-02-27;3689;534;60935;22873;5.9;2.2
57;2021-02-28;1896;55;62831;22928;6.1;2.2
57;2021-03-01;2048;1341;64879;24269;6.3;2.3
57;2021-03-02;2851;1599;67730;25868;6.5;2.5
57;2021-03-03;2802;1609;70532;27477;6.8;2.7
57;2021-03-04;3269;1298;73801;28775;7.1;2.8
57;2021-03-05;4452;1237;78253;30012;7.6;2.9
57;2021-03-06;7238;783;85491;30795;8.3;3.0
57;2021-03-07;6070;271;91561;31066;8.8;3.0
57;2021-03-08;2297;1004;93858;32070;9.1;3.1
57;2021-03-09;3382;1303;97240;33373;9.4;3.2
57;2021-03-10;3574;965;100814;34338;9.7;3.3
57;2021-03-11;4033;1245;104847;35583;10.1;3.4
57;2021-03-12;5105;1212;109952;36795;10.6;3.6
57;2021-03-13;6281;980;116233;37775;11.2;3.6
57;2021-03-14;2424;422;118657;38197;11.5;3.7
57;2021-03-15;2957;872;121614;39069;11.7;3.8
57;2021-03-16;3060;1265;124674;40334;12.0;3.9
57;2021-03-17;3050;1135;127724;41469;12.3;4.0
57;2021-03-18;3400;1072;131124;42541;12.7;4.1
57;2021-03-19;4616;1036;135740;43577;13.1;4.2
57;2021-03-20;4697;1022;140437;44599;13.6;4.3
57;2021-03-21;1895;257;142332;44856;13.7;4.3
57;2021-03-22;2479;1471;144811;46327;14.0;4.5
57;2021-03-23;3439;2336;148250;48663;14.3;4.7
57;2021-03-24;3892;2145;152142;50808;14.7;4.9
57;2021-03-25;4736;2581;156878;53389;15.1;5.2
57;2021-03-26;4839;2254;161717;55643;15.6;5.4
57;2021-03-27;3709;3153;165426;58796;16.0;5.7
57;2021-03-28;1400;1849;166826;60645;16.1;5.9
57;2021-03-29;1937;2170;168763;62815;16.3;6.1
57;2021-03-30;3300;2484;172063;65299;16.6;6.3
57;2021-03-31;2820;2306;174883;67605;16.9;6.5
57;2021-04-01;3222;3170;178105;70775;17.2;6.8
57;2021-04-02;2391;2575;180496;73350;17.4;7.1
57;2021-04-03;2567;2665;183063;76015;17.7;7.3
57;2021-04-04;591;974;183654;76989;17.7;7.4
57;2021-04-05;1921;667;185575;77656;17.9;7.5
57;2021-04-06;2450;2829;188025;80485;18.2;7.8
57;2021-04-07;3810;3080;191835;83565;18.5;8.1
57;2021-04-08;5607;2874;197442;86439;19.1;8.3
57;2021-04-09;5008;2717;202450;89156;19.5;8.6
57;2021-04-10;2353;3636;204803;92792;19.8;9.0
57;2021-04-11;1097;1888;205900;94680;19.9;9.1
57;2021-04-12;1788;2753;207688;97433;20.0;9.4
57;2021-04-13;1974;3031;209662;100464;20.2;9.7
57;2021-04-14;1918;2986;211580;103450;20.4;10.0
57;2021-04-15;2365;3427;213945;106877;20.7;10.3
57;2021-04-16;2702;3285;216647;110162;20.9;10.6
57;2021-04-17;2472;3185;219119;113347;21.2;10.9
57;2021-04-18;1245;1774;220364;115121;21.3;11.1
57;2021-04-19;2140;2261;222504;117382;21.5;11.3
57;2021-04-20;2513;2780;225017;120162;21.7;11.6
57;2021-04-21;2568;2375;227585;122537;22.0;11.8
57;2021-04-22;3206;2250;230791;124787;22.3;12.0
57;2021-04-23;4055;2576;234846;127363;22.7;12.3
57;2021-04-24;3393;2555;238239;129918;23.0;12.5
57;2021-04-25;757;1127;238996;131045;23.1;12.7
57;2021-04-26;2969;1992;241965;133037;23.4;12.8
57;2021-04-27;3898;2371;245863;135408;23.7;13.1
57;2021-04-28;4212;2588;250075;137996;24.1;13.3
57;2021-04-29;5254;3442;255329;141438;24.6;13.7
57;2021-04-30;4725;3547;260054;144985;25.1;14.0
57;2021-05-01;2351;1683;262405;146668;25.3;14.2
57;2021-05-02;789;912;263194;147580;25.4;14.2
57;2021-05-03;3563;2987;266757;150567;25.8;14.5
57;2021-05-04;4870;3165;271627;153732;26.2;14.8
57;2021-05-05;6121;3170;277748;156902;26.8;15.1
57;2021-05-06;5990;3286;283738;160188;27.4;15.5
57;2021-05-07;6853;3445;290591;163633;28.1;15.8
57;2021-05-08;4050;1606;294641;165239;28.4;16.0
57;2021-05-09;2048;1109;296689;166348;28.6;16.1
57;2021-05-10;5126;3070;301815;169418;29.1;16.4
57;2021-05-11;7445;2850;309260;172268;29.9;16.6
57;2021-05-12;7839;3238;317099;175506;30.6;16.9
57;2021-05-13;4510;911;321609;176417;31.0;17.0
57;2021-05-14;7835;2633;329444;179050;31.8;17.3
57;2021-05-15;5963;2046;335407;181096;32.4;17.5
57;2021-05-16;3309;578;338716;181674;32.7;17.5
57;2021-05-17;3864;2066;342580;183740;33.1;17.7
57;2021-05-18;6289;2102;348869;185842;33.7;17.9
57;2021-05-19;7017;2329;355886;188171;34.4;18.2
57;2021-05-20;6045;2184;361931;190355;34.9;18.4
57;2021-05-21;7563;2915;369494;193270;35.7;18.7
57;2021-05-22;4893;2164;374387;195434;36.1;18.9
57;2021-05-23;1964;431;376351;195865;36.3;18.9
57;2021-05-24;3031;1068;379382;196933;36.6;19.0
57;2021-05-25;5575;2800;384957;199733;37.2;19.3
57;2021-05-26;6371;3180;391328;202913;37.8;19.6
57;2021-05-27;5791;3123;397119;206036;38.3;19.9
57;2021-05-28;7023;4747;404142;210783;39.0;20.3
57;2021-05-29;5220;4251;409362;215034;39.5;20.8
57;2021-05-30;1968;1743;411330;216777;39.7;20.9
57;2021-05-31;4317;3338;415647;220115;40.1;21.2
57;2021-06-01;5935;3707;421582;223822;40.7;21.6
57;2021-06-02;6340;3901;427922;227723;41.3;22.0
57;2021-06-03;6211;3694;434133;231417;41.9;22.3
57;2021-06-04;7560;4988;441693;236405;42.6;22.8
57;2021-06-05;4767;4031;446460;240436;43.1;23.2
57;2021-06-06;1995;890;448455;241326;43.3;23.3
57;2021-06-07;4322;4033;452777;245359;43.7;23.7
57;2021-06-08;6711;4305;459488;249664;44.4;24.1
57;2021-06-09;6871;4155;466359;253819;45.0;24.5
57;2021-06-10;6217;4585;472576;258404;45.6;24.9
57;2021-06-11;5360;5354;477936;263758;46.1;25.5
57;2021-06-12;5739;4451;483675;268209;46.7;25.9
57;2021-06-13;1497;1138;485172;269347;46.8;26.0
57;2021-06-14;3367;4708;488539;274055;47.2;26.5
57;2021-06-15;3807;6013;492346;280068;47.5;27.0
57;2021-06-16;4396;6590;496742;286658;48.0;27.7
57;2021-06-17;4192;6078;500934;292736;48.4;28.3
57;2021-06-18;4273;7302;505207;300038;48.8;29.0
57;2021-06-19;4135;6289;509342;306327;49.2;29.6
57;2021-06-20;967;1667;510309;307994;49.3;29.7
57;2021-06-21;2065;5971;512374;313965;49.5;30.3
57;2021-06-22;2638;7987;515012;321952;49.7;31.1
57;2021-06-23;3068;8387;518080;330339;50.0;31.9
57;2021-06-24;2454;5287;520534;335626;50.3;32.4
57;2021-06-25;2854;7825;523388;343451;50.5;33.2
57;2021-06-26;2859;7259;526247;350710;50.8;33.9
57;2021-06-27;749;2983;526996;353693;50.9;34.1
57;2021-06-28;1587;5075;528583;358768;51.0;34.6
57;2021-06-29;2077;6826;530660;365594;51.2;35.3
57;2021-06-30;3044;7314;533704;372908;51.5;36.0
57;2021-07-01;2673;5946;536377;378854;51.8;36.6
57;2021-07-02;2650;8075;539027;386929;52.0;37.4
57;2021-07-03;3228;6528;542255;393457;52.3;38.0
57;2021-07-04;943;2459;543198;395916;52.4;38.2
57;2021-07-05;1671;4606;544869;400522;52.6;38.7
57;2021-07-06;2403;6479;547272;407001;52.8;39.3
57;2021-07-07;2709;7080;549981;414081;53.1;40.0
57;2021-07-08;2469;5872;552450;419953;53.3;40.5
57;2021-07-09;3412;8417;555862;428370;53.7;41.4
57;2021-07-10;3085;6930;558947;435300;54.0;42.0
57;2021-07-11;846;2227;559793;437527;54.0;42.2
57;2021-07-12;2387;6418;562180;443945;54.3;42.9
57;2021-07-13;4383;7494;566563;451439;54.7;43.6
57;2021-07-14;2815;3846;569378;455285;55.0;44.0
57;2021-07-15;3924;7771;573302;463056;55.3;44.7
57;2021-07-16;5612;9816;578914;472872;55.9;45.6
57;2021-07-17;5797;7278;584711;480150;56.4;46.4
57;2021-07-18;1478;2653;586189;482803;56.6;46.6
57;2021-07-19;2349;6206;588538;489009;56.8;47.2
57;2021-07-20;4297;6905;592835;495914;57.2;47.9
57;2021-07-21;5262;6884;598097;502798;57.7;48.5
57;2021-07-22;5927;5951;604024;508749;58.3;49.1
57;2021-07-23;6987;6370;611011;515119;59.0;49.7
57;2021-07-24;4514;7027;615525;522146;59.4;50.4
57;2021-07-25;1332;1764;616857;523910;59.5;50.6
57;2021-07-26;3702;4489;620559;528399;59.9;51.0
57;2021-07-27;6812;4914;627371;533313;60.6;51.5
57;2021-07-28;7440;4519;634811;537832;61.3;51.9
57;2021-07-29;7569;4573;642380;542405;62.0;52.4
57;2021-07-30;6813;4843;649193;547248;62.7;52.8
57;2021-07-31;5670;4992;654863;552240;63.2;53.3
57;2021-08-01;2017;1110;656880;553350;63.4;53.4
57;2021-08-02;3497;3169;660377;556519;63.8;53.7
57;2021-08-03;5450;4262;665827;560781;64.3;54.1
57;2021-08-04;5182;3446;671009;564227;64.8;54.5
57;2021-08-05;5317;3741;676326;567968;65.3;54.8
58;2020-12-27;0;0;0;0;0.0;0.0
58;2020-12-28;0;0;0;0;0.0;0.0
58;2020-12-29;0;0;0;0;0.0;0.0
58;2020-12-30;0;0;0;0;0.0;0.0
58;2020-12-31;0;0;0;0;0.0;0.0
58;2021-01-01;0;0;0;0;0.0;0.0
58;2021-01-02;0;0;0;0;0.0;0.0
58;2021-01-03;1;0;1;0;0.0;0.0
58;2021-01-04;0;0;1;0;0.0;0.0
58;2021-01-05;0;0;1;0;0.0;0.0
58;2021-01-06;145;0;146;0;0.1;0.0
58;2021-01-07;241;0;387;0;0.2;0.0
58;2021-01-08;63;0;450;0;0.2;0.0
58;2021-01-09;1;0;451;0;0.2;0.0
58;2021-01-10;0;0;451;0;0.2;0.0
58;2021-01-11;54;0;505;0;0.3;0.0
58;2021-01-12;255;0;760;0;0.4;0.0
58;2021-01-13;402;0;1162;0;0.6;0.0
58;2021-01-14;291;1;1453;1;0.7;0.0
58;2021-01-15;141;0;1594;1;0.8;0.0
58;2021-01-16;10;1;1604;2;0.8;0.0
58;2021-01-17;0;0;1604;2;0.8;0.0
58;2021-01-18;413;1;2017;3;1.0;0.0
58;2021-01-19;986;2;3003;5;1.5;0.0
58;2021-01-20;1203;1;4206;6;2.1;0.0
58;2021-01-21;961;4;5167;10;2.6;0.0
58;2021-01-22;769;2;5936;12;3.0;0.0
58;2021-01-23;251;0;6187;12;3.1;0.0
58;2021-01-24;2;0;6189;12;3.1;0.0
58;2021-01-25;438;0;6627;12;3.3;0.0
58;2021-01-26;649;3;7276;15;3.6;0.0
58;2021-01-27;604;44;7880;59;3.9;0.0
58;2021-01-28;756;67;8636;126;4.3;0.1
58;2021-01-29;837;7;9473;133;4.7;0.1
58;2021-01-30;281;0;9754;133;4.9;0.1
58;2021-01-31;10;0;9764;133;4.9;0.1
58;2021-02-01;201;71;9965;204;5.0;0.1
58;2021-02-02;565;85;10530;289;5.3;0.1
58;2021-02-03;278;148;10808;437;5.4;0.2
58;2021-02-04;285;93;11093;530;5.6;0.3
58;2021-02-05;184;94;11277;624;5.6;0.3
58;2021-02-06;89;0;11366;624;5.7;0.3
58;2021-02-07;0;0;11366;624;5.7;0.3
58;2021-02-08;306;74;11672;698;5.8;0.3
58;2021-02-09;503;314;12175;1012;6.1;0.5
58;2021-02-10;349;381;12524;1393;6.3;0.7
58;2021-02-11;287;380;12811;1773;6.4;0.9
58;2021-02-12;243;203;13054;1976;6.5;1.0
58;2021-02-13;83;29;13137;2005;6.6;1.0
58;2021-02-14;0;3;13137;2008;6.6;1.0
58;2021-02-15;114;531;13251;2539;6.6;1.3
58;2021-02-16;208;939;13459;3478;6.7;1.7
58;2021-02-17;217;768;13676;4246;6.9;2.1
58;2021-02-18;187;791;13863;5037;6.9;2.5
58;2021-02-19;241;725;14104;5762;7.1;2.9
58;2021-02-20;62;229;14166;5991;7.1;3.0
58;2021-02-21;0;30;14166;6021;7.1;3.0
58;2021-02-22;78;405;14244;6426;7.1;3.2
58;2021-02-23;49;623;14293;7049;7.2;3.5
58;2021-02-24;39;633;14332;7682;7.2;3.8
58;2021-02-25;252;703;14584;8385;7.3;4.2
58;2021-02-26;246;623;14830;9008;7.4;4.5
58;2021-02-27;104;188;14934;9196;7.5;4.6
58;2021-02-28;11;8;14945;9204;7.5;4.6
58;2021-03-01;145;246;15090;9450;7.6;4.7
58;2021-03-02;415;644;15505;10094;7.8;5.1
58;2021-03-03;521;291;16026;10385;8.0;5.2
58;2021-03-04;723;277;16749;10662;8.4;5.3
58;2021-03-05;866;206;17615;10868;8.8;5.4
58;2021-03-06;574;86;18189;10954;9.1;5.5
58;2021-03-07;63;11;18252;10965;9.1;5.5
58;2021-03-08;151;298;18403;11263;9.2;5.6
58;2021-03-09;544;548;18947;11811;9.5;5.9
58;2021-03-10;837;241;19784;12052;9.9;6.0
58;2021-03-11;856;272;20640;12324;10.3;6.2
58;2021-03-12;862;198;21502;12522;10.8;6.3
58;2021-03-13;506;67;22008;12589;11.0;6.3
58;2021-03-14;34;0;22042;12589;11.0;6.3
58;2021-03-15;528;110;22570;12699;11.3;6.4
58;2021-03-16;726;221;23296;12920;11.7;6.5
58;2021-03-17;756;194;24052;13114;12.1;6.6
58;2021-03-18;582;177;24634;13291;12.3;6.7
58;2021-03-19;535;103;25169;13394;12.6;6.7
58;2021-03-20;322;64;25491;13458;12.8;6.7
58;2021-03-21;17;0;25508;13458;12.8;6.7
58;2021-03-22;795;22;26303;13480;13.2;6.8
58;2021-03-23;1636;41;27939;13521;14.0;6.8
58;2021-03-24;1359;73;29298;13594;14.7;6.8
58;2021-03-25;1840;41;31138;13635;15.6;6.8
58;2021-03-26;1413;50;32551;13685;16.3;6.9
58;2021-03-27;358;6;32909;13691;16.5;6.9
58;2021-03-28;20;0;32929;13691;16.5;6.9
58;2021-03-29;639;154;33568;13845;16.8;6.9
58;2021-03-30;1185;249;34753;14094;17.4;7.1
58;2021-03-31;1117;395;35870;14489;18.0;7.3
58;2021-04-01;1546;399;37416;14888;18.7;7.5
58;2021-04-02;1460;362;38876;15250;19.5;7.6
58;2021-04-03;566;149;39442;15399;19.8;7.7
58;2021-04-04;1;0;39443;15399;19.8;7.7
58;2021-04-05;46;0;39489;15399;19.8;7.7
58;2021-04-06;819;343;40308;15742;20.2;7.9
58;2021-04-07;695;548;41003;16290;20.5;8.2
58;2021-04-08;1493;425;42496;16715;21.3;8.4
58;2021-04-09;1773;482;44269;17197;22.2;8.6
58;2021-04-10;652;201;44921;17398;22.5;8.7
58;2021-04-11;17;3;44938;17401;22.5;8.7
58;2021-04-12;1117;502;46055;17903;23.1;9.0
58;2021-04-13;1437;624;47492;18527;23.8;9.3
58;2021-04-14;1339;672;48831;19199;24.5;9.6
58;2021-04-15;1433;599;50264;19798;25.2;9.9
58;2021-04-16;1734;511;51998;20309;26.1;10.2
58;2021-04-17;721;231;52719;20540;26.4;10.3
58;2021-04-18;20;7;52739;20547;26.4;10.3
58;2021-04-19;532;605;53271;21152;26.7;10.6
58;2021-04-20;486;1120;53757;22272;26.9;11.2
58;2021-04-21;626;970;54383;23242;27.2;11.6
58;2021-04-22;767;1526;55150;24768;27.6;12.4
58;2021-04-23;919;784;56069;25552;28.1;12.8
58;2021-04-24;211;204;56280;25756;28.2;12.9
58;2021-04-25;109;9;56389;25765;28.3;12.9
58;2021-04-26;762;247;57151;26012;28.6;13.0
58;2021-04-27;1499;1110;58650;27122;29.4;13.6
58;2021-04-28;1535;1051;60185;28173;30.2;14.1
58;2021-04-29;1442;1040;61627;29213;30.9;14.6
58;2021-04-30;1257;939;62884;30152;31.5;15.1
58;2021-05-01;6;17;62890;30169;31.5;15.1
58;2021-05-02;4;2;62894;30171;31.5;15.1
58;2021-05-03;1045;403;63939;30574;32.0;15.3
58;2021-05-04;1078;1347;65017;31921;32.6;16.0
58;2021-05-05;951;1091;65968;33012;33.1;16.5
58;2021-05-06;1360;1058;67328;34070;33.7;17.1
58;2021-05-07;1110;1089;68438;35159;34.3;17.6
58;2021-05-08;59;60;68497;35219;34.3;17.6
58;2021-05-09;5;19;68502;35238;34.3;17.7
58;2021-05-10;875;989;69377;36227;34.8;18.2
58;2021-05-11;1185;1981;70562;38208;35.4;19.1
58;2021-05-12;1662;1552;72224;39760;36.2;19.9
58;2021-05-13;50;181;72274;39941;36.2;20.0
58;2021-05-14;2308;908;74582;40849;37.4;20.5
58;2021-05-15;1725;457;76307;41306;38.2;20.7
58;2021-05-16;118;30;76425;41336;38.3;20.7
58;2021-05-17;792;607;77217;41943;38.7;21.0
58;2021-05-18;1332;1184;78549;43127;39.4;21.6
58;2021-05-19;1737;542;80286;43669;40.2;21.9
58;2021-05-20;1699;666;81985;44335;41.1;22.2
58;2021-05-21;855;728;82840;45063;41.5;22.6
58;2021-05-22;304;239;83144;45302;41.7;22.7
58;2021-05-23;2;21;83146;45323;41.7;22.7
58;2021-05-24;21;43;83167;45366;41.7;22.7
58;2021-05-25;1386;1152;84553;46518;42.4;23.3
58;2021-05-26;844;840;85397;47358;42.8;23.7
58;2021-05-27;750;943;86147;48301;43.2;24.2
58;2021-05-28;430;911;86577;49212;43.4;24.7
58;2021-05-29;151;212;86728;49424;43.5;24.8
58;2021-05-30;20;19;86748;49443;43.5;24.8
58;2021-05-31;757;398;87505;49841;43.8;25.0
58;2021-06-01;1371;1658;88876;51499;44.5;25.8
58;2021-06-02;1462;1044;90338;52543;45.3;26.3
58;2021-06-03;1026;958;91364;53501;45.8;26.8
58;2021-06-04;844;913;92208;54414;46.2;27.3
58;2021-06-05;272;262;92480;54676;46.3;27.4
58;2021-06-06;24;49;92504;54725;46.3;27.4
58;2021-06-07;713;791;93217;55516;46.7;27.8
58;2021-06-08;1324;1757;94541;57273;47.4;28.7
58;2021-06-09;1401;1006;95942;58279;48.1;29.2
58;2021-06-10;1108;981;97050;59260;48.6;29.7
58;2021-06-11;1030;906;98080;60166;49.1;30.1
58;2021-06-12;1055;415;99135;60581;49.7;30.4
58;2021-06-13;36;33;99171;60614;49.7;30.4
58;2021-06-14;516;1016;99687;61630;49.9;30.9
58;2021-06-15;1594;1756;101281;63386;50.7;31.8
58;2021-06-16;1805;993;103086;64379;51.6;32.3
58;2021-06-17;2023;1110;105109;65489;52.7;32.8
58;2021-06-18;985;1063;106094;66552;53.2;33.3
58;2021-06-19;581;319;106675;66871;53.4;33.5
58;2021-06-20;8;2;106683;66873;53.4;33.5
58;2021-06-21;472;551;107155;67424;53.7;33.8
58;2021-06-22;1027;1964;108182;69388;54.2;34.8
58;2021-06-23;1477;1510;109659;70898;54.9;35.5
58;2021-06-24;729;1026;110388;71924;55.3;36.0
58;2021-06-25;826;1715;111214;73639;55.7;36.9
58;2021-06-26;554;1226;111768;74865;56.0;37.5
58;2021-06-27;17;26;111785;74891;56.0;37.5
58;2021-06-28;463;988;112248;75879;56.2;38.0
58;2021-06-29;624;2163;112872;78042;56.6;39.1
58;2021-06-30;997;1622;113869;79664;57.0;39.9
58;2021-07-01;754;1673;114623;81337;57.4;40.8
58;2021-07-02;451;849;115074;82186;57.7;41.2
58;2021-07-03;248;512;115322;82698;57.8;41.4
58;2021-07-04;12;30;115334;82728;57.8;41.4
58;2021-07-05;510;770;115844;83498;58.0;41.8
58;2021-07-06;694;2125;116538;85623;58.4;42.9
58;2021-07-07;385;958;116923;86581;58.6;43.4
58;2021-07-08;397;1020;117320;87601;58.8;43.9
58;2021-07-09;709;1420;118029;89021;59.1;44.6
58;2021-07-10;260;413;118289;89434;59.3;44.8
58;2021-07-11;175;52;118464;89486;59.4;44.8
58;2021-07-12;197;969;118661;90455;59.5;45.3
58;2021-07-13;928;2500;119589;92955;59.9;46.6
58;2021-07-14;27;62;119616;93017;59.9;46.6
58;2021-07-15;1129;1941;120745;94958;60.5;47.6
58;2021-07-16;1406;1445;122151;96403;61.2;48.3
58;2021-07-17;461;287;122612;96690;61.4;48.4
58;2021-07-18;102;21;122714;96711;61.5;48.5
58;2021-07-19;1642;996;124356;97707;62.3;49.0
58;2021-07-20;1403;2457;125759;100164;63.0;50.2
58;2021-07-21;1182;2036;126941;102200;63.6;51.2
58;2021-07-22;1133;1672;128074;103872;64.2;52.0
58;2021-07-23;1256;1445;129330;105317;64.8;52.8
58;2021-07-24;993;1270;130323;106587;65.3;53.4
58;2021-07-25;88;39;130411;106626;65.3;53.4
58;2021-07-26;976;859;131387;107485;65.8;53.9
58;2021-07-27;1558;2578;132945;110063;66.6;55.1
58;2021-07-28;1568;1961;134513;112024;67.4;56.1
58;2021-07-29;1567;1615;136080;113639;68.2;56.9
58;2021-07-30;1457;1422;137537;115061;68.9;57.6
58;2021-07-31;559;522;138096;115583;69.2;57.9
58;2021-08-01;34;13;138130;115596;69.2;57.9
58;2021-08-02;1577;859;139707;116455;70.0;58.3
58;2021-08-03;2009;1765;141716;118220;71.0;59.2
58;2021-08-04;1305;1182;143021;119402;71.7;59.8
58;2021-08-05;1607;1175;144628;120577;72.5;60.4
59;2020-12-27;1;0;1;0;0.0;0.0
59;2020-12-28;26;0;27;0;0.0;0.0
59;2020-12-29;0;0;27;0;0.0;0.0
59;2020-12-30;0;0;27;0;0.0;0.0
59;2020-12-31;1;0;28;0;0.0;0.0
59;2021-01-01;3;0;31;0;0.0;0.0
59;2021-01-02;1;0;32;0;0.0;0.0
59;2021-01-03;2;0;34;0;0.0;0.0
59;2021-01-04;79;0;113;0;0.0;0.0
59;2021-01-05;217;0;330;0;0.0;0.0
59;2021-01-06;429;2;759;2;0.0;0.0
59;2021-01-07;1312;0;2071;2;0.1;0.0
59;2021-01-08;1262;4;3333;6;0.1;0.0
59;2021-01-09;609;3;3942;9;0.2;0.0
59;2021-01-10;427;0;4369;9;0.2;0.0
59;2021-01-11;1842;5;6211;14;0.2;0.0
59;2021-01-12;2470;2;8681;16;0.3;0.0
59;2021-01-13;2361;3;11042;19;0.4;0.0
59;2021-01-14;2754;21;13796;40;0.5;0.0
59;2021-01-15;2273;16;16069;56;0.6;0.0
59;2021-01-16;770;1;16839;57;0.7;0.0
59;2021-01-17;559;1;17398;58;0.7;0.0
59;2021-01-18;3506;15;20904;73;0.8;0.0
59;2021-01-19;4750;9;25654;82;1.0;0.0
59;2021-01-20;4131;13;29785;95;1.2;0.0
59;2021-01-21;4723;39;34508;134;1.3;0.0
59;2021-01-22;4014;11;38522;145;1.5;0.0
59;2021-01-23;1213;3;39735;148;1.5;0.0
59;2021-01-24;168;0;39903;148;1.5;0.0
59;2021-01-25;2728;59;42631;207;1.6;0.0
59;2021-01-26;2802;137;45433;344;1.8;0.0
59;2021-01-27;1736;308;47169;652;1.8;0.0
59;2021-01-28;3395;763;50564;1415;2.0;0.1
59;2021-01-29;2539;793;53103;2208;2.1;0.1
59;2021-01-30;287;177;53390;2385;2.1;0.1
59;2021-01-31;24;0;53414;2385;2.1;0.1
59;2021-02-01;76;865;53490;3250;2.1;0.1
59;2021-02-02;682;1435;54172;4685;2.1;0.2
59;2021-02-03;3741;1438;57913;6123;2.2;0.2
59;2021-02-04;2957;1743;60870;7866;2.4;0.3
59;2021-02-05;1047;1410;61917;9276;2.4;0.4
59;2021-02-06;206;355;62123;9631;2.4;0.4
59;2021-02-07;267;49;62390;9680;2.4;0.4
59;2021-02-08;683;1627;63073;11307;2.4;0.4
59;2021-02-09;1007;1850;64080;13157;2.5;0.5
59;2021-02-10;975;1638;65055;14795;2.5;0.6
59;2021-02-11;1344;1812;66399;16607;2.6;0.6
59;2021-02-12;1410;1642;67809;18249;2.6;0.7
59;2021-02-13;207;749;68016;18998;2.6;0.7
59;2021-02-14;13;42;68029;19040;2.6;0.7
59;2021-02-15;1392;3118;69421;22158;2.7;0.9
59;2021-02-16;1431;3775;70852;25933;2.7;1.0
59;2021-02-17;1619;3833;72471;29766;2.8;1.1
59;2021-02-18;3101;5195;75572;34961;2.9;1.4
59;2021-02-19;3209;3615;78781;38576;3.0;1.5
59;2021-02-20;1413;1591;80194;40167;3.1;1.6
59;2021-02-21;242;261;80436;40428;3.1;1.6
59;2021-02-22;1431;2588;81867;43016;3.2;1.7
59;2021-02-23;2657;2866;84524;45882;3.3;1.8
59;2021-02-24;4105;4057;88629;49939;3.4;1.9
59;2021-02-25;6916;3720;95545;53659;3.7;2.1
59;2021-02-26;6497;1887;102042;55546;3.9;2.1
59;2021-02-27;3093;176;105135;55722;4.1;2.2
59;2021-02-28;208;59;105343;55781;4.1;2.2
59;2021-03-01;3693;663;109036;56444;4.2;2.2
59;2021-03-02;4793;565;113829;57009;4.4;2.2
59;2021-03-03;5741;983;119570;57992;4.6;2.2
59;2021-03-04;7076;932;126646;58924;4.9;2.3
59;2021-03-05;7822;967;134468;59891;5.2;2.3
59;2021-03-06;11553;511;146021;60402;5.6;2.3
59;2021-03-07;7583;332;153604;60734;5.9;2.3
59;2021-03-08;4495;1091;158099;61825;6.1;2.4
59;2021-03-09;6580;1392;164679;63217;6.4;2.4
59;2021-03-10;7022;1167;171701;64384;6.6;2.5
59;2021-03-11;9470;1845;181171;66229;7.0;2.6
59;2021-03-12;12139;1493;193310;67722;7.5;2.6
59;2021-03-13;16551;1034;209861;68756;8.1;2.7
59;2021-03-14;6959;309;216820;69065;8.4;2.7
59;2021-03-15;5608;1492;222428;70557;8.6;2.7
59;2021-03-16;3736;1315;226164;71872;8.7;2.8
59;2021-03-17;3851;2084;230015;73956;8.9;2.9
59;2021-03-18;3955;2491;233970;76447;9.0;3.0
59;2021-03-19;7730;1811;241700;78258;9.3;3.0
59;2021-03-20;16009;1232;257709;79490;10.0;3.1
59;2021-03-21;6311;427;264020;79917;10.2;3.1
59;2021-03-22;5443;1769;269463;81686;10.4;3.2
59;2021-03-23;7767;2809;277230;84495;10.7;3.3
59;2021-03-24;6861;2952;284091;87447;11.0;3.4
59;2021-03-25;10519;2521;294610;89968;11.4;3.5
59;2021-03-26;12245;2822;306855;92790;11.9;3.6
59;2021-03-27;15269;1099;322124;93889;12.4;3.6
59;2021-03-28;7978;338;330102;94227;12.8;3.6
59;2021-03-29;5494;3196;335596;97423;13.0;3.8
59;2021-03-30;7537;3731;343133;101154;13.3;3.9
59;2021-03-31;6148;4095;349281;105249;13.5;4.1
59;2021-04-01;7488;4902;356769;110151;13.8;4.3
59;2021-04-02;7637;5516;364406;115667;14.1;4.5
59;2021-04-03;13013;4285;377419;119952;14.6;4.6
59;2021-04-04;5349;2177;382768;122129;14.8;4.7
59;2021-04-05;6009;1529;388777;123658;15.0;4.8
59;2021-04-06;5397;4489;394174;128147;15.2;4.9
59;2021-04-07;7625;5415;401799;133562;15.5;5.2
59;2021-04-08;10386;5721;412185;139283;15.9;5.4
59;2021-04-09;13416;5904;425601;145187;16.4;5.6
59;2021-04-10;11472;6127;437073;151314;16.9;5.8
59;2021-04-11;4634;3567;441707;154881;17.1;6.0
59;2021-04-12;6309;4338;448016;159219;17.3;6.1
59;2021-04-13;8928;4771;456944;163990;17.6;6.3
59;2021-04-14;8790;4321;465734;168311;18.0;6.5
59;2021-04-15;10301;4827;476035;173138;18.4;6.7
59;2021-04-16;10882;5491;486917;178629;18.8;6.9
59;2021-04-17;7297;9076;494214;187705;19.1;7.3
59;2021-04-18;3231;4168;497445;191873;19.2;7.4
59;2021-04-19;5047;4302;502492;196175;19.4;7.6
59;2021-04-20;6896;4203;509388;200378;19.7;7.7
59;2021-04-21;6245;4420;515633;204798;19.9;7.9
59;2021-04-22;8593;5498;524226;210296;20.2;8.1
59;2021-04-23;8453;5670;532679;215966;20.6;8.3
59;2021-04-24;5537;8065;538216;224031;20.8;8.7
59;2021-04-25;3240;6079;541456;230110;20.9;8.9
59;2021-04-26;6490;3785;547946;233895;21.2;9.0
59;2021-04-27;8360;5186;556306;239081;21.5;9.2
59;2021-04-28;8764;6565;565070;245646;21.8;9.5
59;2021-04-29;9412;8559;574482;254205;22.2;9.8
59;2021-04-30;10598;8535;585080;262740;22.6;10.1
59;2021-05-01;11993;7582;597073;270322;23.1;10.4
59;2021-05-02;8645;5982;605718;276304;23.4;10.7
59;2021-05-03;9554;5061;615272;281365;23.8;10.9
59;2021-05-04;11427;6004;626699;287369;24.2;11.1
59;2021-05-05;10292;6209;636991;293578;24.6;11.3
59;2021-05-06;11195;8446;648186;302024;25.0;11.7
59;2021-05-07;13293;9620;661479;311644;25.5;12.0
59;2021-05-08;14733;4158;676212;315802;26.1;12.2
59;2021-05-09;11494;3332;687706;319134;26.6;12.3
59;2021-05-10;12738;6634;700444;325768;27.1;12.6
59;2021-05-11;15113;8332;715557;334100;27.6;12.9
59;2021-05-12;16627;8634;732184;342734;28.3;13.2
59;2021-05-13;18440;3447;750624;346181;29.0;13.4
59;2021-05-14;15780;6958;766404;353139;29.6;13.6
59;2021-05-15;23444;5297;789848;358436;30.5;13.8
59;2021-05-16;21184;2402;811032;360838;31.3;13.9
59;2021-05-17;15072;5270;826104;366108;31.9;14.1
59;2021-05-18;16919;5664;843023;371772;32.6;14.4
59;2021-05-19;18313;5086;861336;376858;33.3;14.6
59;2021-05-20;17930;7012;879266;383870;34.0;14.8
59;2021-05-21;18369;8289;897635;392159;34.7;15.1
59;2021-05-22;23812;5685;921447;397844;35.6;15.4
59;2021-05-23;17922;2264;939369;400108;36.3;15.5
59;2021-05-24;16688;2122;956057;402230;36.9;15.5
59;2021-05-25;14991;6673;971048;408903;37.5;15.8
59;2021-05-26;15890;7041;986938;415944;38.1;16.1
59;2021-05-27;16145;9178;1003083;425122;38.7;16.4
59;2021-05-28;15886;11470;1018969;436592;39.4;16.9
59;2021-05-29;14363;8725;1033332;445317;39.9;17.2
59;2021-05-30;8403;1839;1041735;447156;40.2;17.3
59;2021-05-31;14201;7958;1055936;455114;40.8;17.6
59;2021-06-01;15089;10422;1071025;465536;41.4;18.0
59;2021-06-02;14760;9931;1085785;475467;41.9;18.4
59;2021-06-03;15628;12130;1101413;487597;42.5;18.8
59;2021-06-04;15593;13495;1117006;501092;43.1;19.4
59;2021-06-05;14978;9337;1131984;510429;43.7;19.7
59;2021-06-06;8828;3203;1140812;513632;44.1;19.8
59;2021-06-07;10525;9442;1151337;523074;44.5;20.2
59;2021-06-08;11756;11085;1163093;534159;44.9;20.6
59;2021-06-09;10762;11916;1173855;546075;45.3;21.1
59;2021-06-10;11491;12317;1185346;558392;45.8;21.6
59;2021-06-11;10977;16019;1196323;574411;46.2;22.2
59;2021-06-12;11077;13677;1207400;588088;46.6;22.7
59;2021-06-13;6339;7028;1213739;595116;46.9;23.0
59;2021-06-14;6502;12697;1220241;607813;47.1;23.5
59;2021-06-15;8233;15957;1228474;623770;47.4;24.1
59;2021-06-16;9200;13549;1237674;637319;47.8;24.6
59;2021-06-17;9183;15644;1246857;652963;48.2;25.2
59;2021-06-18;9075;20046;1255932;673009;48.5;26.0
59;2021-06-19;8951;17480;1264883;690489;48.9;26.7
59;2021-06-20;4898;10192;1269781;700681;49.0;27.1
59;2021-06-21;5273;15975;1275054;716656;49.2;27.7
59;2021-06-22;6330;18686;1281384;735342;49.5;28.4
59;2021-06-23;6147;19086;1287531;754428;49.7;29.1
59;2021-06-24;7330;20525;1294861;774953;50.0;29.9
59;2021-06-25;6500;21205;1301361;796158;50.3;30.8
59;2021-06-26;6481;23765;1307842;819923;50.5;31.7
59;2021-06-27;4753;17081;1312595;837004;50.7;32.3
59;2021-06-28;4992;19826;1317587;856830;50.9;33.1
59;2021-06-29;5528;20362;1323115;877192;51.1;33.9
59;2021-06-30;6115;20097;1329230;897289;51.3;34.7
59;2021-07-01;6732;20837;1335962;918126;51.6;35.5
59;2021-07-02;6805;23235;1342767;941361;51.9;36.4
59;2021-07-03;5553;24615;1348320;965976;52.1;37.3
59;2021-07-04;4409;15978;1352729;981954;52.2;37.9
59;2021-07-05;5645;17477;1358374;999431;52.5;38.6
59;2021-07-06;6584;18810;1364958;1018241;52.7;39.3
59;2021-07-07;6810;17468;1371768;1035709;53.0;40.0
59;2021-07-08;7991;17710;1379759;1053419;53.3;40.7
59;2021-07-09;7688;20314;1387447;1073733;53.6;41.5
59;2021-07-10;7427;18546;1394874;1092279;53.9;42.2
59;2021-07-11;4447;10237;1399321;1102516;54.0;42.6
59;2021-07-12;5836;18054;1405157;1120570;54.3;43.3
59;2021-07-13;9865;20769;1415022;1141339;54.7;44.1
59;2021-07-14;9761;8458;1424783;1149797;55.0;44.4
59;2021-07-15;11595;20417;1436378;1170214;55.5;45.2
59;2021-07-16;13142;20507;1449520;1190721;56.0;46.0
59;2021-07-17;12346;17433;1461866;1208154;56.5;46.7
59;2021-07-18;7922;8682;1469788;1216836;56.8;47.0
59;2021-07-19;10344;16431;1480132;1233267;57.2;47.6
59;2021-07-20;13340;17111;1493472;1250378;57.7;48.3
59;2021-07-21;14473;15559;1507945;1265937;58.2;48.9
59;2021-07-22;16955;15170;1524900;1281107;58.9;49.5
59;2021-07-23;15670;15804;1540570;1296911;59.5;50.1
59;2021-07-24;16305;12237;1556875;1309148;60.1;50.6
59;2021-07-25;11893;7278;1568768;1316426;60.6;50.8
59;2021-07-26;12992;12569;1581760;1328995;61.1;51.3
59;2021-07-27;16074;11908;1597834;1340903;61.7;51.8
59;2021-07-28;17358;11592;1615192;1352495;62.4;52.2
59;2021-07-29;17308;11610;1632500;1364105;63.1;52.7
59;2021-07-30;15839;11526;1648339;1375631;63.7;53.1
59;2021-07-31;13873;9069;1662212;1384700;64.2;53.5
59;2021-08-01;9927;4468;1672139;1389168;64.6;53.7
59;2021-08-02;12059;9942;1684198;1399110;65.1;54.0
59;2021-08-03;13319;9957;1697517;1409067;65.6;54.4
59;2021-08-04;11087;8184;1708604;1417251;66.0;54.7
59;2021-08-05;12558;9673;1721162;1426924;66.5;55.1
60;2020-12-27;0;0;0;0;0.0;0.0
60;2020-12-28;0;0;0;0;0.0;0.0
60;2020-12-29;1;0;1;0;0.0;0.0
60;2020-12-30;0;0;1;0;0.0;0.0
60;2020-12-31;0;0;1;0;0.0;0.0
60;2021-01-01;0;0;1;0;0.0;0.0
60;2021-01-02;5;0;6;0;0.0;0.0
60;2021-01-03;1;0;7;0;0.0;0.0
60;2021-01-04;1;0;8;0;0.0;0.0
60;2021-01-05;37;0;45;0;0.0;0.0
60;2021-01-06;188;4;233;4;0.0;0.0
60;2021-01-07;236;4;469;8;0.1;0.0
60;2021-01-08;379;3;848;11;0.1;0.0
60;2021-01-09;3;0;851;11;0.1;0.0
60;2021-01-10;60;0;911;11;0.1;0.0
60;2021-01-11;342;2;1253;13;0.2;0.0
60;2021-01-12;534;2;1787;15;0.2;0.0
60;2021-01-13;476;5;2263;20;0.3;0.0
60;2021-01-14;507;5;2770;25;0.3;0.0
60;2021-01-15;700;7;3470;32;0.4;0.0
60;2021-01-16;124;1;3594;33;0.4;0.0
60;2021-01-17;31;0;3625;33;0.4;0.0
60;2021-01-18;859;5;4484;38;0.5;0.0
60;2021-01-19;1168;10;5652;48;0.7;0.0
60;2021-01-20;1687;10;7339;58;0.9;0.0
60;2021-01-21;2187;9;9526;67;1.2;0.0
60;2021-01-22;1523;13;11049;80;1.3;0.0
60;2021-01-23;499;4;11548;84;1.4;0.0
60;2021-01-24;61;1;11609;85;1.4;0.0
60;2021-01-25;893;13;12502;98;1.5;0.0
60;2021-01-26;950;13;13452;111;1.6;0.0
60;2021-01-27;640;8;14092;119;1.7;0.0
60;2021-01-28;395;168;14487;287;1.8;0.0
60;2021-01-29;77;106;14564;393;1.8;0.0
60;2021-01-30;0;1;14564;394;1.8;0.0
60;2021-01-31;22;61;14586;455;1.8;0.1
60;2021-02-01;38;108;14624;563;1.8;0.1
60;2021-02-02;26;161;14650;724;1.8;0.1
60;2021-02-03;161;237;14811;961;1.8;0.1
60;2021-02-04;169;340;14980;1301;1.8;0.2
60;2021-02-05;313;476;15293;1777;1.9;0.2
60;2021-02-06;63;79;15356;1856;1.9;0.2
60;2021-02-07;31;32;15387;1888;1.9;0.2
60;2021-02-08;326;517;15713;2405;1.9;0.3
60;2021-02-09;317;467;16030;2872;1.9;0.3
60;2021-02-10;552;993;16582;3865;2.0;0.5
60;2021-02-11;935;1127;17517;4992;2.1;0.6
60;2021-02-12;911;857;18428;5849;2.2;0.7
60;2021-02-13;90;309;18518;6158;2.2;0.7
60;2021-02-14;24;92;18542;6250;2.2;0.8
60;2021-02-15;613;808;19155;7058;2.3;0.9
60;2021-02-16;581;926;19736;7984;2.4;1.0
60;2021-02-17;631;930;20367;8914;2.5;1.1
60;2021-02-18;684;823;21051;9737;2.6;1.2
60;2021-02-19;641;768;21692;10505;2.6;1.3
60;2021-02-20;103;190;21795;10695;2.6;1.3
60;2021-02-21;22;121;21817;10816;2.6;1.3
60;2021-02-22;463;877;22280;11693;2.7;1.4
60;2021-02-23;533;786;22813;12479;2.8;1.5
60;2021-02-24;793;550;23606;13029;2.9;1.6
60;2021-02-25;1095;308;24701;13337;3.0;1.6
60;2021-02-26;1296;184;25997;13521;3.2;1.6
60;2021-02-27;666;35;26663;13556;3.2;1.6
60;2021-02-28;7;10;26670;13566;3.2;1.6
60;2021-03-01;893;48;27563;13614;3.3;1.7
60;2021-03-02;1013;162;28576;13776;3.5;1.7
60;2021-03-03;1318;445;29894;14221;3.6;1.7
60;2021-03-04;1722;516;31616;14737;3.8;1.8
60;2021-03-05;1820;286;33436;15023;4.1;1.8
60;2021-03-06;1919;131;35355;15154;4.3;1.8
60;2021-03-07;884;30;36239;15184;4.4;1.8
60;2021-03-08;977;314;37216;15498;4.5;1.9
60;2021-03-09;1641;356;38857;15854;4.7;1.9
60;2021-03-10;1937;424;40794;16278;4.9;2.0
60;2021-03-11;2324;382;43118;16660;5.2;2.0
60;2021-03-12;2591;540;45709;17200;5.5;2.1
60;2021-03-13;3835;201;49544;17401;6.0;2.1
60;2021-03-14;1779;54;51323;17455;6.2;2.1
60;2021-03-15;2091;497;53414;17952;6.5;2.2
60;2021-03-16;1583;621;54997;18573;6.7;2.3
60;2021-03-17;1657;612;56654;19185;6.9;2.3
60;2021-03-18;1759;725;58413;19910;7.1;2.4
60;2021-03-19;2590;525;61003;20435;7.4;2.5
60;2021-03-20;3235;186;64238;20621;7.8;2.5
60;2021-03-21;2124;96;66362;20717;8.0;2.5
60;2021-03-22;2134;709;68496;21426;8.3;2.6
60;2021-03-23;3307;719;71803;22145;8.7;2.7
60;2021-03-24;3070;872;74873;23017;9.1;2.8
60;2021-03-25;3848;838;78721;23855;9.5;2.9
60;2021-03-26;4215;868;82936;24723;10.1;3.0
60;2021-03-27;4141;305;87077;25028;10.6;3.0
60;2021-03-28;2448;75;89525;25103;10.9;3.0
60;2021-03-29;2608;1080;92133;26183;11.2;3.2
60;2021-03-30;3283;1065;95416;27248;11.6;3.3
60;2021-03-31;2668;1138;98084;28386;11.9;3.4
60;2021-04-01;2560;1099;100644;29485;12.2;3.6
60;2021-04-02;3309;1095;103953;30580;12.6;3.7
60;2021-04-03;3168;1008;107121;31588;13.0;3.8
60;2021-04-04;874;482;107995;32070;13.1;3.9
60;2021-04-05;458;81;108453;32151;13.1;3.9
60;2021-04-06;1964;1623;110417;33774;13.4;4.1
60;2021-04-07;1982;1745;112399;35519;13.6;4.3
60;2021-04-08;2611;1490;115010;37009;13.9;4.5
60;2021-04-09;2997;1515;118007;38524;14.3;4.7
60;2021-04-10;2928;1586;120935;40110;14.7;4.9
60;2021-04-11;1049;991;121984;41101;14.8;5.0
60;2021-04-12;2047;1719;124031;42820;15.0;5.2
60;2021-04-13;2746;1782;126777;44602;15.4;5.4
60;2021-04-14;3115;1809;129892;46411;15.7;5.6
60;2021-04-15;3543;1881;133435;48292;16.2;5.9
60;2021-04-16;3286;1944;136721;50236;16.6;6.1
60;2021-04-17;2847;2166;139568;52402;16.9;6.4
60;2021-04-18;572;1834;140140;54236;17.0;6.6
60;2021-04-19;1742;2210;141882;56446;17.2;6.8
60;2021-04-20;2129;2675;144011;59121;17.5;7.2
60;2021-04-21;2653;2204;146664;61325;17.8;7.4
60;2021-04-22;2630;2509;149294;63834;18.1;7.7
60;2021-04-23;2645;2496;151939;66330;18.4;8.0
60;2021-04-24;2471;3456;154410;69786;18.7;8.5
60;2021-04-25;1160;1963;155570;71749;18.9;8.7
60;2021-04-26;1889;2525;157459;74274;19.1;9.0
60;2021-04-27;2309;2844;159768;77118;19.4;9.3
60;2021-04-28;3063;2396;162831;79514;19.7;9.6
60;2021-04-29;3152;2625;165983;82139;20.1;10.0
60;2021-04-30;3459;2966;169442;85105;20.5;10.3
60;2021-05-01;2354;1122;171796;86227;20.8;10.5
60;2021-05-02;2147;837;173943;87064;21.1;10.6
60;2021-05-03;2954;1849;176897;88913;21.4;10.8
60;2021-05-04;3019;2353;179916;91266;21.8;11.1
60;2021-05-05;3256;2806;183172;94072;22.2;11.4
60;2021-05-06;3650;2476;186822;96548;22.6;11.7
60;2021-05-07;3986;2522;190808;99070;23.1;12.0
60;2021-05-08;3584;967;194392;100037;23.6;12.1
60;2021-05-09;3459;948;197851;100985;24.0;12.2
60;2021-05-10;2391;2292;200242;103277;24.3;12.5
60;2021-05-11;3665;2467;203907;105744;24.7;12.8
60;2021-05-12;4717;2549;208624;108293;25.3;13.1
60;2021-05-13;5293;1123;213917;109416;25.9;13.3
60;2021-05-14;5605;1809;219522;111225;26.6;13.5
60;2021-05-15;6172;1707;225694;112932;27.4;13.7
60;2021-05-16;4860;687;230554;113619;27.9;13.8
60;2021-05-17;3714;1672;234268;115291;28.4;14.0
60;2021-05-18;4048;2079;238316;117370;28.9;14.2
60;2021-05-19;5095;1852;243411;119222;29.5;14.4
60;2021-05-20;5458;1796;248869;121018;30.2;14.7
60;2021-05-21;5972;1968;254841;122986;30.9;14.9
60;2021-05-22;5355;1978;260196;124964;31.5;15.1
60;2021-05-23;4268;651;264464;125615;32.1;15.2
60;2021-05-24;2950;533;267414;126148;32.4;15.3
60;2021-05-25;4138;1999;271552;128147;32.9;15.5
60;2021-05-26;4466;1831;276018;129978;33.5;15.8
60;2021-05-27;4613;1994;280631;131972;34.0;16.0
60;2021-05-28;4620;2509;285251;134481;34.6;16.3
60;2021-05-29;4612;2272;289863;136753;35.1;16.6
60;2021-05-30;1086;351;290949;137104;35.3;16.6
60;2021-05-31;3830;2080;294779;139184;35.7;16.9
60;2021-06-01;4442;2850;299221;142034;36.3;17.2
60;2021-06-02;3909;2444;303130;144478;36.7;17.5
60;2021-06-03;3904;2377;307034;146855;37.2;17.8
60;2021-06-04;4652;2904;311686;149759;37.8;18.2
60;2021-06-05;4302;3417;315988;153176;38.3;18.6
60;2021-06-06;2156;794;318144;153970;38.6;18.7
60;2021-06-07;2777;2753;320921;156723;38.9;19.0
60;2021-06-08;3800;3009;324721;159732;39.4;19.4
60;2021-06-09;3245;3398;327966;163130;39.7;19.8
60;2021-06-10;3451;3366;331417;166496;40.2;20.2
60;2021-06-11;3879;4197;335296;170693;40.6;20.7
60;2021-06-12;3779;4275;339075;174968;41.1;21.2
60;2021-06-13;1156;2225;340231;177193;41.2;21.5
60;2021-06-14;1907;3306;342138;180499;41.5;21.9
60;2021-06-15;3014;4164;345152;184663;41.8;22.4
60;2021-06-16;3252;4492;348404;189155;42.2;22.9
60;2021-06-17;2977;4784;351381;193939;42.6;23.5
60;2021-06-18;2983;4599;354364;198538;42.9;24.1
60;2021-06-19;3142;4724;357506;203262;43.3;24.6
60;2021-06-20;1430;1935;358936;205197;43.5;24.9
60;2021-06-21;1408;4039;360344;209236;43.7;25.4
60;2021-06-22;1759;5292;362103;214528;43.9;26.0
60;2021-06-23;1860;5240;363963;219768;44.1;26.6
60;2021-06-24;1805;5603;365768;225371;44.3;27.3
60;2021-06-25;1900;5729;367668;231100;44.6;28.0
60;2021-06-26;1856;6983;369524;238083;44.8;28.9
60;2021-06-27;714;2594;370238;240677;44.9;29.2
60;2021-06-28;1780;4144;372018;244821;45.1;29.7
60;2021-06-29;2009;5465;374027;250286;45.3;30.3
60;2021-06-30;2285;5358;376312;255644;45.6;31.0
60;2021-07-01;1884;4922;378196;260566;45.8;31.6
60;2021-07-02;2359;5882;380555;266448;46.1;32.3
60;2021-07-03;2398;6168;382953;272616;46.4;33.0
60;2021-07-04;791;2725;383744;275341;46.5;33.4
60;2021-07-05;1650;4399;385394;279740;46.7;33.9
60;2021-07-06;2137;4498;387531;284238;47.0;34.4
60;2021-07-07;2171;5124;389702;289362;47.2;35.1
60;2021-07-08;2667;4693;392369;294055;47.6;35.6
60;2021-07-09;2635;5561;395004;299616;47.9;36.3
60;2021-07-10;2574;5873;397578;305489;48.2;37.0
60;2021-07-11;1212;1944;398790;307433;48.3;37.3
60;2021-07-12;1425;4757;400215;312190;48.5;37.8
60;2021-07-13;2906;5029;403121;317219;48.9;38.4
60;2021-07-14;2574;1404;405695;318623;49.2;38.6
60;2021-07-15;3422;4871;409117;323494;49.6;39.2
60;2021-07-16;3670;5242;412787;328736;50.0;39.8
60;2021-07-17;4064;5135;416851;333871;50.5;40.5
60;2021-07-18;2178;2120;419029;335991;50.8;40.7
60;2021-07-19;2531;3897;421560;339888;51.1;41.2
60;2021-07-20;4170;4900;425730;344788;51.6;41.8
60;2021-07-21;4312;4268;430042;349056;52.1;42.3
60;2021-07-22;4616;4324;434658;353380;52.7;42.8
60;2021-07-23;4961;4884;439619;358264;53.3;43.4
60;2021-07-24;4287;4659;443906;362923;53.8;44.0
60;2021-07-25;2596;1816;446502;364739;54.1;44.2
60;2021-07-26;3358;3752;449860;368491;54.5;44.7
60;2021-07-27;4411;4621;454271;373112;55.1;45.2
60;2021-07-28;4523;3757;458794;376869;55.6;45.7
60;2021-07-29;4888;3693;463682;380562;56.2;46.1
60;2021-07-30;4993;4230;468675;384792;56.8;46.6
60;2021-07-31;4045;3937;472720;388729;57.3;47.1
60;2021-08-01;1674;852;474394;389581;57.5;47.2
60;2021-08-02;3160;2729;477554;392310;57.9;47.5
60;2021-08-03;3571;2872;481125;395182;58.3;47.9
60;2021-08-04;3286;2770;484411;397952;58.7;48.2
60;2021-08-05;2991;2234;487402;400186;59.1;48.5
61;2020-12-27;0;0;0;0;0.0;0.0
61;2020-12-28;0;0;0;0;0.0;0.0
61;2020-12-29;0;0;0;0;0.0;0.0
61;2020-12-30;0;0;0;0;0.0;0.0
61;2020-12-31;0;0;0;0;0.0;0.0
61;2021-01-01;1;0;1;0;0.0;0.0
61;2021-01-02;1;0;2;0;0.0;0.0
61;2021-01-03;0;0;2;0;0.0;0.0
61;2021-01-04;1;0;3;0;0.0;0.0
61;2021-01-05;3;0;6;0;0.0;0.0
61;2021-01-06;76;0;82;0;0.0;0.0
61;2021-01-07;175;2;257;2;0.1;0.0
61;2021-01-08;406;1;663;3;0.2;0.0
61;2021-01-09;165;1;828;4;0.3;0.0
61;2021-01-10;49;0;877;4;0.3;0.0
61;2021-01-11;396;1;1273;5;0.5;0.0
61;2021-01-12;680;2;1953;7;0.7;0.0
61;2021-01-13;739;1;2692;8;1.0;0.0
61;2021-01-14;528;8;3220;16;1.2;0.0
61;2021-01-15;538;4;3758;20;1.4;0.0
61;2021-01-16;289;1;4047;21;1.5;0.0
61;2021-01-17;833;7;4880;28;1.8;0.0
61;2021-01-18;1913;3;6793;31;2.5;0.0
61;2021-01-19;1321;4;8114;35;2.9;0.0
61;2021-01-20;683;0;8797;35;3.2;0.0
61;2021-01-21;844;1;9641;36;3.5;0.0
61;2021-01-22;764;1;10405;37;3.8;0.0
61;2021-01-23;256;2;10661;39;3.9;0.0
61;2021-01-24;228;0;10889;39;3.9;0.0
61;2021-01-25;578;2;11467;41;4.1;0.0
61;2021-01-26;555;0;12022;41;4.3;0.0
61;2021-01-27;569;14;12591;55;4.5;0.0
61;2021-01-28;463;53;13054;108;4.7;0.0
61;2021-01-29;478;204;13532;312;4.9;0.1
61;2021-01-30;212;3;13744;315;5.0;0.1
61;2021-01-31;106;0;13850;315;5.0;0.1
61;2021-02-01;430;190;14280;505;5.2;0.2
61;2021-02-02;387;425;14667;930;5.3;0.3
61;2021-02-03;412;490;15079;1420;5.4;0.5
61;2021-02-04;388;338;15467;1758;5.6;0.6
61;2021-02-05;538;362;16005;2120;5.8;0.8
61;2021-02-06;196;91;16201;2211;5.9;0.8
61;2021-02-07;45;200;16246;2411;5.9;0.9
61;2021-02-08;539;1409;16785;3820;6.1;1.4
61;2021-02-09;405;808;17190;4628;6.2;1.7
61;2021-02-10;277;560;17467;5188;6.3;1.9
61;2021-02-11;432;563;17899;5751;6.5;2.1
61;2021-02-12;402;737;18301;6488;6.6;2.3
61;2021-02-13;132;431;18433;6919;6.7;2.5
61;2021-02-14;2;315;18435;7234;6.7;2.6
61;2021-02-15;171;847;18606;8081;6.7;2.9
61;2021-02-16;203;682;18809;8763;6.8;3.2
61;2021-02-17;44;639;18853;9402;6.8;3.4
61;2021-02-18;161;527;19014;9929;6.9;3.6
61;2021-02-19;101;391;19115;10320;6.9;3.7
61;2021-02-20;40;240;19155;10560;6.9;3.8
61;2021-02-21;1;155;19156;10715;6.9;3.9
61;2021-02-22;88;567;19244;11282;6.9;4.1
61;2021-02-23;114;495;19358;11777;7.0;4.3
61;2021-02-24;173;572;19531;12349;7.1;4.5
61;2021-02-25;265;447;19796;12796;7.1;4.6
61;2021-02-26;266;464;20062;13260;7.2;4.8
61;2021-02-27;108;225;20170;13485;7.3;4.9
61;2021-02-28;4;119;20174;13604;7.3;4.9
61;2021-03-01;216;610;20390;14214;7.4;5.1
61;2021-03-02;148;698;20538;14912;7.4;5.4
61;2021-03-03;142;448;20680;15360;7.5;5.5
61;2021-03-04;431;445;21111;15805;7.6;5.7
61;2021-03-05;701;295;21812;16100;7.9;5.8
61;2021-03-06;435;230;22247;16330;8.0;5.9
61;2021-03-07;154;2;22401;16332;8.1;5.9
61;2021-03-08;299;314;22700;16646;8.2;6.0
61;2021-03-09;622;185;23322;16831;8.4;6.1
61;2021-03-10;672;180;23994;17011;8.7;6.1
61;2021-03-11;1119;128;25113;17139;9.1;6.2
61;2021-03-12;1465;97;26578;17236;9.6;6.2
61;2021-03-13;771;52;27349;17288;9.9;6.2
61;2021-03-14;226;3;27575;17291;10.0;6.2
61;2021-03-15;814;32;28389;17323;10.3;6.3
61;2021-03-16;720;22;29109;17345;10.5;6.3
61;2021-03-17;760;11;29869;17356;10.8;6.3
61;2021-03-18;856;23;30725;17379;11.1;6.3
61;2021-03-19;1025;45;31750;17424;11.5;6.3
61;2021-03-20;470;14;32220;17438;11.6;6.3
61;2021-03-21;71;2;32291;17440;11.7;6.3
61;2021-03-22;796;86;33087;17526;11.9;6.3
61;2021-03-23;920;39;34007;17565;12.3;6.3
61;2021-03-24;1372;65;35379;17630;12.8;6.4
61;2021-03-25;1875;56;37254;17686;13.5;6.4
61;2021-03-26;1794;39;39048;17725;14.1;6.4
61;2021-03-27;1083;17;40131;17742;14.5;6.4
61;2021-03-28;359;9;40490;17751;14.6;6.4
61;2021-03-29;1271;179;41761;17930;15.1;6.5
61;2021-03-30;1471;92;43232;18022;15.6;6.5
61;2021-03-31;1685;46;44917;18068;16.2;6.5
61;2021-04-01;2048;222;46965;18290;17.0;6.6
61;2021-04-02;1516;423;48481;18713;17.5;6.8
61;2021-04-03;638;288;49119;19001;17.7;6.9
61;2021-04-04;193;1;49312;19002;17.8;6.9
61;2021-04-05;532;7;49844;19009;18.0;6.9
61;2021-04-06;1354;619;51198;19628;18.5;7.1
61;2021-04-07;1696;662;52894;20290;19.1;7.3
61;2021-04-08;2268;819;55162;21109;19.9;7.6
61;2021-04-09;2134;832;57296;21941;20.7;7.9
61;2021-04-10;1534;484;58830;22425;21.2;8.1
61;2021-04-11;238;197;59068;22622;21.3;8.2
61;2021-04-12;1289;735;60357;23357;21.8;8.4
61;2021-04-13;1741;703;62098;24060;22.4;8.7
61;2021-04-14;1730;782;63828;24842;23.1;9.0
61;2021-04-15;2266;777;66094;25619;23.9;9.3
61;2021-04-16;2224;682;68318;26301;24.7;9.5
61;2021-04-17;1486;319;69804;26620;25.2;9.6
61;2021-04-18;538;99;70342;26719;25.4;9.6
61;2021-04-19;938;745;71280;27464;25.7;9.9
61;2021-04-20;1525;783;72805;28247;26.3;10.2
61;2021-04-21;1351;1037;74156;29284;26.8;10.6
61;2021-04-22;1293;1214;75449;30498;27.2;11.0
61;2021-04-23;1218;1149;76667;31647;27.7;11.4
61;2021-04-24;1437;816;78104;32463;28.2;11.7
61;2021-04-25;361;330;78465;32793;28.3;11.8
61;2021-04-26;669;1141;79134;33934;28.6;12.3
61;2021-04-27;1464;1140;80598;35074;29.1;12.7
61;2021-04-28;1387;1386;81985;36460;29.6;13.2
61;2021-04-29;1252;1858;83237;38318;30.1;13.8
61;2021-04-30;1720;1170;84957;39488;30.7;14.3
61;2021-05-01;788;320;85745;39808;31.0;14.4
61;2021-05-02;438;223;86183;40031;31.1;14.5
61;2021-05-03;842;1247;87025;41278;31.4;14.9
61;2021-05-04;1326;1751;88351;43029;31.9;15.5
61;2021-05-05;1012;2026;89363;45055;32.3;16.3
61;2021-05-06;1771;2210;91134;47265;32.9;17.1
61;2021-05-07;1379;1965;92513;49230;33.4;17.8
61;2021-05-08;925;471;93438;49701;33.7;17.9
61;2021-05-09;393;291;93831;49992;33.9;18.1
61;2021-05-10;987;1752;94818;51744;34.2;18.7
61;2021-05-11;1374;1512;96192;53256;34.7;19.2
61;2021-05-12;1869;1588;98061;54844;35.4;19.8
61;2021-05-13;889;490;98950;55334;35.7;20.0
61;2021-05-14;1851;1193;100801;56527;36.4;20.4
61;2021-05-15;2093;1115;102894;57642;37.2;20.8
61;2021-05-16;983;300;103877;57942;37.5;20.9
61;2021-05-17;1311;913;105188;58855;38.0;21.3
61;2021-05-18;2423;891;107611;59746;38.9;21.6
61;2021-05-19;2402;799;110013;60545;39.7;21.9
61;2021-05-20;2214;810;112227;61355;40.5;22.2
61;2021-05-21;2148;856;114375;62211;41.3;22.5
61;2021-05-22;1778;717;116153;62928;41.9;22.7
61;2021-05-23;714;53;116867;62981;42.2;22.7
61;2021-05-24;913;110;117780;63091;42.5;22.8
61;2021-05-25;1992;921;119772;64012;43.3;23.1
61;2021-05-26;2035;927;121807;64939;44.0;23.5
61;2021-05-27;2037;1095;123844;66034;44.7;23.8
61;2021-05-28;2052;1377;125896;67411;45.5;24.3
61;2021-05-29;1462;554;127358;67965;46.0;24.5
61;2021-05-30;450;44;127808;68009;46.2;24.6
61;2021-05-31;1560;937;129368;68946;46.7;24.9
61;2021-06-01;1873;1387;131241;70333;47.4;25.4
61;2021-06-02;1674;1135;132915;71468;48.0;25.8
61;2021-06-03;2248;1109;135163;72577;48.8;26.2
61;2021-06-04;1895;1340;137058;73917;49.5;26.7
61;2021-06-05;1667;1238;138725;75155;50.1;27.1
61;2021-06-06;318;229;139043;75384;50.2;27.2
61;2021-06-07;2188;867;141231;76251;51.0;27.5
61;2021-06-08;1844;1567;143075;77818;51.7;28.1
61;2021-06-09;1974;1184;145049;79002;52.4;28.5
61;2021-06-10;1972;1186;147021;80188;53.1;29.0
61;2021-06-11;1820;1576;148841;81764;53.8;29.5
61;2021-06-12;1423;998;150264;82762;54.3;29.9
61;2021-06-13;340;377;150604;83139;54.4;30.0
61;2021-06-14;1106;1188;151710;84327;54.8;30.5
61;2021-06-15;1211;1694;152921;86021;55.2;31.1
61;2021-06-16;1110;1359;154031;87380;55.6;31.6
61;2021-06-17;1018;1728;155049;89108;56.0;32.2
61;2021-06-18;1520;1668;156569;90776;56.5;32.8
61;2021-06-19;1243;1302;157812;92078;57.0;33.3
61;2021-06-20;289;345;158101;92423;57.1;33.4
61;2021-06-21;809;1628;158910;94051;57.4;34.0
61;2021-06-22;1023;1683;159933;95734;57.8;34.6
61;2021-06-23;972;2438;160905;98172;58.1;35.5
61;2021-06-24;649;1360;161554;99532;58.3;35.9
61;2021-06-25;836;2168;162390;101700;58.6;36.7
61;2021-06-26;624;1953;163014;103653;58.9;37.4
61;2021-06-27;139;800;163153;104453;58.9;37.7
61;2021-06-28;478;2248;163631;106701;59.1;38.5
61;2021-06-29;699;2859;164330;109560;59.3;39.6
61;2021-06-30;767;2462;165097;112022;59.6;40.5
61;2021-07-01;632;1692;165729;113714;59.9;41.1
61;2021-07-02;836;2499;166565;116213;60.2;42.0
61;2021-07-03;415;1910;166980;118123;60.3;42.7
61;2021-07-04;74;638;167054;118761;60.3;42.9
61;2021-07-05;686;1776;167740;120537;60.6;43.5
61;2021-07-06;988;2794;168728;123331;60.9;44.5
61;2021-07-07;731;2360;169459;125691;61.2;45.4
61;2021-07-08;839;1951;170298;127642;61.5;46.1
61;2021-07-09;721;2379;171019;130021;61.8;47.0
61;2021-07-10;463;1773;171482;131794;61.9;47.6
61;2021-07-11;241;489;171723;132283;62.0;47.8
61;2021-07-12;434;2295;172157;134578;62.2;48.6
61;2021-07-13;640;2492;172797;137070;62.4;49.5
61;2021-07-14;147;333;172944;137403;62.5;49.6
61;2021-07-15;806;2816;173750;140219;62.7;50.6
61;2021-07-16;956;2574;174706;142793;63.1;51.6
61;2021-07-17;700;2232;175406;145025;63.3;52.4
61;2021-07-18;335;367;175741;145392;63.5;52.5
61;2021-07-19;930;2404;176671;147796;63.8;53.4
61;2021-07-20;1315;2355;177986;150151;64.3;54.2
61;2021-07-21;1495;2179;179481;152330;64.8;55.0
61;2021-07-22;1739;2187;181220;154517;65.4;55.8
61;2021-07-23;1780;2298;183000;156815;66.1;56.6
61;2021-07-24;1444;2000;184444;158815;66.6;57.4
61;2021-07-25;323;394;184767;159209;66.7;57.5
61;2021-07-26;1243;1934;186010;161143;67.2;58.2
61;2021-07-27;2397;1580;188407;162723;68.0;58.8
61;2021-07-28;2436;1339;190843;164062;68.9;59.2
61;2021-07-29;2539;1567;193382;165629;69.8;59.8
61;2021-07-30;2383;1384;195765;167013;70.7;60.3
61;2021-07-31;1278;1293;197043;168306;71.2;60.8
61;2021-08-01;495;254;197538;168560;71.3;60.9
61;2021-08-02;1897;1112;199435;169672;72.0;61.3
61;2021-08-03;2444;903;201879;170575;72.9;61.6
61;2021-08-04;2336;776;204215;171351;73.7;61.9
61;2021-08-05;1891;982;206106;172333;74.4;62.2
62;2020-12-27;2;0;2;0;0.0;0.0
62;2020-12-28;2;0;4;0;0.0;0.0
62;2020-12-29;0;0;4;0;0.0;0.0
62;2020-12-30;0;0;4;0;0.0;0.0
62;2020-12-31;0;0;4;0;0.0;0.0
62;2021-01-01;0;0;4;0;0.0;0.0
62;2021-01-02;0;0;4;0;0.0;0.0
62;2021-01-03;0;0;4;0;0.0;0.0
62;2021-01-04;2;0;6;0;0.0;0.0
62;2021-01-05;47;0;53;0;0.0;0.0
62;2021-01-06;123;0;176;0;0.0;0.0
62;2021-01-07;351;0;527;0;0.0;0.0
62;2021-01-08;712;6;1239;6;0.1;0.0
62;2021-01-09;163;1;1402;7;0.1;0.0
62;2021-01-10;84;0;1486;7;0.1;0.0
62;2021-01-11;554;1;2040;8;0.1;0.0
62;2021-01-12;1247;1;3287;9;0.2;0.0
62;2021-01-13;1137;5;4424;14;0.3;0.0
62;2021-01-14;1386;8;5810;22;0.4;0.0
62;2021-01-15;1296;8;7106;30;0.5;0.0
62;2021-01-16;307;3;7413;33;0.5;0.0
62;2021-01-17;107;1;7520;34;0.5;0.0
62;2021-01-18;1663;9;9183;43;0.6;0.0
62;2021-01-19;2098;5;11281;48;0.8;0.0
62;2021-01-20;2054;6;13335;54;0.9;0.0
62;2021-01-21;2226;5;15561;59;1.1;0.0
62;2021-01-22;1832;7;17393;66;1.2;0.0
62;2021-01-23;512;0;17905;66;1.2;0.0
62;2021-01-24;0;0;17905;66;1.2;0.0
62;2021-01-25;1280;6;19185;72;1.3;0.0
62;2021-01-26;1540;15;20725;87;1.4;0.0
62;2021-01-27;1488;175;22213;262;1.5;0.0
62;2021-01-28;4148;345;26361;607;1.8;0.0
62;2021-01-29;2024;335;28385;942;2.0;0.1
62;2021-01-30;159;154;28544;1096;2.0;0.1
62;2021-01-31;22;3;28566;1099;2.0;0.1
62;2021-02-01;46;359;28612;1458;2.0;0.1
62;2021-02-02;59;789;28671;2247;2.0;0.2
62;2021-02-03;44;630;28715;2877;2.0;0.2
62;2021-02-04;81;822;28796;3699;2.0;0.3
62;2021-02-05;79;753;28875;4452;2.0;0.3
62;2021-02-06;26;195;28901;4647;2.0;0.3
62;2021-02-07;237;27;29138;4674;2.0;0.3
62;2021-02-08;131;845;29269;5519;2.0;0.4
62;2021-02-09;226;1099;29495;6618;2.0;0.5
62;2021-02-10;383;1174;29878;7792;2.1;0.5
62;2021-02-11;722;1004;30600;8796;2.1;0.6
62;2021-02-12;966;782;31566;9578;2.2;0.7
62;2021-02-13;159;270;31725;9848;2.2;0.7
62;2021-02-14;0;0;31725;9848;2.2;0.7
62;2021-02-15;664;1276;32389;11124;2.2;0.8
62;2021-02-16;920;1788;33309;12912;2.3;0.9
62;2021-02-17;1074;2130;34383;15042;2.4;1.0
62;2021-02-18;2210;3801;36593;18843;2.5;1.3
62;2021-02-19;2304;2547;38897;21390;2.7;1.5
62;2021-02-20;613;479;39510;21869;2.7;1.5
62;2021-02-21;86;49;39596;21918;2.7;1.5
62;2021-02-22;847;971;40443;22889;2.8;1.6
62;2021-02-23;1419;1219;41862;24108;2.9;1.7
62;2021-02-24;1544;643;43406;24751;3.0;1.7
62;2021-02-25;3166;414;46572;25165;3.2;1.7
62;2021-02-26;2907;336;49479;25501;3.4;1.8
62;2021-02-27;1829;92;51308;25593;3.5;1.8
62;2021-02-28;52;42;51360;25635;3.5;1.8
62;2021-03-01;1319;117;52679;25752;3.6;1.8
62;2021-03-02;3152;171;55831;25923;3.8;1.8
62;2021-03-03;3264;119;59095;26042;4.1;1.8
62;2021-03-04;3806;202;62901;26244;4.3;1.8
62;2021-03-05;4644;210;67545;26454;4.6;1.8
62;2021-03-06;9614;231;77159;26685;5.3;1.8
62;2021-03-07;8073;199;85232;26884;5.9;1.9
62;2021-03-08;2193;252;87425;27136;6.0;1.9
62;2021-03-09;3801;370;91226;27506;6.3;1.9
62;2021-03-10;4228;601;95454;28107;6.6;1.9
62;2021-03-11;5990;1522;101444;29629;7.0;2.0
62;2021-03-12;6632;1403;108076;31032;7.4;2.1
62;2021-03-13;14715;773;122791;31805;8.5;2.2
62;2021-03-14;9579;361;132370;32166;9.1;2.2
62;2021-03-15;3763;1015;136133;33181;9.4;2.3
62;2021-03-16;2734;848;138867;34029;9.6;2.3
62;2021-03-17;2804;721;141671;34750;9.8;2.4
62;2021-03-18;2724;929;144395;35679;9.9;2.5
62;2021-03-19;4780;912;149175;36591;10.3;2.5
62;2021-03-20;11061;578;160236;37169;11.0;2.6
62;2021-03-21;9442;333;169678;37502;11.7;2.6
62;2021-03-22;2938;1104;172616;38606;11.9;2.7
62;2021-03-23;4993;1497;177609;40103;12.2;2.8
62;2021-03-24;4692;1413;182301;41516;12.5;2.9
62;2021-03-25;6553;1474;188854;42990;13.0;3.0
62;2021-03-26;7050;1483;195904;44473;13.5;3.1
62;2021-03-27;12589;716;208493;45189;14.4;3.1
62;2021-03-28;6938;263;215431;45452;14.8;3.1
62;2021-03-29;3473;1201;218904;46653;15.1;3.2
62;2021-03-30;4549;2204;223453;48857;15.4;3.4
62;2021-03-31;4222;2460;227675;51317;15.7;3.5
62;2021-04-01;4969;2762;232644;54079;16.0;3.7
62;2021-04-02;5067;3228;237711;57307;16.4;3.9
62;2021-04-03;8206;3331;245917;60638;16.9;4.2
62;2021-04-04;4577;1917;250494;62555;17.2;4.3
62;2021-04-05;943;463;251437;63018;17.3;4.3
62;2021-04-06;4123;3000;255560;66018;17.6;4.5
62;2021-04-07;5029;3500;260589;69518;17.9;4.8
62;2021-04-08;6483;3971;267072;73489;18.4;5.1
62;2021-04-09;7621;3466;274693;76955;18.9;5.3
62;2021-04-10;6635;8062;281328;85017;19.4;5.9
62;2021-04-11;2810;6898;284138;91915;19.6;6.3
62;2021-04-12;3419;2369;287557;94284;19.8;6.5
62;2021-04-13;6169;3149;293726;97433;20.2;6.7
62;2021-04-14;5301;3057;299027;100490;20.6;6.9
62;2021-04-15;5737;2978;304764;103468;21.0;7.1
62;2021-04-16;5418;3186;310182;106654;21.4;7.3
62;2021-04-17;4362;7357;314544;114011;21.7;7.8
62;2021-04-18;1961;6849;316505;120860;21.8;8.3
62;2021-04-19;2778;1928;319283;122788;22.0;8.5
62;2021-04-20;4147;3885;323430;126673;22.3;8.7
62;2021-04-21;3751;3980;327181;130653;22.5;9.0
62;2021-04-22;3946;5184;331127;135837;22.8;9.4
62;2021-04-23;4053;5300;335180;141137;23.1;9.7
62;2021-04-24;4406;6722;339586;147859;23.4;10.2
62;2021-04-25;1908;3501;341494;151360;23.5;10.4
62;2021-04-26;2223;2429;343717;153789;23.7;10.6
62;2021-04-27;4409;3698;348126;157487;24.0;10.8
62;2021-04-28;4587;4348;352713;161835;24.3;11.1
62;2021-04-29;4786;5872;357499;167707;24.6;11.5
62;2021-04-30;5212;5706;362711;173413;25.0;11.9
62;2021-05-01;5729;3463;368440;176876;25.4;12.2
62;2021-05-02;7820;3132;376260;180008;25.9;12.4
62;2021-05-03;4501;2332;380761;182340;26.2;12.6
62;2021-05-04;5393;4981;386154;187321;26.6;12.9
62;2021-05-05;4729;4839;390883;192160;26.9;13.2
62;2021-05-06;5621;4931;396504;197091;27.3;13.6
62;2021-05-07;7681;4677;404185;201768;27.8;13.9
62;2021-05-08;10643;2300;414828;204068;28.6;14.0
62;2021-05-09;8626;1633;423454;205701;29.1;14.2
62;2021-05-10;4870;4013;428324;209714;29.5;14.4
62;2021-05-11;6409;5028;434733;214742;29.9;14.8
62;2021-05-12;8621;4603;443354;219345;30.5;15.1
62;2021-05-13;9996;1477;453350;220822;31.2;15.2
62;2021-05-14;11876;3389;465226;224211;32.0;15.4
62;2021-05-15;19781;3260;485007;227471;33.4;15.7
62;2021-05-16;16394;1399;501401;228870;34.5;15.8
62;2021-05-17;8181;2658;509582;231528;35.1;15.9
62;2021-05-18;9327;3122;518909;234650;35.7;16.2
62;2021-05-19;8615;2914;527524;237564;36.3;16.4
62;2021-05-20;8340;3844;535864;241408;36.9;16.6
62;2021-05-21;9398;4214;545262;245622;37.5;16.9
62;2021-05-22;17871;3518;563133;249140;38.8;17.1
62;2021-05-23;12377;1138;575510;250278;39.6;17.2
62;2021-05-24;3910;586;579420;250864;39.9;17.3
62;2021-05-25;7220;4084;586640;254948;40.4;17.5
62;2021-05-26;6774;4907;593414;259855;40.8;17.9
62;2021-05-27;6383;5686;599797;265541;41.3;18.3
62;2021-05-28;6520;6765;606317;272306;41.7;18.7
62;2021-05-29;10851;5539;617168;277845;42.5;19.1
62;2021-05-30;4037;982;621205;278827;42.8;19.2
62;2021-05-31;4794;3972;625999;282799;43.1;19.5
62;2021-06-01;6520;6526;632519;289325;43.5;19.9
62;2021-06-02;7427;5805;639946;295130;44.0;20.3
62;2021-06-03;7855;5888;647801;301018;44.6;20.7
62;2021-06-04;7904;6248;655705;307266;45.1;21.2
62;2021-06-05;8274;6231;663979;313497;45.7;21.6
62;2021-06-06;3126;1289;667105;314786;45.9;21.7
62;2021-06-07;4619;3760;671724;318546;46.2;21.9
62;2021-06-08;6207;5892;677931;324438;46.7;22.3
62;2021-06-09;5491;4761;683422;329199;47.0;22.7
62;2021-06-10;5206;5881;688628;335080;47.4;23.1
62;2021-06-11;6212;8875;694840;343955;47.8;23.7
62;2021-06-12;5934;8646;700774;352601;48.2;24.3
62;2021-06-13;3228;3791;704002;356392;48.5;24.5
62;2021-06-14;2606;6774;706608;363166;48.6;25.0
62;2021-06-15;4672;8540;711280;371706;49.0;25.6
62;2021-06-16;5078;7423;716358;379129;49.3;26.1
62;2021-06-17;5231;8039;721589;387168;49.7;26.7
62;2021-06-18;4812;10483;726401;397651;50.0;27.4
62;2021-06-19;5797;13440;732198;411091;50.4;28.3
62;2021-06-20;2100;4371;734298;415462;50.5;28.6
62;2021-06-21;2968;8930;737266;424392;50.7;29.2
62;2021-06-22;3427;10168;740693;434560;51.0;29.9
62;2021-06-23;3384;10319;744077;444879;51.2;30.6
62;2021-06-24;3334;11781;747411;456660;51.4;31.4
62;2021-06-25;3698;15770;751109;472430;51.7;32.5
62;2021-06-26;3543;18427;754652;490857;51.9;33.8
62;2021-06-27;1119;9820;755771;500677;52.0;34.5
62;2021-06-28;1916;8871;757687;509548;52.2;35.1
62;2021-06-29;2962;11456;760649;521004;52.4;35.9
62;2021-06-30;4139;10805;764788;531809;52.6;36.6
62;2021-07-01;4459;10473;769247;542282;53.0;37.3
62;2021-07-02;4138;11974;773385;554256;53.2;38.2
62;2021-07-03;2988;18058;776373;572314;53.4;39.4
62;2021-07-04;1441;9188;777814;581502;53.5;40.0
62;2021-07-05;2407;6927;780221;588429;53.7;40.5
62;2021-07-06;3810;10019;784031;598448;54.0;41.2
62;2021-07-07;3909;8917;787940;607365;54.2;41.8
62;2021-07-08;5239;9105;793179;616470;54.6;42.4
62;2021-07-09;4399;10861;797578;627331;54.9;43.2
62;2021-07-10;4925;11886;802503;639217;55.2;44.0
62;2021-07-11;1331;2087;803834;641304;55.3;44.1
62;2021-07-12;2309;7144;806143;648448;55.5;44.6
62;2021-07-13;5075;12163;811218;660611;55.8;45.5
62;2021-07-14;3616;3158;814834;663769;56.1;45.7
62;2021-07-15;7531;11518;822365;675287;56.6;46.5
62;2021-07-16;7562;11056;829927;686343;57.1;47.2
62;2021-07-17;9615;10274;839542;696617;57.8;48.0
62;2021-07-18;2696;3460;842238;700077;58.0;48.2
62;2021-07-19;5970;7017;848208;707094;58.4;48.7
62;2021-07-20;7888;10716;856096;717810;58.9;49.4
62;2021-07-21;9683;9397;865779;727207;59.6;50.1
62;2021-07-22;9707;8993;875486;736200;60.3;50.7
62;2021-07-23;10572;8401;886058;744601;61.0;51.3
62;2021-07-24;9615;10277;895673;754878;61.7;52.0
62;2021-07-25;5520;1847;901193;756725;62.0;52.1
62;2021-07-26;6199;5376;907392;762101;62.5;52.5
62;2021-07-27;9703;8117;917095;770218;63.1;53.0
62;2021-07-28;10282;7467;927377;777685;63.8;53.5
62;2021-07-29;11828;7603;939205;785288;64.6;54.1
62;2021-07-30;9002;6262;948207;791550;65.3;54.5
62;2021-07-31;6591;3996;954798;795546;65.7;54.8
62;2021-08-01;2328;1089;957126;796635;65.9;54.8
62;2021-08-02;6797;4711;963923;801346;66.4;55.2
62;2021-08-03;8553;7426;972476;808772;66.9;55.7
62;2021-08-04;9394;5391;981870;814163;67.6;56.0
62;2021-08-05;8243;5553;990113;819716;68.2;56.4
63;2020-12-27;0;0;0;0;0.0;0.0
63;2020-12-28;1;0;1;0;0.0;0.0
63;2020-12-29;0;0;1;0;0.0;0.0
63;2020-12-30;0;0;1;0;0.0;0.0
63;2020-12-31;0;0;1;0;0.0;0.0
63;2021-01-01;1;0;2;0;0.0;0.0
63;2021-01-02;0;0;2;0;0.0;0.0
63;2021-01-03;1;0;3;0;0.0;0.0
63;2021-01-04;0;0;3;0;0.0;0.0
63;2021-01-05;1;0;4;0;0.0;0.0
63;2021-01-06;4;1;8;1;0.0;0.0
63;2021-01-07;310;0;318;1;0.0;0.0
63;2021-01-08;212;0;530;1;0.1;0.0
63;2021-01-09;91;0;621;1;0.1;0.0
63;2021-01-10;81;0;702;1;0.1;0.0
63;2021-01-11;423;0;1125;1;0.2;0.0
63;2021-01-12;644;1;1769;2;0.3;0.0
63;2021-01-13;848;3;2617;5;0.4;0.0
63;2021-01-14;523;8;3140;13;0.5;0.0
63;2021-01-15;430;2;3570;15;0.5;0.0
63;2021-01-16;157;0;3727;15;0.6;0.0
63;2021-01-17;133;0;3860;15;0.6;0.0
63;2021-01-18;605;2;4465;17;0.7;0.0
63;2021-01-19;862;1;5327;18;0.8;0.0
63;2021-01-20;1044;1;6371;19;1.0;0.0
63;2021-01-21;1004;3;7375;22;1.1;0.0
63;2021-01-22;968;3;8343;25;1.3;0.0
63;2021-01-23;191;0;8534;25;1.3;0.0
63;2021-01-24;163;1;8697;26;1.3;0.0
63;2021-01-25;803;1;9500;27;1.4;0.0
63;2021-01-26;961;2;10461;29;1.6;0.0
63;2021-01-27;999;5;11460;34;1.7;0.0
63;2021-01-28;1314;67;12774;101;1.9;0.0
63;2021-01-29;1065;66;13839;167;2.1;0.0
63;2021-01-30;68;0;13907;167;2.1;0.0
63;2021-01-31;6;0;13913;167;2.1;0.0
63;2021-02-01;566;182;14479;349;2.2;0.1
63;2021-02-02;885;234;15364;583;2.3;0.1
63;2021-02-03;1469;282;16833;865;2.5;0.1
63;2021-02-04;2118;513;18951;1378;2.9;0.2
63;2021-02-05;1145;272;20096;1650;3.0;0.2
63;2021-02-06;117;0;20213;1650;3.1;0.2
63;2021-02-07;9;1;20222;1651;3.1;0.3
63;2021-02-08;538;408;20760;2059;3.1;0.3
63;2021-02-09;671;436;21431;2495;3.2;0.4
63;2021-02-10;606;601;22037;3096;3.3;0.5
63;2021-02-11;752;467;22789;3563;3.5;0.5
63;2021-02-12;823;810;23612;4373;3.6;0.7
63;2021-02-13;82;1;23694;4374;3.6;0.7
63;2021-02-14;0;65;23694;4439;3.6;0.7
63;2021-02-15;203;791;23897;5230;3.6;0.8
63;2021-02-16;411;1138;24308;6368;3.7;1.0
63;2021-02-17;348;877;24656;7245;3.7;1.1
63;2021-02-18;607;826;25263;8071;3.8;1.2
63;2021-02-19;447;975;25710;9046;3.9;1.4
63;2021-02-20;36;32;25746;9078;3.9;1.4
63;2021-02-21;2;17;25748;9095;3.9;1.4
63;2021-02-22;293;933;26041;10028;3.9;1.5
63;2021-02-23;578;1141;26619;11169;4.0;1.7
63;2021-02-24;697;1426;27316;12595;4.1;1.9
63;2021-02-25;1597;1666;28913;14261;4.4;2.2
63;2021-02-26;1625;1367;30538;15628;4.6;2.4
63;2021-02-27;642;66;31180;15694;4.7;2.4
63;2021-02-28;4;178;31184;15872;4.7;2.4
63;2021-03-01;586;520;31770;16392;4.8;2.5
63;2021-03-02;903;799;32673;17191;4.9;2.6
63;2021-03-03;1035;723;33708;17914;5.1;2.7
63;2021-03-04;1752;496;35460;18410;5.4;2.8
63;2021-03-05;2612;688;38072;19098;5.8;2.9
63;2021-03-06;1550;47;39622;19145;6.0;2.9
63;2021-03-07;511;16;40133;19161;6.1;2.9
63;2021-03-08;966;648;41099;19809;6.2;3.0
63;2021-03-09;1538;1067;42637;20876;6.5;3.2
63;2021-03-10;1647;611;44284;21487;6.7;3.3
63;2021-03-11;3051;887;47335;22374;7.2;3.4
63;2021-03-12;3511;381;50846;22755;7.7;3.4
63;2021-03-13;2049;79;52895;22834;8.0;3.5
63;2021-03-14;61;21;52956;22855;8.0;3.5
63;2021-03-15;1743;363;54699;23218;8.3;3.5
63;2021-03-16;1742;413;56441;23631;8.5;3.6
63;2021-03-17;1637;678;58078;24309;8.8;3.7
63;2021-03-18;1934;743;60012;25052;9.1;3.8
63;2021-03-19;2737;493;62749;25545;9.5;3.9
63;2021-03-20;1121;66;63870;25611;9.7;3.9
63;2021-03-21;50;45;63920;25656;9.7;3.9
63;2021-03-22;1983;255;65903;25911;10.0;3.9
63;2021-03-23;2880;363;68783;26274;10.4;4.0
63;2021-03-24;3217;337;72000;26611;10.9;4.0
63;2021-03-25;4591;382;76591;26993;11.6;4.1
63;2021-03-26;4689;558;81280;27551;12.3;4.2
63;2021-03-27;2454;228;83734;27779;12.7;4.2
63;2021-03-28;1047;82;84781;27861;12.8;4.2
63;2021-03-29;2480;512;87261;28373;13.2;4.3
63;2021-03-30;3281;625;90542;28998;13.7;4.4
63;2021-03-31;2964;748;93506;29746;14.2;4.5
63;2021-04-01;3835;528;97341;30274;14.7;4.6
63;2021-04-02;3481;708;100822;30982;15.3;4.7
63;2021-04-03;1171;182;101993;31164;15.4;4.7
63;2021-04-04;877;26;102870;31190;15.6;4.7
63;2021-04-05;803;86;103673;31276;15.7;4.7
63;2021-04-06;2470;935;106143;32211;16.1;4.9
63;2021-04-07;3206;867;109349;33078;16.6;5.0
63;2021-04-08;4720;1210;114069;34288;17.3;5.2
63;2021-04-09;5312;990;119381;35278;18.1;5.3
63;2021-04-10;2221;475;121602;35753;18.4;5.4
63;2021-04-11;834;37;122436;35790;18.5;5.4
63;2021-04-12;1619;1314;124055;37104;18.8;5.6
63;2021-04-13;1986;1969;126041;39073;19.1;5.9
63;2021-04-14;2628;1435;128669;40508;19.5;6.1
63;2021-04-15;3788;1528;132457;42036;20.1;6.4
63;2021-04-16;2839;2155;135296;44191;20.5;6.7
63;2021-04-17;1233;672;136529;44863;20.7;6.8
63;2021-04-18;802;60;137331;44923;20.8;6.8
63;2021-04-19;1654;2106;138985;47029;21.1;7.1
63;2021-04-20;1700;2300;140685;49329;21.3;7.5
63;2021-04-21;1515;2405;142200;51734;21.5;7.8
63;2021-04-22;1913;2267;144113;54001;21.8;8.2
63;2021-04-23;2018;3112;146131;57113;22.1;8.7
63;2021-04-24;1192;1128;147323;58241;22.3;8.8
63;2021-04-25;554;413;147877;58654;22.4;8.9
63;2021-04-26;1438;2242;149315;60896;22.6;9.2
63;2021-04-27;2312;2611;151627;63507;23.0;9.6
63;2021-04-28;2331;3162;153958;66669;23.3;10.1
63;2021-04-29;2868;2836;156826;69505;23.8;10.5
63;2021-04-30;2862;2820;159688;72325;24.2;11.0
63;2021-05-01;1127;1050;160815;73375;24.4;11.1
63;2021-05-02;897;641;161712;74016;24.5;11.2
63;2021-05-03;2686;2247;164398;76263;24.9;11.6
63;2021-05-04;2876;2676;167274;78939;25.3;12.0
63;2021-05-05;2937;3120;170211;82059;25.8;12.4
63;2021-05-06;3669;3054;173880;85113;26.3;12.9
63;2021-05-07;4032;3542;177912;88655;26.9;13.4
63;2021-05-08;1998;652;179910;89307;27.2;13.5
63;2021-05-09;1802;608;181712;89915;27.5;13.6
63;2021-05-10;4198;2763;185910;92678;28.2;14.0
63;2021-05-11;5337;2755;191247;95433;29.0;14.5
63;2021-05-12;5263;2901;196510;98334;29.8;14.9
63;2021-05-13;4131;698;200641;99032;30.4;15.0
63;2021-05-14;4769;1511;205410;100543;31.1;15.2
63;2021-05-15;3721;984;209131;101527;31.7;15.4
63;2021-05-16;3517;444;212648;101971;32.2;15.4
63;2021-05-17;3895;1987;216543;103958;32.8;15.7
63;2021-05-18;5118;1616;221661;105574;33.6;16.0
63;2021-05-19;5216;1619;226877;107193;34.4;16.2
63;2021-05-20;6793;2079;233670;109272;35.4;16.6
63;2021-05-21;6253;2324;239923;111596;36.3;16.9
63;2021-05-22;3351;846;243274;112442;36.8;17.0
63;2021-05-23;2383;245;245657;112687;37.2;17.1
63;2021-05-24;2638;580;248295;113267;37.6;17.2
63;2021-05-25;4266;2633;252561;115900;38.3;17.6
63;2021-05-26;5444;2407;258005;118307;39.1;17.9
63;2021-05-27;6494;2800;264499;121107;40.1;18.3
63;2021-05-28;5417;3895;269916;125002;40.9;18.9
63;2021-05-29;3360;1504;273276;126506;41.4;19.2
63;2021-05-30;1579;217;274855;126723;41.6;19.2
63;2021-05-31;4147;2283;279002;129006;42.3;19.5
63;2021-06-01;3800;2957;282802;131963;42.8;20.0
63;2021-06-02;3882;2522;286684;134485;43.4;20.4
63;2021-06-03;4902;3145;291586;137630;44.2;20.8
63;2021-06-04;5096;3623;296682;141253;44.9;21.4
63;2021-06-05;2810;1743;299492;142996;45.4;21.7
63;2021-06-06;1307;697;300799;143693;45.6;21.8
63;2021-06-07;3163;2516;303962;146209;46.0;22.1
63;2021-06-08;2875;2755;306837;148964;46.5;22.6
63;2021-06-09;3019;2275;309856;151239;46.9;22.9
63;2021-06-10;3215;2690;313071;153929;47.4;23.3
63;2021-06-11;3096;4048;316167;157977;47.9;23.9
63;2021-06-12;1636;1970;317803;159947;48.1;24.2
63;2021-06-13;478;1096;318281;161043;48.2;24.4
63;2021-06-14;1823;3475;320104;164518;48.5;24.9
63;2021-06-15;2207;3475;322311;167993;48.8;25.4
63;2021-06-16;2568;3313;324879;171306;49.2;25.9
63;2021-06-17;2388;4302;327267;175608;49.6;26.6
63;2021-06-18;2469;5828;329736;181436;49.9;27.5
63;2021-06-19;1627;2830;331363;184266;50.2;27.9
63;2021-06-20;665;2439;332028;186705;50.3;28.3
63;2021-06-21;1270;5388;333298;192093;50.5;29.1
63;2021-06-22;1231;5537;334529;197630;50.7;29.9
63;2021-06-23;1527;4758;336056;202388;50.9;30.7
63;2021-06-24;1923;5382;337979;207770;51.2;31.5
63;2021-06-25;1739;5901;339718;213671;51.5;32.4
63;2021-06-26;1069;3351;340787;217022;51.6;32.9
63;2021-06-27;708;3487;341495;220509;51.7;33.4
63;2021-06-28;1135;5661;342630;226170;51.9;34.3
63;2021-06-29;1226;5159;343856;231329;52.1;35.0
63;2021-06-30;1592;5289;345448;236618;52.3;35.8
63;2021-07-01;1907;8067;347355;244685;52.6;37.1
63;2021-07-02;2042;6539;349397;251224;52.9;38.1
63;2021-07-03;953;2927;350350;254151;53.1;38.5
63;2021-07-04;1027;1881;351377;256032;53.2;38.8
63;2021-07-05;1510;6279;352887;262311;53.4;39.7
63;2021-07-06;1590;4798;354477;267109;53.7;40.5
63;2021-07-07;1958;4082;356435;271191;54.0;41.1
63;2021-07-08;2199;4587;358634;275778;54.3;41.8
63;2021-07-09;1904;5725;360538;281503;54.6;42.6
63;2021-07-10;1522;3410;362060;284913;54.8;43.2
63;2021-07-11;899;1532;362959;286445;55.0;43.4
63;2021-07-12;1573;8707;364532;295152;55.2;44.7
63;2021-07-13;3579;6139;368111;301291;55.8;45.6
63;2021-07-14;3601;1788;371712;303079;56.3;45.9
63;2021-07-15;4375;5027;376087;308106;57.0;46.7
63;2021-07-16;4645;5779;380732;313885;57.7;47.5
63;2021-07-17;2988;2469;383720;316354;58.1;47.9
63;2021-07-18;2800;1088;386520;317442;58.5;48.1
63;2021-07-19;3954;4843;390474;322285;59.1;48.8
63;2021-07-20;4679;5446;395153;327731;59.8;49.6
63;2021-07-21;4747;3975;399900;331706;60.6;50.2
63;2021-07-22;5474;4380;405374;336086;61.4;50.9
63;2021-07-23;5114;4645;410488;340731;62.2;51.6
63;2021-07-24;3632;1945;414120;342676;62.7;51.9
63;2021-07-25;3017;1426;417137;344102;63.2;52.1
63;2021-07-26;3986;3219;421123;347321;63.8;52.6
63;2021-07-27;3852;3136;424975;350457;64.4;53.1
63;2021-07-28;3769;2704;428744;353161;64.9;53.5
63;2021-07-29;4367;3145;433111;356306;65.6;54.0
63;2021-07-30;3783;3561;436894;359867;66.2;54.5
63;2021-07-31;2041;1697;438935;361564;66.5;54.8
63;2021-08-01;1191;827;440126;362391;66.7;54.9
63;2021-08-02;2179;3066;442305;365457;67.0;55.4
63;2021-08-03;2712;3255;445017;368712;67.4;55.8
63;2021-08-04;2709;3222;447726;371934;67.8;56.3
63;2021-08-05;2395;3466;450121;375400;68.2;56.9
64;2020-12-27;0;0;0;0;0.0;0.0
64;2020-12-28;2;0;2;0;0.0;0.0
64;2020-12-29;0;0;2;0;0.0;0.0
64;2020-12-30;0;0;2;0;0.0;0.0
64;2020-12-31;0;0;2;0;0.0;0.0
64;2021-01-01;0;0;2;0;0.0;0.0
64;2021-01-02;0;0;2;0;0.0;0.0
64;2021-01-03;0;0;2;0;0.0;0.0
64;2021-01-04;29;0;31;0;0.0;0.0
64;2021-01-05;25;0;56;0;0.0;0.0
64;2021-01-06;187;0;243;0;0.0;0.0
64;2021-01-07;839;0;1082;0;0.2;0.0
64;2021-01-08;879;2;1961;2;0.3;0.0
64;2021-01-09;54;0;2015;2;0.3;0.0
64;2021-01-10;0;0;2015;2;0.3;0.0
64;2021-01-11;540;0;2555;2;0.4;0.0
64;2021-01-12;759;2;3314;4;0.5;0.0
64;2021-01-13;865;2;4179;6;0.6;0.0
64;2021-01-14;1045;3;5224;9;0.8;0.0
64;2021-01-15;929;5;6153;14;0.9;0.0
64;2021-01-16;68;0;6221;14;0.9;0.0
64;2021-01-17;5;0;6226;14;0.9;0.0
64;2021-01-18;942;8;7168;22;1.0;0.0
64;2021-01-19;1441;4;8609;26;1.3;0.0
64;2021-01-20;1617;2;10226;28;1.5;0.0
64;2021-01-21;2602;2;12828;30;1.9;0.0
64;2021-01-22;1648;3;14476;33;2.1;0.0
64;2021-01-23;524;1;15000;34;2.2;0.0
64;2021-01-24;88;0;15088;34;2.2;0.0
64;2021-01-25;969;8;16057;42;2.4;0.0
64;2021-01-26;1355;21;17412;63;2.5;0.0
64;2021-01-27;1240;120;18652;183;2.7;0.0
64;2021-01-28;1648;633;20300;816;3.0;0.1
64;2021-01-29;972;653;21272;1469;3.1;0.2
64;2021-01-30;467;59;21739;1528;3.2;0.2
64;2021-01-31;91;0;21830;1528;3.2;0.2
64;2021-02-01;673;312;22503;1840;3.3;0.3
64;2021-02-02;1132;556;23635;2396;3.5;0.4
64;2021-02-03;1040;630;24675;3026;3.6;0.4
64;2021-02-04;1027;535;25702;3561;3.8;0.5
64;2021-02-05;866;456;26568;4017;3.9;0.6
64;2021-02-06;500;34;27068;4051;4.0;0.6
64;2021-02-07;131;4;27199;4055;4.0;0.6
64;2021-02-08;769;310;27968;4365;4.1;0.6
64;2021-02-09;947;713;28915;5078;4.2;0.7
64;2021-02-10;911;805;29826;5883;4.4;0.9
64;2021-02-11;1199;1488;31025;7371;4.5;1.1
64;2021-02-12;1075;1067;32100;8438;4.7;1.2
64;2021-02-13;225;321;32325;8759;4.7;1.3
64;2021-02-14;36;47;32361;8806;4.7;1.3
64;2021-02-15;221;1129;32582;9935;4.8;1.5
64;2021-02-16;258;1407;32840;11342;4.8;1.7
64;2021-02-17;289;1252;33129;12594;4.8;1.8
64;2021-02-18;506;1718;33635;14312;4.9;2.1
64;2021-02-19;415;1290;34050;15602;5.0;2.3
64;2021-02-20;119;438;34169;16040;5.0;2.3
64;2021-02-21;20;83;34189;16123;5.0;2.4
64;2021-02-22;475;986;34664;17109;5.1;2.5
64;2021-02-23;719;1143;35383;18252;5.2;2.7
64;2021-02-24;731;1016;36114;19268;5.3;2.8
64;2021-02-25;1094;954;37208;20222;5.4;3.0
64;2021-02-26;1216;915;38424;21137;5.6;3.1
64;2021-02-27;864;405;39288;21542;5.8;3.2
64;2021-02-28;41;85;39329;21627;5.8;3.2
64;2021-03-01;763;799;40092;22426;5.9;3.3
64;2021-03-02;1078;916;41170;23342;6.0;3.4
64;2021-03-03;1246;1002;42416;24344;6.2;3.6
64;2021-03-04;1878;1187;44294;25531;6.5;3.7
64;2021-03-05;2192;1069;46486;26600;6.8;3.9
64;2021-03-06;1542;519;48028;27119;7.0;4.0
64;2021-03-07;594;111;48622;27230;7.1;4.0
64;2021-03-08;1533;765;50155;27995;7.3;4.1
64;2021-03-09;2063;851;52218;28846;7.6;4.2
64;2021-03-10;2078;759;54296;29605;7.9;4.3
64;2021-03-11;2969;1072;57265;30677;8.4;4.5
64;2021-03-12;3483;589;60748;31266;8.9;4.6
64;2021-03-13;2254;168;63002;31434;9.2;4.6
64;2021-03-14;232;15;63234;31449;9.3;4.6
64;2021-03-15;2331;227;65565;31676;9.6;4.6
64;2021-03-16;1985;263;67550;31939;9.9;4.7
64;2021-03-17;2066;233;69616;32172;10.2;4.7
64;2021-03-18;2459;203;72075;32375;10.6;4.7
64;2021-03-19;3009;281;75084;32656;11.0;4.8
64;2021-03-20;2464;86;77548;32742;11.4;4.8
64;2021-03-21;1275;24;78823;32766;11.5;4.8
64;2021-03-22;2587;551;81410;33317;11.9;4.9
64;2021-03-23;3196;651;84606;33968;12.4;5.0
64;2021-03-24;3562;699;88168;34667;12.9;5.1
64;2021-03-25;4349;804;92517;35471;13.5;5.2
64;2021-03-26;4418;697;96935;36168;14.2;5.3
64;2021-03-27;2969;423;99904;36591;14.6;5.4
64;2021-03-28;521;54;100425;36645;14.7;5.4
64;2021-03-29;3024;879;103449;37524;15.1;5.5
64;2021-03-30;4132;865;107581;38389;15.7;5.6
64;2021-03-31;3584;780;111165;39169;16.3;5.7
64;2021-04-01;4766;928;115931;40097;17.0;5.9
64;2021-04-02;4437;740;120368;40837;17.6;6.0
64;2021-04-03;2057;582;122425;41419;17.9;6.1
64;2021-04-04;304;49;122729;41468;18.0;6.1
64;2021-04-05;1687;140;124416;41608;18.2;6.1
64;2021-04-06;3654;1386;128070;42994;18.7;6.3
64;2021-04-07;3944;1508;132014;44502;19.3;6.5
64;2021-04-08;5186;1593;137200;46095;20.1;6.7
64;2021-04-09;5888;1621;143088;47716;20.9;7.0
64;2021-04-10;3219;1044;146307;48760;21.4;7.1
64;2021-04-11;443;251;146750;49011;21.5;7.2
64;2021-04-12;4041;1855;150791;50866;22.1;7.4
64;2021-04-13;4460;2155;155251;53021;22.7;7.8
64;2021-04-14;4084;2130;159335;55151;23.3;8.1
64;2021-04-15;4395;2294;163730;57445;24.0;8.4
64;2021-04-16;4291;2255;168021;59700;24.6;8.7
64;2021-04-17;2478;1497;170499;61197;25.0;9.0
64;2021-04-18;1095;1182;171594;62379;25.1;9.1
64;2021-04-19;2729;2444;174323;64823;25.5;9.5
64;2021-04-20;3207;2423;177530;67246;26.0;9.8
64;2021-04-21;3215;2563;180745;69809;26.5;10.2
64;2021-04-22;3386;2775;184131;72584;27.0;10.6
64;2021-04-23;3431;2594;187562;75178;27.5;11.0
64;2021-04-24;2068;1586;189630;76764;27.8;11.2
64;2021-04-25;290;238;189920;77002;27.8;11.3
64;2021-04-26;2658;2650;192578;79652;28.2;11.7
64;2021-04-27;3059;3130;195637;82782;28.6;12.1
64;2021-04-28;3603;3059;199240;85841;29.2;12.6
64;2021-04-29;4648;3448;203888;89289;29.8;13.1
64;2021-04-30;4071;3607;207959;92896;30.4;13.6
64;2021-05-01;1480;1030;209439;93926;30.7;13.7
64;2021-05-02;446;326;209885;94252;30.7;13.8
64;2021-05-03;2909;3490;212794;97742;31.1;14.3
64;2021-05-04;3644;3986;216438;101728;31.7;14.9
64;2021-05-05;3361;4016;219799;105744;32.2;15.5
64;2021-05-06;4111;3984;223910;109728;32.8;16.1
64;2021-05-07;3916;4189;227826;113917;33.3;16.7
64;2021-05-08;2618;1233;230444;115150;33.7;16.9
64;2021-05-09;719;306;231163;115456;33.8;16.9
64;2021-05-10;2862;4232;234025;119688;34.3;17.5
64;2021-05-11;4183;4152;238208;123840;34.9;18.1
64;2021-05-12;4484;3941;242692;127781;35.5;18.7
64;2021-05-13;3198;885;245890;128666;36.0;18.8
64;2021-05-14;5138;3147;251028;131813;36.7;19.3
64;2021-05-15;3525;1867;254553;133680;37.3;19.6
64;2021-05-16;498;225;255051;133905;37.3;19.6
64;2021-05-17;4190;2377;259241;136282;37.9;19.9
64;2021-05-18;5164;2301;264405;138583;38.7;20.3
64;2021-05-19;4978;2162;269383;140745;39.4;20.6
64;2021-05-20;5561;2154;274944;142899;40.2;20.9
64;2021-05-21;5264;2245;280208;145144;41.0;21.2
64;2021-05-22;3577;1507;283785;146651;41.5;21.5
64;2021-05-23;431;207;284216;146858;41.6;21.5
64;2021-05-24;2995;1233;287211;148091;42.0;21.7
64;2021-05-25;4333;2846;291544;150937;42.7;22.1
64;2021-05-26;4350;2716;295894;153653;43.3;22.5
64;2021-05-27;5284;3152;301178;156805;44.1;23.0
64;2021-05-28;4608;3432;305786;160237;44.8;23.5
64;2021-05-29;2809;2115;308595;162352;45.2;23.8
64;2021-05-30;436;204;309031;162556;45.2;23.8
64;2021-05-31;3893;3665;312924;166221;45.8;24.3
64;2021-06-01;5334;3561;318258;169782;46.6;24.9
64;2021-06-02;4939;3177;323197;172959;47.3;25.3
64;2021-06-03;6363;3260;329560;176219;48.2;25.8
64;2021-06-04;5141;4550;334701;180769;49.0;26.5
64;2021-06-05;3482;2523;338183;183292;49.5;26.8
64;2021-06-06;2014;329;340197;183621;49.8;26.9
64;2021-06-07;4124;4324;344321;187945;50.4;27.5
64;2021-06-08;5154;4122;349475;192067;51.2;28.1
64;2021-06-09;5151;3650;354626;195717;51.9;28.6
64;2021-06-10;6172;3139;360798;198856;52.8;29.1
64;2021-06-11;5583;4867;366381;203723;53.6;29.8
64;2021-06-12;3945;2324;370326;206047;54.2;30.2
64;2021-06-13;1554;390;371880;206437;54.4;30.2
64;2021-06-14;3671;4786;375551;211223;55.0;30.9
64;2021-06-15;4574;4706;380125;215929;55.6;31.6
64;2021-06-16;4470;4657;384595;220586;56.3;32.3
64;2021-06-17;3638;4301;388233;224887;56.8;32.9
64;2021-06-18;4423;5169;392656;230056;57.5;33.7
64;2021-06-19;2979;3278;395635;233334;57.9;34.2
64;2021-06-20;878;537;396513;233871;58.0;34.2
64;2021-06-21;2309;5125;398822;238996;58.4;35.0
64;2021-06-22;2557;5729;401379;244725;58.8;35.8
64;2021-06-23;3101;5473;404480;250198;59.2;36.6
64;2021-06-24;2718;3806;407198;254004;59.6;37.2
64;2021-06-25;2900;6432;410098;260436;60.0;38.1
64;2021-06-26;1797;3834;411895;264270;60.3;38.7
64;2021-06-27;492;712;412387;264982;60.4;38.8
64;2021-06-28;1926;6060;414313;271042;60.6;39.7
64;2021-06-29;1946;6262;416259;277304;60.9;40.6
64;2021-06-30;2248;6002;418507;283306;61.3;41.5
64;2021-07-01;2400;5336;420907;288642;61.6;42.3
64;2021-07-02;2294;6400;423201;295042;61.9;43.2
64;2021-07-03;1258;3781;424459;298823;62.1;43.7
64;2021-07-04;409;847;424868;299670;62.2;43.9
64;2021-07-05;1369;5411;426237;305081;62.4;44.7
64;2021-07-06;1985;6148;428222;311229;62.7;45.6
64;2021-07-07;2055;5747;430277;316976;63.0;46.4
64;2021-07-08;1793;4392;432070;321368;63.2;47.0
64;2021-07-09;1813;6533;433883;327901;63.5;48.0
64;2021-07-10;1166;3882;435049;331783;63.7;48.6
64;2021-07-11;251;859;435300;332642;63.7;48.7
64;2021-07-12;1491;6092;436791;338734;63.9;49.6
64;2021-07-13;2352;7250;439143;345984;64.3;50.6
64;2021-07-14;2355;3386;441498;349370;64.6;51.1
64;2021-07-15;2077;5478;443575;354848;64.9;51.9
64;2021-07-16;2813;6774;446388;361622;65.3;52.9
64;2021-07-17;2321;4582;448709;366204;65.7;53.6
64;2021-07-18;703;2051;449412;368255;65.8;53.9
64;2021-07-19;2315;6120;451727;374375;66.1;54.8
64;2021-07-20;3105;6550;454832;380925;66.6;55.8
64;2021-07-21;3309;6042;458141;386967;67.1;56.6
64;2021-07-22;3785;5711;461926;392678;67.6;57.5
64;2021-07-23;3709;5601;465635;398279;68.2;58.3
64;2021-07-24;2530;4423;468165;402702;68.5;58.9
64;2021-07-25;750;1058;468915;403760;68.6;59.1
64;2021-07-26;3062;5119;471977;408879;69.1;59.9
64;2021-07-27;4217;5129;476194;414008;69.7;60.6
64;2021-07-28;4272;4579;480466;418587;70.3;61.3
64;2021-07-29;5484;3872;485950;422459;71.1;61.8
64;2021-07-30;5055;4195;491005;426654;71.9;62.5
64;2021-07-31;3144;3333;494149;429987;72.3;62.9
64;2021-08-01;1139;576;495288;430563;72.5;63.0
64;2021-08-02;4323;2627;499611;433190;73.1;63.4
64;2021-08-03;4498;3148;504109;436338;73.8;63.9
64;2021-08-04;4087;2977;508196;439315;74.4;64.3
64;2021-08-05;3915;2594;512111;441909;75.0;64.7
65;2020-12-27;0;0;0;0;0.0;0.0
65;2020-12-28;0;0;0;0;0.0;0.0
65;2020-12-29;0;0;0;0;0.0;0.0
65;2020-12-30;0;0;0;0;0.0;0.0
65;2020-12-31;0;0;0;0;0.0;0.0
65;2021-01-01;0;0;0;0;0.0;0.0
65;2021-01-02;0;0;0;0;0.0;0.0
65;2021-01-03;0;0;0;0;0.0;0.0
65;2021-01-04;0;0;0;0;0.0;0.0
65;2021-01-05;1;0;1;0;0.0;0.0
65;2021-01-06;3;0;4;0;0.0;0.0
65;2021-01-07;167;0;171;0;0.1;0.0
65;2021-01-08;253;1;424;1;0.2;0.0
65;2021-01-09;175;1;599;2;0.3;0.0
65;2021-01-10;1;0;600;2;0.3;0.0
65;2021-01-11;275;3;875;5;0.4;0.0
65;2021-01-12;271;1;1146;6;0.5;0.0
65;2021-01-13;587;1;1733;7;0.8;0.0
65;2021-01-14;577;5;2310;12;1.0;0.0
65;2021-01-15;527;2;2837;14;1.3;0.0
65;2021-01-16;221;2;3058;16;1.3;0.0
65;2021-01-17;1;0;3059;16;1.3;0.0
65;2021-01-18;549;6;3608;22;1.6;0.0
65;2021-01-19;570;2;4178;24;1.8;0.0
65;2021-01-20;582;3;4760;27;2.1;0.0
65;2021-01-21;584;0;5344;27;2.4;0.0
65;2021-01-22;596;0;5940;27;2.6;0.0
65;2021-01-23;174;1;6114;28;2.7;0.0
65;2021-01-24;3;1;6117;29;2.7;0.0
65;2021-01-25;550;3;6667;32;2.9;0.0
65;2021-01-26;880;2;7547;34;3.3;0.0
65;2021-01-27;588;12;8135;46;3.6;0.0
65;2021-01-28;503;71;8638;117;3.8;0.1
65;2021-01-29;426;138;9064;255;4.0;0.1
65;2021-01-30;183;74;9247;329;4.1;0.1
65;2021-01-31;15;0;9262;329;4.1;0.1
65;2021-02-01;320;90;9582;419;4.2;0.2
65;2021-02-02;418;195;10000;614;4.4;0.3
65;2021-02-03;463;245;10463;859;4.6;0.4
65;2021-02-04;307;333;10770;1192;4.7;0.5
65;2021-02-05;283;362;11053;1554;4.9;0.7
65;2021-02-06;99;103;11152;1657;4.9;0.7
65;2021-02-07;10;0;11162;1657;4.9;0.7
65;2021-02-08;424;222;11586;1879;5.1;0.8
65;2021-02-09;271;380;11857;2259;5.2;1.0
65;2021-02-10;296;272;12153;2531;5.4;1.1
65;2021-02-11;320;273;12473;2804;5.5;1.2
65;2021-02-12;276;232;12749;3036;5.6;1.3
65;2021-02-13;124;97;12873;3133;5.7;1.4
65;2021-02-14;2;16;12875;3149;5.7;1.4
65;2021-02-15;202;415;13077;3564;5.8;1.6
65;2021-02-16;488;582;13565;4146;6.0;1.8
65;2021-02-17;229;499;13794;4645;6.1;2.0
65;2021-02-18;285;586;14079;5231;6.2;2.3
65;2021-02-19;155;479;14234;5710;6.3;2.5
65;2021-02-20;53;158;14287;5868;6.3;2.6
65;2021-02-21;2;48;14289;5916;6.3;2.6
65;2021-02-22;166;540;14455;6456;6.4;2.8
65;2021-02-23;247;528;14702;6984;6.5;3.1
65;2021-02-24;232;637;14934;7621;6.6;3.4
65;2021-02-25;211;178;15145;7799;6.7;3.4
65;2021-02-26;350;776;15495;8575;6.8;3.8
65;2021-02-27;107;202;15602;8777;6.9;3.9
65;2021-02-28;1;0;15603;8777;6.9;3.9
65;2021-03-01;375;374;15978;9151;7.0;4.0
65;2021-03-02;452;360;16430;9511;7.2;4.2
65;2021-03-03;380;390;16810;9901;7.4;4.4
65;2021-03-04;695;329;17505;10230;7.7;4.5
65;2021-03-05;676;284;18181;10514;8.0;4.6
65;2021-03-06;1183;83;19364;10597;8.5;4.7
65;2021-03-07;258;11;19622;10608;8.7;4.7
65;2021-03-08;412;344;20034;10952;8.8;4.8
65;2021-03-09;668;333;20702;11285;9.1;5.0
65;2021-03-10;625;370;21327;11655;9.4;5.1
65;2021-03-11;781;356;22108;12011;9.7;5.3
65;2021-03-12;1057;189;23165;12200;10.2;5.4
65;2021-03-13;353;92;23518;12292;10.4;5.4
65;2021-03-14;3;31;23521;12323;10.4;5.4
65;2021-03-15;814;183;24335;12506;10.7;5.5
65;2021-03-16;692;217;25027;12723;11.0;5.6
65;2021-03-17;709;207;25736;12930;11.3;5.7
65;2021-03-18;531;231;26267;13161;11.6;5.8
65;2021-03-19;877;161;27144;13322;12.0;5.9
65;2021-03-20;244;45;27388;13367;12.1;5.9
65;2021-03-21;11;2;27399;13369;12.1;5.9
65;2021-03-22;734;154;28133;13523;12.4;6.0
65;2021-03-23;835;366;28968;13889;12.8;6.1
65;2021-03-24;868;252;29836;14141;13.2;6.2
65;2021-03-25;1250;191;31086;14332;13.7;6.3
65;2021-03-26;1220;138;32306;14470;14.2;6.4
65;2021-03-27;1357;81;33663;14551;14.8;6.4
65;2021-03-28;1;2;33664;14553;14.8;6.4
65;2021-03-29;1491;357;35155;14910;15.5;6.6
65;2021-03-30;1357;403;36512;15313;16.1;6.8
65;2021-03-31;1204;367;37716;15680;16.6;6.9
65;2021-04-01;1509;395;39225;16075;17.3;7.1
65;2021-04-02;1681;286;40906;16361;18.0;7.2
65;2021-04-03;247;43;41153;16404;18.1;7.2
65;2021-04-04;4;2;41157;16406;18.1;7.2
65;2021-04-05;158;44;41315;16450;18.2;7.3
65;2021-04-06;1287;493;42602;16943;18.8;7.5
65;2021-04-07;1953;448;44555;17391;19.6;7.7
65;2021-04-08;1634;411;46189;17802;20.4;7.8
65;2021-04-09;1644;469;47833;18271;21.1;8.1
65;2021-04-10;1588;144;49421;18415;21.8;8.1
65;2021-04-11;3;0;49424;18415;21.8;8.1
65;2021-04-12;1348;736;50772;19151;22.4;8.4
65;2021-04-13;1575;591;52347;19742;23.1;8.7
65;2021-04-14;1904;740;54251;20482;23.9;9.0
65;2021-04-15;1698;663;55949;21145;24.7;9.3
65;2021-04-16;1825;527;57774;21672;25.5;9.6
65;2021-04-17;2156;123;59930;21795;26.4;9.6
65;2021-04-18;7;27;59937;21822;26.4;9.6
65;2021-04-19;1337;774;61274;22596;27.0;10.0
65;2021-04-20;1526;704;62800;23300;27.7;10.3
65;2021-04-21;1046;1049;63846;24349;28.1;10.7
65;2021-04-22;1644;724;65490;25073;28.9;11.1
65;2021-04-23;1161;1144;66651;26217;29.4;11.6
65;2021-04-24;1262;603;67913;26820;29.9;11.8
65;2021-04-25;31;15;67944;26835;30.0;11.8
65;2021-04-26;1603;1296;69547;28131;30.7;12.4
65;2021-04-27;1423;1334;70970;29465;31.3;13.0
65;2021-04-28;1730;1024;72700;30489;32.0;13.4
65;2021-04-29;1961;1027;74661;31516;32.9;13.9
65;2021-04-30;1780;924;76441;32440;33.7;14.3
65;2021-05-01;1573;221;78014;32661;34.4;14.4
65;2021-05-02;670;22;78684;32683;34.7;14.4
65;2021-05-03;1284;1619;79968;34302;35.3;15.1
65;2021-05-04;1539;1241;81507;35543;35.9;15.7
65;2021-05-05;1373;1643;82880;37186;36.5;16.4
65;2021-05-06;1554;1178;84434;38364;37.2;16.9
65;2021-05-07;1273;1568;85707;39932;37.8;17.6
65;2021-05-08;1648;439;87355;40371;38.5;17.8
65;2021-05-09;0;90;87355;40461;38.5;17.8
65;2021-05-10;951;1882;88306;42343;38.9;18.7
65;2021-05-11;1058;1811;89364;44154;39.4;19.5
65;2021-05-12;1234;1635;90598;45789;39.9;20.2
65;2021-05-13;1342;166;91940;45955;40.5;20.3
65;2021-05-14;1576;1095;93516;47050;41.2;20.7
65;2021-05-15;1400;509;94916;47559;41.8;21.0
65;2021-05-16;1445;70;96361;47629;42.5;21.0
65;2021-05-17;1037;1615;97398;49244;42.9;21.7
65;2021-05-18;1610;1202;99008;50446;43.6;22.2
65;2021-05-19;1685;1004;100693;51450;44.4;22.7
65;2021-05-20;1844;1047;102537;52497;45.2;23.1
65;2021-05-21;1790;1233;104327;53730;46.0;23.7
65;2021-05-22;1286;637;105613;54367;46.6;24.0
65;2021-05-23;690;32;106303;54399;46.9;24.0
65;2021-05-24;703;77;107006;54476;47.2;24.0
65;2021-05-25;1354;1544;108360;56020;47.8;24.7
65;2021-05-26;1472;1354;109832;57374;48.4;25.3
65;2021-05-27;1617;1453;111449;58827;49.1;25.9
65;2021-05-28;1598;1674;113047;60501;49.8;26.7
65;2021-05-29;1186;1512;114233;62013;50.4;27.3
65;2021-05-30;6;10;114239;62023;50.4;27.3
65;2021-05-31;1322;1298;115561;63321;50.9;27.9
65;2021-06-01;1829;931;117390;64252;51.8;28.3
65;2021-06-02;1574;949;118964;65201;52.4;28.7
65;2021-06-03;1339;1101;120303;66302;53.0;29.2
65;2021-06-04;1788;1562;122091;67864;53.8;29.9
65;2021-06-05;433;1239;122524;69103;54.0;30.5
65;2021-06-06;3;13;122527;69116;54.0;30.5
65;2021-06-07;672;1984;123199;71100;54.3;31.3
65;2021-06-08;956;1537;124155;72637;54.7;32.0
65;2021-06-09;823;1549;124978;74186;55.1;32.7
65;2021-06-10;739;1155;125717;75341;55.4;33.2
65;2021-06-11;910;1808;126627;77149;55.8;34.0
65;2021-06-12;150;639;126777;77788;55.9;34.3
65;2021-06-13;5;7;126782;77795;55.9;34.3
65;2021-06-14;503;2422;127285;80217;56.1;35.4
65;2021-06-15;939;1805;128224;82022;56.5;36.2
65;2021-06-16;1063;1368;129287;83390;57.0;36.8
65;2021-06-17;813;1045;130100;84435;57.4;37.2
65;2021-06-18;1017;1631;131117;86066;57.8;37.9
65;2021-06-19;689;1688;131806;87754;58.1;38.7
65;2021-06-20;2;2;131808;87756;58.1;38.7
65;2021-06-21;740;1938;132548;89694;58.4;39.5
65;2021-06-22;1043;1479;133591;91173;58.9;40.2
65;2021-06-23;1064;1233;134655;92406;59.4;40.7
65;2021-06-24;957;1142;135612;93548;59.8;41.2
65;2021-06-25;830;1965;136442;95513;60.1;42.1
65;2021-06-26;169;1658;136611;97171;60.2;42.8
65;2021-06-27;15;1101;136626;98272;60.2;43.3
65;2021-06-28;444;2302;137070;100574;60.4;44.3
65;2021-06-29;683;1914;137753;102488;60.7;45.2
65;2021-06-30;929;1680;138682;104168;61.1;45.9
65;2021-07-01;602;748;139284;104916;61.4;46.3
65;2021-07-02;1161;1731;140445;106647;61.9;47.0
65;2021-07-03;191;1915;140636;108562;62.0;47.9
65;2021-07-04;414;182;141050;108744;62.2;47.9
65;2021-07-05;640;1993;141690;110737;62.5;48.8
65;2021-07-06;889;2124;142579;112861;62.9;49.8
65;2021-07-07;963;1514;143542;114375;63.3;50.4
65;2021-07-08;324;662;143866;115037;63.4;50.7
65;2021-07-09;545;1594;144411;116631;63.7;51.4
65;2021-07-10;291;956;144702;117587;63.8;51.8
65;2021-07-11;0;0;144702;117587;63.8;51.8
65;2021-07-12;475;2223;145177;119810;64.0;52.8
65;2021-07-13;689;2147;145866;121957;64.3;53.8
65;2021-07-14;207;50;146073;122007;64.4;53.8
65;2021-07-15;1020;1660;147093;123667;64.8;54.5
65;2021-07-16;1165;1875;148258;125542;65.4;55.3
65;2021-07-17;407;539;148665;126081;65.5;55.6
65;2021-07-18;22;12;148687;126093;65.5;55.6
65;2021-07-19;623;1494;149310;127587;65.8;56.2
65;2021-07-20;1414;1694;150724;129281;66.4;57.0
65;2021-07-21;1372;1651;152096;130932;67.1;57.7
65;2021-07-22;2129;1271;154225;132203;68.0;58.3
65;2021-07-23;1571;1788;155796;133991;68.7;59.1
65;2021-07-24;1028;646;156824;134637;69.1;59.4
65;2021-07-25;21;21;156845;134658;69.1;59.4
65;2021-07-26;1110;1242;157955;135900;69.6;59.9
65;2021-07-27;1754;1956;159709;137856;70.4;60.8
65;2021-07-28;1560;1312;161269;139168;71.1;61.4
65;2021-07-29;2807;1117;164076;140285;72.3;61.8
65;2021-07-30;2391;1383;166467;141668;73.4;62.5
65;2021-07-31;2204;338;168671;142006;74.4;62.6
65;2021-08-01;14;16;168685;142022;74.4;62.6
65;2021-08-02;923;831;169608;142853;74.8;63.0
65;2021-08-03;1998;1050;171606;143903;75.7;63.4
65;2021-08-04;1755;624;173361;144527;76.4;63.7
65;2021-08-05;1760;819;175121;145346;77.2;64.1
66;2020-12-27;0;0;0;0;0.0;0.0
66;2020-12-28;2;0;2;0;0.0;0.0
66;2020-12-29;0;0;2;0;0.0;0.0
66;2020-12-30;0;0;2;0;0.0;0.0
66;2020-12-31;1;0;3;0;0.0;0.0
66;2021-01-01;1;0;4;0;0.0;0.0
66;2021-01-02;0;0;4;0;0.0;0.0
66;2021-01-03;0;0;4;0;0.0;0.0
66;2021-01-04;30;0;34;0;0.0;0.0
66;2021-01-05;135;0;169;0;0.0;0.0
66;2021-01-06;195;0;364;0;0.1;0.0
66;2021-01-07;180;0;544;0;0.1;0.0
66;2021-01-08;212;0;756;0;0.2;0.0
66;2021-01-09;232;0;988;0;0.2;0.0
66;2021-01-10;11;0;999;0;0.2;0.0
66;2021-01-11;404;2;1403;2;0.3;0.0
66;2021-01-12;587;2;1990;4;0.4;0.0
66;2021-01-13;877;6;2867;10;0.6;0.0
66;2021-01-14;891;11;3758;21;0.8;0.0
66;2021-01-15;585;1;4343;22;0.9;0.0
66;2021-01-16;106;2;4449;24;0.9;0.0
66;2021-01-17;46;1;4495;25;0.9;0.0
66;2021-01-18;654;2;5149;27;1.1;0.0
66;2021-01-19;716;3;5865;30;1.2;0.0
66;2021-01-20;1168;3;7033;33;1.5;0.0
66;2021-01-21;2402;3;9435;36;2.0;0.0
66;2021-01-22;1437;8;10872;44;2.3;0.0
66;2021-01-23;399;3;11271;47;2.4;0.0
66;2021-01-24;226;9;11497;56;2.4;0.0
66;2021-01-25;737;42;12234;98;2.6;0.0
66;2021-01-26;785;68;13019;166;2.7;0.0
66;2021-01-27;865;104;13884;270;2.9;0.1
66;2021-01-28;869;128;14753;398;3.1;0.1
66;2021-01-29;816;126;15569;524;3.3;0.1
66;2021-01-30;480;70;16049;594;3.4;0.1
66;2021-01-31;202;27;16251;621;3.4;0.1
66;2021-02-01;562;190;16813;811;3.5;0.2
66;2021-02-02;618;290;17431;1101;3.6;0.2
66;2021-02-03;736;629;18167;1730;3.8;0.4
66;2021-02-04;688;621;18855;2351;3.9;0.5
66;2021-02-05;777;417;19632;2768;4.1;0.6
66;2021-02-06;413;147;20045;2915;4.2;0.6
66;2021-02-07;169;139;20214;3054;4.2;0.6
66;2021-02-08;500;395;20714;3449;4.3;0.7
66;2021-02-09;531;401;21245;3850;4.4;0.8
66;2021-02-10;614;772;21859;4622;4.6;1.0
66;2021-02-11;1104;1572;22963;6194;4.8;1.3
66;2021-02-12;1120;1202;24083;7396;5.0;1.5
66;2021-02-13;366;305;24449;7701;5.1;1.6
66;2021-02-14;111;199;24560;7900;5.1;1.6
66;2021-02-15;425;701;24985;8601;5.2;1.8
66;2021-02-16;303;792;25288;9393;5.3;2.0
66;2021-02-17;378;701;25666;10094;5.4;2.1
66;2021-02-18;366;777;26032;10871;5.4;2.3
66;2021-02-19;400;704;26432;11575;5.5;2.4
66;2021-02-20;184;413;26616;11988;5.6;2.5
66;2021-02-21;41;172;26657;12160;5.6;2.5
66;2021-02-22;415;646;27072;12806;5.7;2.7
66;2021-02-23;508;660;27580;13466;5.8;2.8
66;2021-02-24;340;750;27920;14216;5.8;3.0
66;2021-02-25;718;715;28638;14931;6.0;3.1
66;2021-02-26;951;748;29589;15679;6.2;3.3
66;2021-02-27;363;433;29952;16112;6.3;3.4
66;2021-02-28;59;173;30011;16285;6.3;3.4
66;2021-03-01;378;655;30389;16940;6.3;3.5
66;2021-03-02;332;657;30721;17597;6.4;3.7
66;2021-03-03;527;645;31248;18242;6.5;3.8
66;2021-03-04;991;1056;32239;19298;6.7;4.0
66;2021-03-05;1526;795;33765;20093;7.0;4.2
66;2021-03-06;1145;344;34910;20437;7.3;4.3
66;2021-03-07;1096;96;36006;20533;7.5;4.3
66;2021-03-08;694;545;36700;21078;7.7;4.4
66;2021-03-09;1221;593;37921;21671;7.9;4.5
66;2021-03-10;1300;501;39221;22172;8.2;4.6
66;2021-03-11;1475;595;40696;22767;8.5;4.8
66;2021-03-12;2393;579;43089;23346;9.0;4.9
66;2021-03-13;1081;306;44170;23652;9.2;4.9
66;2021-03-14;190;85;44360;23737;9.3;5.0
66;2021-03-15;1108;392;45468;24129;9.5;5.0
66;2021-03-16;952;260;46420;24389;9.7;5.1
66;2021-03-17;866;395;47286;24784;9.9;5.2
66;2021-03-18;968;344;48254;25128;10.1;5.2
66;2021-03-19;1292;317;49546;25445;10.3;5.3
66;2021-03-20;837;121;50383;25566;10.5;5.3
66;2021-03-21;185;44;50568;25610;10.6;5.3
66;2021-03-22;1106;396;51674;26006;10.8;5.4
66;2021-03-23;1756;388;53430;26394;11.2;5.5
66;2021-03-24;1791;516;55221;26910;11.5;5.6
66;2021-03-25;2533;465;57754;27375;12.1;5.7
66;2021-03-26;2578;357;60332;27732;12.6;5.8
66;2021-03-27;1208;294;61540;28026;12.8;5.9
66;2021-03-28;320;3;61860;28029;12.9;5.9
66;2021-03-29;1829;255;63689;28284;13.3;5.9
66;2021-03-30;2237;171;65926;28455;13.8;5.9
66;2021-03-31;1984;250;67910;28705;14.2;6.0
66;2021-04-01;2671;302;70581;29007;14.7;6.1
66;2021-04-02;2416;254;72997;29261;15.2;6.1
66;2021-04-03;1148;335;74145;29596;15.5;6.2
66;2021-04-04;107;127;74252;29723;15.5;6.2
66;2021-04-05;195;141;74447;29864;15.5;6.2
66;2021-04-06;1331;651;75778;30515;15.8;6.4
66;2021-04-07;1395;595;77173;31110;16.1;6.5
66;2021-04-08;2066;547;79239;31657;16.5;6.6
66;2021-04-09;3474;659;82713;32316;17.3;6.7
66;2021-04-10;2305;522;85018;32838;17.7;6.9
66;2021-04-11;1200;166;86218;33004;18.0;6.9
66;2021-04-12;2701;1022;88919;34026;18.6;7.1
66;2021-04-13;3608;1058;92527;35084;19.3;7.3
66;2021-04-14;3291;922;95818;36006;20.0;7.5
66;2021-04-15;3551;1047;99369;37053;20.7;7.7
66;2021-04-16;3591;1034;102960;38087;21.5;8.0
66;2021-04-17;2261;586;105221;38673;22.0;8.1
66;2021-04-18;1445;131;106666;38804;22.3;8.1
66;2021-04-19;2256;1121;108922;39925;22.7;8.3
66;2021-04-20;2370;1079;111292;41004;23.2;8.6
66;2021-04-21;2867;1179;114159;42183;23.8;8.8
66;2021-04-22;2656;1228;116815;43411;24.4;9.1
66;2021-04-23;2378;1234;119193;44645;24.9;9.3
66;2021-04-24;2744;873;121937;45518;25.5;9.5
66;2021-04-25;1207;267;123144;45785;25.7;9.6
66;2021-04-26;1995;1254;125139;47039;26.1;9.8
66;2021-04-27;2748;1298;127887;48337;26.7;10.1
66;2021-04-28;2419;1664;130306;50001;27.2;10.4
66;2021-04-29;2698;2125;133004;52126;27.8;10.9
66;2021-04-30;3055;1558;136059;53684;28.4;11.2
66;2021-05-01;2001;468;138060;54152;28.8;11.3
66;2021-05-02;1529;262;139589;54414;29.1;11.4
66;2021-05-03;2938;1109;142527;55523;29.8;11.6
66;2021-05-04;3170;1343;145697;56866;30.4;11.9
66;2021-05-05;3052;1538;148749;58404;31.1;12.2
66;2021-05-06;3758;2078;152507;60482;31.8;12.6
66;2021-05-07;2965;3082;155472;63564;32.5;13.3
66;2021-05-08;1731;1170;157203;64734;32.8;13.5
66;2021-05-09;887;1373;158090;66107;33.0;13.8
66;2021-05-10;1805;2974;159895;69081;33.4;14.4
66;2021-05-11;2739;3123;162634;72204;34.0;15.1
66;2021-05-12;2429;2569;165063;74773;34.5;15.6
66;2021-05-13;2255;1381;167318;76154;34.9;15.9
66;2021-05-14;2773;2116;170091;78270;35.5;16.3
66;2021-05-15;2329;1576;172420;79846;36.0;16.7
66;2021-05-16;2286;1250;174706;81096;36.5;16.9
66;2021-05-17;2049;1823;176755;82919;36.9;17.3
66;2021-05-18;3237;1806;179992;84725;37.6;17.7
66;2021-05-19;2877;1336;182869;86061;38.2;18.0
66;2021-05-20;4377;1442;187246;87503;39.1;18.3
66;2021-05-21;3268;1459;190514;88962;39.8;18.6
66;2021-05-22;3066;770;193580;89732;40.4;18.7
66;2021-05-23;1510;237;195090;89969;40.7;18.8
66;2021-05-24;1954;426;197044;90395;41.1;18.9
66;2021-05-25;2793;1689;199837;92084;41.7;19.2
66;2021-05-26;2781;1491;202618;93575;42.3;19.5
66;2021-05-27;3383;2251;206001;95826;43.0;20.0
66;2021-05-28;2680;3051;208681;98877;43.6;20.6
66;2021-05-29;2148;1519;210829;100396;44.0;21.0
66;2021-05-30;786;989;211615;101385;44.2;21.2
66;2021-05-31;2120;1786;213735;103171;44.6;21.5
66;2021-06-01;2624;2004;216359;105175;45.2;22.0
66;2021-06-02;2808;2338;219167;107513;45.8;22.4
66;2021-06-03;2479;2973;221646;110486;46.3;23.1
66;2021-06-04;1858;3352;223504;113838;46.7;23.8
66;2021-06-05;1408;2601;224912;116439;47.0;24.3
66;2021-06-06;292;1224;225204;117663;47.0;24.6
66;2021-06-07;1339;2958;226543;120621;47.3;25.2
66;2021-06-08;1739;3019;228282;123640;47.7;25.8
66;2021-06-09;2069;2785;230351;126425;48.1;26.4
66;2021-06-10;2081;2958;232432;129383;48.5;27.0
66;2021-06-11;2096;3866;234528;133249;49.0;27.8
66;2021-06-12;870;2411;235398;135660;49.1;28.3
66;2021-06-13;515;1334;235913;136994;49.3;28.6
66;2021-06-14;1360;3492;237273;140486;49.5;29.3
66;2021-06-15;2129;3572;239402;144058;50.0;30.1
66;2021-06-16;1787;3567;241189;147625;50.4;30.8
66;2021-06-17;2431;3604;243620;151229;50.9;31.6
66;2021-06-18;2226;3821;245846;155050;51.3;32.4
66;2021-06-19;1540;2318;247386;157368;51.6;32.9
66;2021-06-20;993;1259;248379;158627;51.9;33.1
66;2021-06-21;1162;2877;249541;161504;52.1;33.7
66;2021-06-22;1502;3761;251043;165265;52.4;34.5
66;2021-06-23;1323;3025;252366;168290;52.7;35.1
66;2021-06-24;1512;3231;253878;171521;53.0;35.8
66;2021-06-25;1396;3532;255274;175053;53.3;36.5
66;2021-06-26;963;2680;256237;177733;53.5;37.1
66;2021-06-27;677;1556;256914;179289;53.6;37.4
66;2021-06-28;976;2974;257890;182263;53.8;38.1
66;2021-06-29;1140;3793;259030;186056;54.1;38.8
66;2021-06-30;1274;3298;260304;189354;54.3;39.5
66;2021-07-01;1361;4041;261665;193395;54.6;40.4
66;2021-07-02;1312;3604;262977;196999;54.9;41.1
66;2021-07-03;1148;3893;264125;200892;55.1;41.9
66;2021-07-04;716;1790;264841;202682;55.3;42.3
66;2021-07-05;1090;2997;265931;205679;55.5;42.9
66;2021-07-06;1364;3777;267295;209456;55.8;43.7
66;2021-07-07;1383;3249;268678;212705;56.1;44.4
66;2021-07-08;1263;3377;269941;216082;56.4;45.1
66;2021-07-09;1418;3461;271359;219543;56.7;45.8
66;2021-07-10;998;2404;272357;221947;56.9;46.3
66;2021-07-11;538;1538;272895;223485;57.0;46.7
66;2021-07-12;985;3639;273880;227124;57.2;47.4
66;2021-07-13;2117;4263;275997;231387;57.6;48.3
66;2021-07-14;1938;1225;277935;232612;58.0;48.6
66;2021-07-15;2771;3103;280706;235715;58.6;49.2
66;2021-07-16;3298;3181;284004;238896;59.3;49.9
66;2021-07-17;2107;2027;286111;240923;59.7;50.3
66;2021-07-18;1193;1057;287304;241980;60.0;50.5
66;2021-07-19;2780;3074;290084;245054;60.6;51.2
66;2021-07-20;3625;2864;293709;247918;61.3;51.8
66;2021-07-21;3948;2929;297657;250847;62.1;52.4
66;2021-07-22;3820;2797;301477;253644;62.9;53.0
66;2021-07-23;3858;3017;305335;256661;63.7;53.6
66;2021-07-24;2581;1908;307916;258569;64.3;54.0
66;2021-07-25;2012;1233;309928;259802;64.7;54.2
66;2021-07-26;2761;2620;312689;262422;65.3;54.8
66;2021-07-27;3186;2878;315875;265300;65.9;55.4
66;2021-07-28;3328;2555;319203;267855;66.6;55.9
66;2021-07-29;3813;2510;323016;270365;67.4;56.4
66;2021-07-30;4171;2442;327187;272807;68.3;57.0
66;2021-07-31;2211;1701;329398;274508;68.8;57.3
66;2021-08-01;1812;887;331210;275395;69.1;57.5
66;2021-08-02;2257;1912;333467;277307;69.6;57.9
66;2021-08-03;2574;2047;336041;279354;70.2;58.3
66;2021-08-04;2530;1986;338571;281340;70.7;58.7
66;2021-08-05;2368;2478;340939;283818;71.2;59.3
67;2020-12-27;4;0;4;0;0.0;0.0
67;2020-12-28;3;0;7;0;0.0;0.0
67;2020-12-29;2;0;9;0;0.0;0.0
67;2020-12-30;0;0;9;0;0.0;0.0
67;2020-12-31;0;0;9;0;0.0;0.0
67;2021-01-01;3;0;12;0;0.0;0.0
67;2021-01-02;1;0;13;0;0.0;0.0
67;2021-01-03;1;0;14;0;0.0;0.0
67;2021-01-04;41;0;55;0;0.0;0.0
67;2021-01-05;167;0;222;0;0.0;0.0
67;2021-01-06;121;0;343;0;0.0;0.0
67;2021-01-07;235;1;578;1;0.1;0.0
67;2021-01-08;232;1;810;2;0.1;0.0
67;2021-01-09;113;1;923;3;0.1;0.0
67;2021-01-10;66;0;989;3;0.1;0.0
67;2021-01-11;182;1;1171;4;0.1;0.0
67;2021-01-12;511;1;1682;5;0.1;0.0
67;2021-01-13;653;2;2335;7;0.2;0.0
67;2021-01-14;1075;7;3410;14;0.3;0.0
67;2021-01-15;936;8;4346;22;0.4;0.0
67;2021-01-16;196;3;4542;25;0.4;0.0
67;2021-01-17;98;0;4640;25;0.4;0.0
67;2021-01-18;892;2;5532;27;0.5;0.0
67;2021-01-19;1423;5;6955;32;0.6;0.0
67;2021-01-20;1849;12;8804;44;0.8;0.0
67;2021-01-21;2201;9;11005;53;1.0;0.0
67;2021-01-22;1987;5;12992;58;1.1;0.0
67;2021-01-23;812;5;13804;63;1.2;0.0
67;2021-01-24;380;1;14184;64;1.3;0.0
67;2021-01-25;526;32;14710;96;1.3;0.0
67;2021-01-26;157;108;14867;204;1.3;0.0
67;2021-01-27;1391;90;16258;294;1.4;0.0
67;2021-01-28;3051;225;19309;519;1.7;0.0
67;2021-01-29;2024;157;21333;676;1.9;0.1
67;2021-01-30;1094;83;22427;759;2.0;0.1
67;2021-01-31;1161;29;23588;788;2.1;0.1
67;2021-02-01;3389;248;26977;1036;2.4;0.1
67;2021-02-02;2687;430;29664;1466;2.6;0.1
67;2021-02-03;1573;404;31237;1870;2.8;0.2
67;2021-02-04;1193;762;32430;2632;2.9;0.2
67;2021-02-05;1193;646;33623;3278;3.0;0.3
67;2021-02-06;788;146;34411;3424;3.0;0.3
67;2021-02-07;289;44;34700;3468;3.1;0.3
67;2021-02-08;837;451;35537;3919;3.1;0.3
67;2021-02-09;957;741;36494;4660;3.2;0.4
67;2021-02-10;928;796;37422;5456;3.3;0.5
67;2021-02-11;1149;1130;38571;6586;3.4;0.6
67;2021-02-12;1244;780;39815;7366;3.5;0.7
67;2021-02-13;765;280;40580;7646;3.6;0.7
67;2021-02-14;243;95;40823;7741;3.6;0.7
67;2021-02-15;778;837;41601;8578;3.7;0.8
67;2021-02-16;927;1148;42528;9726;3.8;0.9
67;2021-02-17;783;1196;43311;10922;3.8;1.0
67;2021-02-18;1398;2567;44709;13489;3.9;1.2
67;2021-02-19;1371;2115;46080;15604;4.1;1.4
67;2021-02-20;627;909;46707;16513;4.1;1.5
67;2021-02-21;208;1196;46915;17709;4.1;1.6
67;2021-02-22;1401;2170;48316;19879;4.3;1.8
67;2021-02-23;1459;1575;49775;21454;4.4;1.9
67;2021-02-24;1434;1055;51209;22509;4.5;2.0
67;2021-02-25;1614;1482;52823;23991;4.7;2.1
67;2021-02-26;2222;1408;55045;25399;4.9;2.2
67;2021-02-27;1255;788;56300;26187;5.0;2.3
67;2021-02-28;147;365;56447;26552;5.0;2.3
67;2021-03-01;636;1003;57083;27555;5.0;2.4
67;2021-03-02;889;1200;57972;28755;5.1;2.5
67;2021-03-03;1409;1283;59381;30038;5.2;2.7
67;2021-03-04;1957;1056;61338;31094;5.4;2.7
67;2021-03-05;3253;1100;64591;32194;5.7;2.8
67;2021-03-06;2334;773;66925;32967;5.9;2.9
67;2021-03-07;466;283;67391;33250;6.0;2.9
67;2021-03-08;1184;792;68575;34042;6.1;3.0
67;2021-03-09;2219;902;70794;34944;6.3;3.1
67;2021-03-10;2444;1188;73238;36132;6.5;3.2
67;2021-03-11;3203;1350;76441;37482;6.7;3.3
67;2021-03-12;5247;1367;81688;38849;7.2;3.4
67;2021-03-13;3996;883;85684;39732;7.6;3.5
67;2021-03-14;483;387;86167;40119;7.6;3.5
67;2021-03-15;2188;1156;88355;41275;7.8;3.6
67;2021-03-16;1545;1229;89900;42504;7.9;3.8
67;2021-03-17;2060;916;91960;43420;8.1;3.8
67;2021-03-18;2385;720;94345;44140;8.3;3.9
67;2021-03-19;3670;744;98015;44884;8.7;4.0
67;2021-03-20;3064;505;101079;45389;8.9;4.0
67;2021-03-21;332;14;101411;45403;9.0;4.0
67;2021-03-22;2328;777;103739;46180;9.2;4.1
67;2021-03-23;3395;765;107134;46945;9.5;4.1
67;2021-03-24;3903;804;111037;47749;9.8;4.2
67;2021-03-25;5311;528;116348;48277;10.3;4.3
67;2021-03-26;6868;471;123216;48748;10.9;4.3
67;2021-03-27;3921;332;127137;49080;11.2;4.3
67;2021-03-28;578;98;127715;49178;11.3;4.3
67;2021-03-29;3814;424;131529;49602;11.6;4.4
67;2021-03-30;4831;664;136360;50266;12.0;4.4
67;2021-03-31;4840;685;141200;50951;12.5;4.5
67;2021-04-01;5137;917;146337;51868;12.9;4.6
67;2021-04-02;1001;172;147338;52040;13.0;4.6
67;2021-04-03;1689;285;149027;52325;13.2;4.6
67;2021-04-04;325;5;149352;52330;13.2;4.6
67;2021-04-05;365;3;149717;52333;13.2;4.6
67;2021-04-06;3472;1171;153189;53504;13.5;4.7
67;2021-04-07;4533;1273;157722;54777;13.9;4.8
67;2021-04-08;5654;1395;163376;56172;14.4;5.0
67;2021-04-09;7106;1335;170482;57507;15.1;5.1
67;2021-04-10;4328;884;174810;58391;15.4;5.2
67;2021-04-11;855;426;175665;58817;15.5;5.2
67;2021-04-12;3879;1400;179544;60217;15.9;5.3
67;2021-04-13;4891;1573;184435;61790;16.3;5.5
67;2021-04-14;5242;1892;189677;63682;16.7;5.6
67;2021-04-15;6071;2100;195748;65782;17.3;5.8
67;2021-04-16;7830;2400;203578;68182;18.0;6.0
67;2021-04-17;4005;1577;207583;69759;18.3;6.2
67;2021-04-18;1113;646;208696;70405;18.4;6.2
67;2021-04-19;3628;2139;212324;72544;18.7;6.4
67;2021-04-20;4255;1918;216579;74462;19.1;6.6
67;2021-04-21;4068;2512;220647;76974;19.5;6.8
67;2021-04-22;4474;2902;225121;79876;19.9;7.1
67;2021-04-23;5237;2990;230358;82866;20.3;7.3
67;2021-04-24;3099;2019;233457;84885;20.6;7.5
67;2021-04-25;1028;450;234485;85335;20.7;7.5
67;2021-04-26;3188;2615;237673;87950;21.0;7.8
67;2021-04-27;4021;2922;241694;90872;21.3;8.0
67;2021-04-28;4248;3430;245942;94302;21.7;8.3
67;2021-04-29;5123;3512;251065;97814;22.2;8.6
67;2021-04-30;7175;2482;258240;100296;22.8;8.9
67;2021-05-01;2680;782;260920;101078;23.0;8.9
67;2021-05-02;2180;672;263100;101750;23.2;9.0
67;2021-05-03;5560;2612;268660;104362;23.7;9.2
67;2021-05-04;5850;3607;274510;107969;24.2;9.5
67;2021-05-05;5208;4198;279718;112167;24.7;9.9
67;2021-05-06;6712;4914;286430;117081;25.3;10.3
67;2021-05-07;6427;6913;292857;123994;25.9;10.9
67;2021-05-08;3570;1019;296427;125013;26.2;11.0
67;2021-05-09;3371;598;299798;125611;26.5;11.1
67;2021-05-10;4693;4530;304491;130141;26.9;11.5
67;2021-05-11;5647;4927;310138;135068;27.4;11.9
67;2021-05-12;6589;4845;316727;139913;28.0;12.4
67;2021-05-13;7306;1698;324033;141611;28.6;12.5
67;2021-05-14;8880;5372;332913;146983;29.4;13.0
67;2021-05-15;8188;3654;341101;150637;30.1;13.3
67;2021-05-16;6172;974;347273;151611;30.7;13.4
67;2021-05-17;5689;3903;352962;155514;31.2;13.7
67;2021-05-18;6900;3980;359862;159494;31.8;14.1
67;2021-05-19;7373;4172;367235;163666;32.4;14.5
67;2021-05-20;8688;4220;375923;167886;33.2;14.8
67;2021-05-21;8160;5848;384083;173734;33.9;15.3
67;2021-05-22;5937;3429;390020;177163;34.4;15.6
67;2021-05-23;2657;593;392677;177756;34.7;15.7
67;2021-05-24;4416;861;397093;178617;35.1;15.8
67;2021-05-25;5416;4762;402509;183379;35.5;16.2
67;2021-05-26;6056;4881;408565;188260;36.1;16.6
67;2021-05-27;7307;4894;415872;193154;36.7;17.1
67;2021-05-28;7963;6492;423835;199646;37.4;17.6
67;2021-05-29;6645;3874;430480;203520;38.0;18.0
67;2021-05-30;1146;810;431626;204330;38.1;18.0
67;2021-05-31;6401;4055;438027;208385;38.7;18.4
67;2021-06-01;7329;4399;445356;212784;39.3;18.8
67;2021-06-02;8056;4175;453412;216959;40.0;19.2
67;2021-06-03;8834;4863;462246;221822;40.8;19.6
67;2021-06-04;8590;6128;470836;227950;41.6;20.1
67;2021-06-05;6555;3986;477391;231936;42.1;20.5
67;2021-06-06;3476;872;480867;232808;42.5;20.6
67;2021-06-07;7414;4260;488281;237068;43.1;20.9
67;2021-06-08;8627;4922;496908;241990;43.9;21.4
67;2021-06-09;9261;4802;506169;246792;44.7;21.8
67;2021-06-10;9771;5016;515940;251808;45.6;22.2
67;2021-06-11;8064;8329;524004;260137;46.3;23.0
67;2021-06-12;6786;5197;530790;265334;46.9;23.4
67;2021-06-13;3104;1041;533894;266375;47.1;23.5
67;2021-06-14;5508;6459;539402;272834;47.6;24.1
67;2021-06-15;6686;6746;546088;279580;48.2;24.7
67;2021-06-16;6946;6696;553034;286276;48.8;25.3
67;2021-06-17;7269;9049;560303;295325;49.5;26.1
67;2021-06-18;7599;8506;567902;303831;50.1;26.8
67;2021-06-19;6379;5960;574281;309791;50.7;27.4
67;2021-06-20;1451;1412;575732;311203;50.8;27.5
67;2021-06-21;4264;6763;579996;317966;51.2;28.1
67;2021-06-22;4234;9094;584230;327060;51.6;28.9
67;2021-06-23;5261;8164;589491;335224;52.0;29.6
67;2021-06-24;4515;9090;594006;344314;52.4;30.4
67;2021-06-25;5331;9946;599337;354260;52.9;31.3
67;2021-06-26;3458;9104;602795;363364;53.2;32.1
67;2021-06-27;1018;3521;603813;366885;53.3;32.4
67;2021-06-28;2846;8734;606659;375619;53.6;33.2
67;2021-06-29;2892;8598;609551;384217;53.8;33.9
67;2021-06-30;3375;8733;612926;392950;54.1;34.7
67;2021-07-01;3590;8413;616516;401363;54.4;35.4
67;2021-07-02;3727;10932;620243;412295;54.8;36.4
67;2021-07-03;2974;7744;623217;420039;55.0;37.1
67;2021-07-04;763;1869;623980;421908;55.1;37.3
67;2021-07-05;2609;8249;626589;430157;55.3;38.0
67;2021-07-06;3048;8437;629637;438594;55.6;38.7
67;2021-07-07;3900;8737;633537;447331;55.9;39.5
67;2021-07-08;4182;7781;637719;455112;56.3;40.2
67;2021-07-09;3751;11372;641470;466484;56.6;41.2
67;2021-07-10;2845;8207;644315;474691;56.9;41.9
67;2021-07-11;935;1992;645250;476683;57.0;42.1
67;2021-07-12;2449;9723;647699;486406;57.2;42.9
67;2021-07-13;4083;9887;651782;496293;57.5;43.8
67;2021-07-14;3474;4398;655256;500691;57.9;44.2
67;2021-07-15;5101;12218;660357;512909;58.3;45.3
67;2021-07-16;4800;12292;665157;525201;58.7;46.4
67;2021-07-17;3718;8831;668875;534032;59.1;47.2
67;2021-07-18;1446;2545;670321;536577;59.2;47.4
67;2021-07-19;4594;9736;674915;546313;59.6;48.2
67;2021-07-20;5716;9818;680631;556131;60.1;49.1
67;2021-07-21;5791;10640;686422;566771;60.6;50.0
67;2021-07-22;6387;10223;692809;576994;61.2;50.9
67;2021-07-23;7334;11189;700143;588183;61.8;51.9
67;2021-07-24;5400;7572;705543;595755;62.3;52.6
67;2021-07-25;2301;1961;707844;597716;62.5;52.8
67;2021-07-26;4951;7241;712795;604957;62.9;53.4
67;2021-07-27;6519;7298;719314;612255;63.5;54.1
67;2021-07-28;7501;7185;726815;619440;64.2;54.7
67;2021-07-29;8305;6419;735120;625859;64.9;55.3
67;2021-07-30;8573;7286;743693;633145;65.7;55.9
67;2021-07-31;5041;4841;748734;637986;66.1;56.3
67;2021-08-01;2429;1402;751163;639388;66.3;56.5
67;2021-08-02;6293;5060;757456;644448;66.9;56.9
67;2021-08-03;7256;4684;764712;649132;67.5;57.3
67;2021-08-04;6826;4574;771538;653706;68.1;57.7
67;2021-08-05;5674;4166;777212;657872;68.6;58.1
68;2020-12-27;0;0;0;0;0.0;0.0
68;2020-12-28;0;0;0;0;0.0;0.0
68;2020-12-29;0;0;0;0;0.0;0.0
68;2020-12-30;0;0;0;0;0.0;0.0
68;2020-12-31;0;0;0;0;0.0;0.0
68;2021-01-01;0;0;0;0;0.0;0.0
68;2021-01-02;0;0;0;0;0.0;0.0
68;2021-01-03;0;0;0;0;0.0;0.0
68;2021-01-04;1;0;1;0;0.0;0.0
68;2021-01-05;11;0;12;0;0.0;0.0
68;2021-01-06;244;1;256;1;0.0;0.0
68;2021-01-07;75;0;331;1;0.0;0.0
68;2021-01-08;118;1;449;2;0.1;0.0
68;2021-01-09;20;0;469;2;0.1;0.0
68;2021-01-10;1;0;470;2;0.1;0.0
68;2021-01-11;82;0;552;2;0.1;0.0
68;2021-01-12;386;1;938;3;0.1;0.0
68;2021-01-13;703;2;1641;5;0.2;0.0
68;2021-01-14;372;2;2013;7;0.3;0.0
68;2021-01-15;204;1;2217;8;0.3;0.0
68;2021-01-16;1;0;2218;8;0.3;0.0
68;2021-01-17;0;0;2218;8;0.3;0.0
68;2021-01-18;379;5;2597;13;0.3;0.0
68;2021-01-19;559;5;3156;18;0.4;0.0
68;2021-01-20;706;9;3862;27;0.5;0.0
68;2021-01-21;1393;12;5255;39;0.7;0.0
68;2021-01-22;1499;12;6754;51;0.9;0.0
68;2021-01-23;215;3;6969;54;0.9;0.0
68;2021-01-24;697;0;7666;54;1.0;0.0
68;2021-01-25;1388;46;9054;100;1.2;0.0
68;2021-01-26;1553;80;10607;180;1.4;0.0
68;2021-01-27;2765;140;13372;320;1.8;0.0
68;2021-01-28;2347;57;15719;377;2.1;0.0
68;2021-01-29;1506;115;17225;492;2.3;0.1
68;2021-01-30;165;3;17390;495;2.3;0.1
68;2021-01-31;0;0;17390;495;2.3;0.1
68;2021-02-01;737;103;18127;598;2.4;0.1
68;2021-02-02;867;306;18994;904;2.5;0.1
68;2021-02-03;998;620;19992;1524;2.6;0.2
68;2021-02-04;1000;324;20992;1848;2.8;0.2
68;2021-02-05;946;236;21938;2084;2.9;0.3
68;2021-02-06;137;1;22075;2085;2.9;0.3
68;2021-02-07;1;16;22076;2101;2.9;0.3
68;2021-02-08;893;21;22969;2122;3.0;0.3
68;2021-02-09;1357;45;24326;2167;3.2;0.3
68;2021-02-10;1452;61;25778;2228;3.4;0.3
68;2021-02-11;1487;471;27265;2699;3.6;0.4
68;2021-02-12;1547;453;28812;3152;3.8;0.4
68;2021-02-13;132;1;28944;3153;3.8;0.4
68;2021-02-14;57;231;29001;3384;3.8;0.4
68;2021-02-15;662;1088;29663;4472;3.9;0.6
68;2021-02-16;863;1369;30526;5841;4.0;0.8
68;2021-02-17;1284;2133;31810;7974;4.2;1.0
68;2021-02-18;1641;2049;33451;10023;4.4;1.3
68;2021-02-19;985;1369;34436;11392;4.5;1.5
68;2021-02-20;93;125;34529;11517;4.5;1.5
68;2021-02-21;1;40;34530;11557;4.5;1.5
68;2021-02-22;446;798;34976;12355;4.6;1.6
68;2021-02-23;639;1060;35615;13415;4.7;1.8
68;2021-02-24;853;1157;36468;14572;4.8;1.9
68;2021-02-25;1209;1248;37677;15820;4.9;2.1
68;2021-02-26;1198;986;38875;16806;5.1;2.2
68;2021-02-27;547;175;39422;16981;5.2;2.2
68;2021-02-28;12;1;39434;16982;5.2;2.2
68;2021-03-01;939;767;40373;17749;5.3;2.3
68;2021-03-02;1215;924;41588;18673;5.4;2.4
68;2021-03-03;1591;967;43179;19640;5.7;2.6
68;2021-03-04;1989;1042;45168;20682;5.9;2.7
68;2021-03-05;2354;1048;47522;21730;6.2;2.8
68;2021-03-06;2283;244;49805;21974;6.5;2.9
68;2021-03-07;839;103;50644;22077;6.6;2.9
68;2021-03-08;1473;978;52117;23055;6.8;3.0
68;2021-03-09;1692;1328;53809;24383;7.1;3.2
68;2021-03-10;1961;1797;55770;26180;7.3;3.4
68;2021-03-11;2637;1911;58407;28091;7.7;3.7
68;2021-03-12;2628;1415;61035;29506;8.0;3.9
68;2021-03-13;3342;243;64377;29749;8.4;3.9
68;2021-03-14;1542;63;65919;29812;8.6;3.9
68;2021-03-15;1793;622;67712;30434;8.9;4.0
68;2021-03-16;1998;601;69710;31035;9.1;4.1
68;2021-03-17;1955;725;71665;31760;9.4;4.2
68;2021-03-18;2219;948;73884;32708;9.7;4.3
68;2021-03-19;3084;734;76968;33442;10.1;4.4
68;2021-03-20;973;122;77941;33564;10.2;4.4
68;2021-03-21;68;1;78009;33565;10.2;4.4
68;2021-03-22;1965;593;79974;34158;10.5;4.5
68;2021-03-23;2859;613;82833;34771;10.9;4.6
68;2021-03-24;3174;810;86007;35581;11.3;4.7
68;2021-03-25;3501;786;89508;36367;11.7;4.8
68;2021-03-26;3892;713;93400;37080;12.2;4.9
68;2021-03-27;1102;164;94502;37244;12.4;4.9
68;2021-03-28;55;3;94557;37247;12.4;4.9
68;2021-03-29;2264;1378;96821;38625;12.7;5.1
68;2021-03-30;2934;1297;99755;39922;13.1;5.2
68;2021-03-31;2641;1363;102396;41285;13.4;5.4
68;2021-04-01;2748;1545;105144;42830;13.8;5.6
68;2021-04-02;244;87;105388;42917;13.8;5.6
68;2021-04-03;240;123;105628;43040;13.8;5.6
68;2021-04-04;4;0;105632;43040;13.8;5.6
68;2021-04-05;48;2;105680;43042;13.8;5.6
68;2021-04-06;1794;1326;107474;44368;14.1;5.8
68;2021-04-07;2584;1532;110058;45900;14.4;6.0
68;2021-04-08;3231;1498;113289;47398;14.8;6.2
68;2021-04-09;4197;1522;117486;48920;15.4;6.4
68;2021-04-10;1200;1975;118686;50895;15.6;6.7
68;2021-04-11;126;1318;118812;52213;15.6;6.8
68;2021-04-12;2666;1635;121478;53848;15.9;7.1
68;2021-04-13;2760;2109;124238;55957;16.3;7.3
68;2021-04-14;3602;2268;127840;58225;16.8;7.6
68;2021-04-15;4047;2154;131887;60379;17.3;7.9
68;2021-04-16;3938;2076;135825;62455;17.8;8.2
68;2021-04-17;1073;440;136898;62895;17.9;8.2
68;2021-04-18;85;9;136983;62904;17.9;8.2
68;2021-04-19;2359;1836;139342;64740;18.3;8.5
68;2021-04-20;2438;2325;141780;67065;18.6;8.8
68;2021-04-21;2830;2479;144610;69544;18.9;9.1
68;2021-04-22;3285;1976;147895;71520;19.4;9.4
68;2021-04-23;3411;2074;151306;73594;19.8;9.6
68;2021-04-24;843;486;152149;74080;19.9;9.7
68;2021-04-25;214;20;152363;74100;20.0;9.7
68;2021-04-26;2329;2109;154692;76209;20.3;10.0
68;2021-04-27;2599;2216;157291;78425;20.6;10.3
68;2021-04-28;3573;1763;160864;80188;21.1;10.5
68;2021-04-29;4165;1747;165029;81935;21.6;10.7
68;2021-04-30;4833;1366;169862;83301;22.3;10.9
68;2021-05-01;946;121;170808;83422;22.4;10.9
68;2021-05-02;731;70;171539;83492;22.5;10.9
68;2021-05-03;3621;1816;175160;85308;23.0;11.2
68;2021-05-04;3935;2362;179095;87670;23.5;11.5
68;2021-05-05;3633;3238;182728;90908;23.9;11.9
68;2021-05-06;4805;2865;187533;93773;24.6;12.3
68;2021-05-07;4517;2908;192050;96681;25.2;12.7
68;2021-05-08;1671;211;193721;96892;25.4;12.7
68;2021-05-09;1077;107;194798;96999;25.5;12.7
68;2021-05-10;3157;3720;197955;100719;25.9;13.2
68;2021-05-11;4716;3618;202671;104337;26.6;13.7
68;2021-05-12;5781;3291;208452;107628;27.3;14.1
68;2021-05-13;4764;842;213216;108470;27.9;14.2
68;2021-05-14;5960;2134;219176;110604;28.7;14.5
68;2021-05-15;3558;909;222734;111513;29.2;14.6
68;2021-05-16;669;121;223403;111634;29.3;14.6
68;2021-05-17;4449;2499;227852;114133;29.9;15.0
68;2021-05-18;6138;2304;233990;116437;30.7;15.3
68;2021-05-19;5867;2887;239857;119324;31.4;15.6
68;2021-05-20;5928;2421;245785;121745;32.2;16.0
68;2021-05-21;5778;2870;251563;124615;33.0;16.3
68;2021-05-22;2578;925;254141;125540;33.3;16.4
68;2021-05-23;15;17;254156;125557;33.3;16.5
68;2021-05-24;2307;968;256463;126525;33.6;16.6
68;2021-05-25;4344;3437;260807;129962;34.2;17.0
68;2021-05-26;4883;3381;265690;133343;34.8;17.5
68;2021-05-27;5407;3399;271097;136742;35.5;17.9
68;2021-05-28;5619;3730;276716;140472;36.3;18.4
68;2021-05-29;1537;1186;278253;141658;36.5;18.6
68;2021-05-30;41;46;278294;141704;36.5;18.6
68;2021-05-31;5161;2364;283455;144068;37.1;18.9
68;2021-06-01;5988;2802;289443;146870;37.9;19.2
68;2021-06-02;4887;3004;294330;149874;38.6;19.6
68;2021-06-03;5939;3099;300269;152973;39.3;20.0
68;2021-06-04;4892;3304;305161;156277;40.0;20.5
68;2021-06-05;779;1169;305940;157446;40.1;20.6
68;2021-06-06;67;114;306007;157560;40.1;20.6
68;2021-06-07;4756;3037;310763;160597;40.7;21.0
68;2021-06-08;4942;3561;315705;164158;41.4;21.5
68;2021-06-09;4988;3439;320693;167597;42.0;22.0
68;2021-06-10;5201;3139;325894;170736;42.7;22.4
68;2021-06-11;5058;4150;330952;174886;43.4;22.9
68;2021-06-12;3035;1765;333987;176651;43.8;23.1
68;2021-06-13;515;682;334502;177333;43.8;23.2
68;2021-06-14;2515;4393;337017;181726;44.2;23.8
68;2021-06-15;3110;4723;340127;186449;44.6;24.4
68;2021-06-16;3386;4434;343513;190883;45.0;25.0
68;2021-06-17;2359;4459;345872;195342;45.3;25.6
68;2021-06-18;3350;5178;349222;200520;45.8;26.3
68;2021-06-19;2253;2169;351475;202689;46.1;26.6
68;2021-06-20;258;893;351733;203582;46.1;26.7
68;2021-06-21;2061;5153;353794;208735;46.4;27.3
68;2021-06-22;1901;5176;355695;213911;46.6;28.0
68;2021-06-23;2317;5742;358012;219653;46.9;28.8
68;2021-06-24;2153;4894;360165;224547;47.2;29.4
68;2021-06-25;2286;6656;362451;231203;47.5;30.3
68;2021-06-26;1298;2604;363749;233807;47.7;30.6
68;2021-06-27;151;880;363900;234687;47.7;30.8
68;2021-06-28;1601;6444;365501;241131;47.9;31.6
68;2021-06-29;1537;6635;367038;247766;48.1;32.5
68;2021-06-30;1793;6554;368831;254320;48.3;33.3
68;2021-07-01;2087;5349;370918;259669;48.6;34.0
68;2021-07-02;2095;6483;373013;266152;48.9;34.9
68;2021-07-03;977;1935;373990;268087;49.0;35.1
68;2021-07-04;242;201;374232;268288;49.0;35.2
68;2021-07-05;1455;5525;375687;273813;49.2;35.9
68;2021-07-06;1995;5883;377682;279696;49.5;36.6
68;2021-07-07;2454;4976;380136;284672;49.8;37.3
68;2021-07-08;2430;4745;382566;289417;50.1;37.9
68;2021-07-09;2091;7363;384657;296780;50.4;38.9
68;2021-07-10;1019;2002;385676;298782;50.5;39.1
68;2021-07-11;145;155;385821;298937;50.6;39.2
68;2021-07-12;1636;6781;387457;305718;50.8;40.1
68;2021-07-13;2899;6550;390356;312268;51.1;40.9
68;2021-07-14;1840;978;392196;313246;51.4;41.0
68;2021-07-15;3178;6651;395374;319897;51.8;41.9
68;2021-07-16;3801;6759;399175;326656;52.3;42.8
68;2021-07-17;3354;2297;402529;328953;52.7;43.1
68;2021-07-18;1053;229;403582;329182;52.9;43.1
68;2021-07-19;3037;6084;406619;335266;53.3;43.9
68;2021-07-20;3987;5665;410606;340931;53.8;44.7
68;2021-07-21;4328;5815;414934;346746;54.4;45.4
68;2021-07-22;4163;4832;419097;351578;54.9;46.1
68;2021-07-23;5016;5742;424113;357320;55.6;46.8
68;2021-07-24;3295;2120;427408;359440;56.0;47.1
68;2021-07-25;818;527;428226;359967;56.1;47.2
68;2021-07-26;4746;4432;432972;364399;56.7;47.7
68;2021-07-27;6333;3731;439305;368130;57.6;48.2
68;2021-07-28;6833;3861;446138;371991;58.5;48.7
68;2021-07-29;6373;3388;452511;375379;59.3;49.2
68;2021-07-30;6314;4360;458825;379739;60.1;49.8
68;2021-07-31;3901;1412;462726;381151;60.6;49.9
68;2021-08-01;1644;471;464370;381622;60.8;50.0
68;2021-08-02;4569;3116;468939;384738;61.4;50.4
68;2021-08-03;3519;2425;472458;387163;61.9;50.7
68;2021-08-04;3115;2671;475573;389834;62.3;51.1
68;2021-08-05;2717;2615;478290;392449;62.7;51.4
69;2020-12-27;1;0;1;0;0.0;0.0
69;2020-12-28;7;0;8;0;0.0;0.0
69;2020-12-29;5;0;13;0;0.0;0.0
69;2020-12-30;6;0;19;0;0.0;0.0
69;2020-12-31;10;0;29;0;0.0;0.0
69;2021-01-01;2;0;31;0;0.0;0.0
69;2021-01-02;1;0;32;0;0.0;0.0
69;2021-01-03;1;0;33;0;0.0;0.0
69;2021-01-04;10;0;43;0;0.0;0.0
69;2021-01-05;215;0;258;0;0.0;0.0
69;2021-01-06;509;0;767;0;0.0;0.0
69;2021-01-07;811;0;1578;0;0.1;0.0
69;2021-01-08;826;0;2404;0;0.1;0.0
69;2021-01-09;36;0;2440;0;0.1;0.0
69;2021-01-10;2;1;2442;1;0.1;0.0
69;2021-01-11;1133;3;3575;4;0.2;0.0
69;2021-01-12;1396;7;4971;11;0.3;0.0
69;2021-01-13;1392;4;6363;15;0.3;0.0
69;2021-01-14;2271;21;8634;36;0.5;0.0
69;2021-01-15;1826;8;10460;44;0.6;0.0
69;2021-01-16;928;3;11388;47;0.6;0.0
69;2021-01-17;260;2;11648;49;0.6;0.0
69;2021-01-18;1693;17;13341;66;0.7;0.0
69;2021-01-19;3507;33;16848;99;0.9;0.0
69;2021-01-20;4445;27;21293;126;1.1;0.0
69;2021-01-21;4038;24;25331;150;1.4;0.0
69;2021-01-22;3154;20;28485;170;1.5;0.0
69;2021-01-23;1281;4;29766;174;1.6;0.0
69;2021-01-24;101;1;29867;175;1.6;0.0
69;2021-01-25;2234;40;32101;215;1.7;0.0
69;2021-01-26;2560;88;34661;303;1.8;0.0
69;2021-01-27;2356;178;37017;481;2.0;0.0
69;2021-01-28;2234;374;39251;855;2.1;0.0
69;2021-01-29;2108;284;41359;1139;2.2;0.1
69;2021-01-30;889;2;42248;1141;2.3;0.1
69;2021-01-31;65;0;42313;1141;2.3;0.1
69;2021-02-01;1112;401;43425;1542;2.3;0.1
69;2021-02-02;1547;411;44972;1953;2.4;0.1
69;2021-02-03;1442;535;46414;2488;2.5;0.1
69;2021-02-04;1788;954;48202;3442;2.6;0.2
69;2021-02-05;819;818;49021;4260;2.6;0.2
69;2021-02-06;365;54;49386;4314;2.6;0.2
69;2021-02-07;0;0;49386;4314;2.6;0.2
69;2021-02-08;1133;1078;50519;5392;2.7;0.3
69;2021-02-09;2049;2109;52568;7501;2.8;0.4
69;2021-02-10;1852;2651;54420;10152;2.9;0.5
69;2021-02-11;1862;3292;56282;13444;3.0;0.7
69;2021-02-12;1900;2113;58182;15557;3.1;0.8
69;2021-02-13;458;803;58640;16360;3.1;0.9
69;2021-02-14;89;40;58729;16400;3.1;0.9
69;2021-02-15;1014;1771;59743;18171;3.2;1.0
69;2021-02-16;984;2449;60727;20620;3.2;1.1
69;2021-02-17;1026;2395;61753;23015;3.3;1.2
69;2021-02-18;967;2341;62720;25356;3.3;1.4
69;2021-02-19;894;1894;63614;27250;3.4;1.5
69;2021-02-20;324;913;63938;28163;3.4;1.5
69;2021-02-21;52;68;63990;28231;3.4;1.5
69;2021-02-22;609;2099;64599;30330;3.4;1.6
69;2021-02-23;740;2228;65339;32558;3.5;1.7
69;2021-02-24;973;2250;66312;34808;3.5;1.9
69;2021-02-25;2215;2679;68527;37487;3.7;2.0
69;2021-02-26;2776;1923;71303;39410;3.8;2.1
69;2021-02-27;924;573;72227;39983;3.8;2.1
69;2021-02-28;148;103;72375;40086;3.9;2.1
69;2021-03-01;2162;906;74537;40992;4.0;2.2
69;2021-03-02;3294;1393;77831;42385;4.1;2.3
69;2021-03-03;3669;1213;81500;43598;4.3;2.3
69;2021-03-04;4875;1261;86375;44859;4.6;2.4
69;2021-03-05;5866;1248;92241;46107;4.9;2.5
69;2021-03-06;3415;410;95656;46517;5.1;2.5
69;2021-03-07;639;41;96295;46558;5.1;2.5
69;2021-03-08;2953;1114;99248;47672;5.3;2.5
69;2021-03-09;4610;1249;103858;48921;5.5;2.6
69;2021-03-10;5063;1035;108921;49956;5.8;2.7
69;2021-03-11;6598;1019;115519;50975;6.2;2.7
69;2021-03-12;8854;1186;124373;52161;6.6;2.8
69;2021-03-13;4923;226;129296;52387;6.9;2.8
69;2021-03-14;2742;133;132038;52520;7.0;2.8
69;2021-03-15;4807;694;136845;53214;7.3;2.8
69;2021-03-16;3812;633;140657;53847;7.5;2.9
69;2021-03-17;3948;862;144605;54709;7.7;2.9
69;2021-03-18;4966;1600;149571;56309;8.0;3.0
69;2021-03-19;6681;1051;156252;57360;8.3;3.1
69;2021-03-20;3585;268;159837;57628;8.5;3.1
69;2021-03-21;1973;91;161810;57719;8.6;3.1
69;2021-03-22;4546;804;166356;58523;8.9;3.1
69;2021-03-23;7358;809;173714;59332;9.3;3.2
69;2021-03-24;6452;987;180166;60319;9.6;3.2
69;2021-03-25;8583;1098;188749;61417;10.1;3.3
69;2021-03-26;8812;1230;197561;62647;10.5;3.3
69;2021-03-27;3151;786;200712;63433;10.7;3.4
69;2021-03-28;2212;180;202924;63613;10.8;3.4
69;2021-03-29;4095;2191;207019;65804;11.0;3.5
69;2021-03-30;7642;2509;214661;68313;11.4;3.6
69;2021-03-31;6352;3160;221013;71473;11.8;3.8
69;2021-04-01;8444;2712;229457;74185;12.2;4.0
69;2021-04-02;8311;3104;237768;77289;12.7;4.1
69;2021-04-03;5423;2158;243191;79447;13.0;4.2
69;2021-04-04;6607;549;249798;79996;13.3;4.3
69;2021-04-05;6191;816;255989;80812;13.6;4.3
69;2021-04-06;5105;3480;261094;84292;13.9;4.5
69;2021-04-07;5162;3885;266256;88177;14.2;4.7
69;2021-04-08;6425;4057;272681;92234;14.5;4.9
69;2021-04-09;9164;3774;281845;96008;15.0;5.1
69;2021-04-10;3050;2499;284895;98507;15.2;5.3
69;2021-04-11;2039;1898;286934;100405;15.3;5.4
69;2021-04-12;5467;3574;292401;103979;15.6;5.5
69;2021-04-13;7069;4113;299470;108092;16.0;5.8
69;2021-04-14;6712;4146;306182;112238;16.3;6.0
69;2021-04-15;7924;4576;314106;116814;16.7;6.2
69;2021-04-16;7860;4492;321966;121306;17.2;6.5
69;2021-04-17;5036;2315;327002;123621;17.4;6.6
69;2021-04-18;1717;1793;328719;125414;17.5;6.7
69;2021-04-19;7019;3771;335738;129185;17.9;6.9
69;2021-04-20;6484;4742;342222;133927;18.2;7.1
69;2021-04-21;5687;4408;347909;138335;18.5;7.4
69;2021-04-22;6426;5433;354335;143768;18.9;7.7
69;2021-04-23;6726;4876;361061;148644;19.2;7.9
69;2021-04-24;3154;2021;364215;150665;19.4;8.0
69;2021-04-25;2118;1547;366333;152212;19.5;8.1
69;2021-04-26;4497;3879;370830;156091;19.8;8.3
69;2021-04-27;6514;5328;377344;161419;20.1;8.6
69;2021-04-28;6272;4848;383616;166267;20.4;8.9
69;2021-04-29;6696;5352;390312;171619;20.8;9.1
69;2021-04-30;6931;6167;397243;177786;21.2;9.5
69;2021-05-01;3297;644;400540;178430;21.4;9.5
69;2021-05-02;1627;5889;402167;184319;21.4;9.8
69;2021-05-03;5858;8245;408025;192564;21.7;10.3
69;2021-05-04;7602;8166;415627;200730;22.2;10.7
69;2021-05-05;11211;5640;426838;206370;22.8;11.0
69;2021-05-06;12474;6276;439312;212646;23.4;11.3
69;2021-05-07;11687;7156;450999;219802;24.0;11.7
69;2021-05-08;4302;1650;455301;221452;24.3;11.8
69;2021-05-09;6634;2677;461935;224129;24.6;11.9
69;2021-05-10;6933;6059;468868;230188;25.0;12.3
69;2021-05-11;9827;7042;478695;237230;25.5;12.6
69;2021-05-12;12461;6808;491156;244038;26.2;13.0
69;2021-05-13;10836;2559;501992;246597;26.8;13.1
69;2021-05-14;12585;5224;514577;251821;27.4;13.4
69;2021-05-15;9142;2601;523719;254422;27.9;13.6
69;2021-05-16;8408;1875;532127;256297;28.4;13.7
69;2021-05-17;11305;5652;543432;261949;29.0;14.0
69;2021-05-18;13226;6400;556658;268349;29.7;14.3
69;2021-05-19;13699;5889;570357;274238;30.4;14.6
69;2021-05-20;11378;6089;581735;280327;31.0;14.9
69;2021-05-21;11041;6568;592776;286895;31.6;15.3
69;2021-05-22;5578;2575;598354;289470;31.9;15.4
69;2021-05-23;4569;1545;602923;291015;32.1;15.5
69;2021-05-24;8434;1864;611357;292879;32.6;15.6
69;2021-05-25;9743;6183;621100;299062;33.1;15.9
69;2021-05-26;10281;6116;631381;305178;33.7;16.3
69;2021-05-27;10434;6778;641815;311956;34.2;16.6
69;2021-05-28;11611;8745;653426;320701;34.8;17.1
69;2021-05-29;7389;6034;660815;326735;35.2;17.4
69;2021-05-30;7384;3170;668199;329905;35.6;17.6
69;2021-05-31;10960;6376;679159;336281;36.2;17.9
69;2021-06-01;12814;7521;691973;343802;36.9;18.3
69;2021-06-02;14871;6710;706844;350512;37.7;18.7
69;2021-06-03;16629;7428;723473;357940;38.6;19.1
69;2021-06-04;16198;8552;739671;366492;39.4;19.5
69;2021-06-05;10106;3413;749777;369905;40.0;19.7
69;2021-06-06;7486;1710;757263;371615;40.4;19.8
69;2021-06-07;12813;7043;770076;378658;41.0;20.2
69;2021-06-08;16373;8273;786449;386931;41.9;20.6
69;2021-06-09;15220;7364;801669;394295;42.7;21.0
69;2021-06-10;16266;7320;817935;401615;43.6;21.4
69;2021-06-11;16635;9693;834570;411308;44.5;21.9
69;2021-06-12;8518;4189;843088;415497;44.9;22.1
69;2021-06-13;5621;2142;848709;417639;45.2;22.3
69;2021-06-14;8577;9101;857286;426740;45.7;22.7
69;2021-06-15;10933;11021;868219;437761;46.3;23.3
69;2021-06-16;11335;12323;879554;450084;46.9;24.0
69;2021-06-17;11446;13251;891000;463335;47.5;24.7
69;2021-06-18;11937;14772;902937;478107;48.1;25.5
69;2021-06-19;6820;8345;909757;486452;48.5;25.9
69;2021-06-20;5270;4763;915027;491215;48.8;26.2
69;2021-06-21;6515;12129;921542;503344;49.1;26.8
69;2021-06-22;7195;13836;928737;517180;49.5;27.6
69;2021-06-23;8318;13033;937055;530213;49.9;28.3
69;2021-06-24;9270;13734;946325;543947;50.4;29.0
69;2021-06-25;7053;16310;953378;560257;50.8;29.9
69;2021-06-26;3933;9074;957311;569331;51.0;30.3
69;2021-06-27;3286;7417;960597;576748;51.2;30.7
69;2021-06-28;4341;14882;964938;591630;51.4;31.5
69;2021-06-29;5248;15659;970186;607289;51.7;32.4
69;2021-06-30;6200;14453;976386;621742;52.0;33.1
69;2021-07-01;6943;11941;983329;633683;52.4;33.8
69;2021-07-02;6993;14118;990322;647801;52.8;34.5
69;2021-07-03;5939;7771;996261;655572;53.1;34.9
69;2021-07-04;4152;5552;1000413;661124;53.3;35.2
69;2021-07-05;5785;13020;1006198;674144;53.6;35.9
69;2021-07-06;5235;14280;1011433;688424;53.9;36.7
69;2021-07-07;7090;13555;1018523;701979;54.3;37.4
69;2021-07-08;7414;13418;1025937;715397;54.7;38.1
69;2021-07-09;7227;16465;1033164;731862;55.1;39.0
69;2021-07-10;2751;10325;1035915;742187;55.2;39.6
69;2021-07-11;4260;5837;1040175;748024;55.4;39.9
69;2021-07-12;3568;16973;1043743;764997;55.6;40.8
69;2021-07-13;5894;20748;1049637;785745;55.9;41.9
69;2021-07-14;4713;8486;1054350;794231;56.2;42.3
69;2021-07-15;7292;22613;1061642;816844;56.6;43.5
69;2021-07-16;9406;20124;1071048;836968;57.1;44.6
69;2021-07-17;4829;12242;1075877;849210;57.3;45.3
69;2021-07-18;3380;8907;1079257;858117;57.5;45.7
69;2021-07-19;6298;16466;1085555;874583;57.9;46.6
69;2021-07-20;9019;19298;1094574;893881;58.3;47.6
69;2021-07-21;9242;17397;1103816;911278;58.8;48.6
69;2021-07-22;11306;16423;1115122;927701;59.4;49.4
69;2021-07-23;10839;17650;1125961;945351;60.0;50.4
69;2021-07-24;5527;11029;1131488;956380;60.3;51.0
69;2021-07-25;4673;6620;1136161;963000;60.6;51.3
69;2021-07-26;8512;12918;1144673;975918;61.0;52.0
69;2021-07-27;12592;12119;1157265;988037;61.7;52.7
69;2021-07-28;11838;12084;1169103;1000121;62.3;53.3
69;2021-07-29;14474;12252;1183577;1012373;63.1;54.0
69;2021-07-30;13463;12160;1197040;1024533;63.8;54.6
69;2021-07-31;7983;7174;1205023;1031707;64.2;55.0
69;2021-08-01;4966;5841;1209989;1037548;64.5;55.3
69;2021-08-02;10116;9531;1220105;1047079;65.0;55.8
69;2021-08-03;12672;8916;1232777;1055995;65.7;56.3
69;2021-08-04;12261;8065;1245038;1064060;66.4;56.7
69;2021-08-05;10731;7422;1255769;1071482;66.9;57.1
70;2020-12-27;0;0;0;0;0.0;0.0
70;2020-12-28;0;0;0;0;0.0;0.0
70;2020-12-29;0;0;0;0;0.0;0.0
70;2020-12-30;0;0;0;0;0.0;0.0
70;2020-12-31;0;0;0;0;0.0;0.0
70;2021-01-01;0;0;0;0;0.0;0.0
70;2021-01-02;0;0;0;0;0.0;0.0
70;2021-01-03;0;0;0;0;0.0;0.0
70;2021-01-04;0;0;0;0;0.0;0.0
70;2021-01-05;0;0;0;0;0.0;0.0
70;2021-01-06;24;0;24;0;0.0;0.0
70;2021-01-07;121;0;145;0;0.1;0.0
70;2021-01-08;21;0;166;0;0.1;0.0
70;2021-01-09;0;0;166;0;0.1;0.0
70;2021-01-10;0;0;166;0;0.1;0.0
70;2021-01-11;147;1;313;1;0.1;0.0
70;2021-01-12;195;1;508;2;0.2;0.0
70;2021-01-13;172;1;680;3;0.3;0.0
70;2021-01-14;149;6;829;9;0.4;0.0
70;2021-01-15;153;0;982;9;0.4;0.0
70;2021-01-16;65;0;1047;9;0.4;0.0
70;2021-01-17;0;0;1047;9;0.4;0.0
70;2021-01-18;392;0;1439;9;0.6;0.0
70;2021-01-19;502;2;1941;11;0.8;0.0
70;2021-01-20;494;2;2435;13;1.0;0.0
70;2021-01-21;673;2;3108;15;1.3;0.0
70;2021-01-22;458;3;3566;18;1.5;0.0
70;2021-01-23;261;2;3827;20;1.6;0.0
70;2021-01-24;4;0;3831;20;1.6;0.0
70;2021-01-25;371;1;4202;21;1.8;0.0
70;2021-01-26;335;1;4537;22;1.9;0.0
70;2021-01-27;328;10;4865;32;2.1;0.0
70;2021-01-28;365;36;5230;68;2.2;0.0
70;2021-01-29;329;52;5559;120;2.4;0.1
70;2021-01-30;228;1;5787;121;2.5;0.1
70;2021-01-31;0;0;5787;121;2.5;0.1
70;2021-02-01;260;51;6047;172;2.6;0.1
70;2021-02-02;272;98;6319;270;2.7;0.1
70;2021-02-03;252;61;6571;331;2.8;0.1
70;2021-02-04;264;122;6835;453;2.9;0.2
70;2021-02-05;254;75;7089;528;3.0;0.2
70;2021-02-06;209;37;7298;565;3.1;0.2
70;2021-02-07;0;0;7298;565;3.1;0.2
70;2021-02-08;179;235;7477;800;3.2;0.3
70;2021-02-09;206;231;7683;1031;3.3;0.4
70;2021-02-10;196;302;7879;1333;3.4;0.6
70;2021-02-11;351;329;8230;1662;3.5;0.7
70;2021-02-12;239;492;8469;2154;3.6;0.9
70;2021-02-13;75;211;8544;2365;3.7;1.0
70;2021-02-14;0;29;8544;2394;3.7;1.0
70;2021-02-15;70;340;8614;2734;3.7;1.2
70;2021-02-16;113;363;8727;3097;3.7;1.3
70;2021-02-17;167;305;8894;3402;3.8;1.5
70;2021-02-18;205;259;9099;3661;3.9;1.6
70;2021-02-19;197;205;9296;3866;4.0;1.7
70;2021-02-20;192;69;9488;3935;4.1;1.7
70;2021-02-21;1;0;9489;3935;4.1;1.7
70;2021-02-22;107;236;9596;4171;4.1;1.8
70;2021-02-23;125;262;9721;4433;4.2;1.9
70;2021-02-24;129;233;9850;4666;4.2;2.0
70;2021-02-25;315;257;10165;4923;4.4;2.1
70;2021-02-26;395;148;10560;5071;4.5;2.2
70;2021-02-27;147;202;10707;5273;4.6;2.3
70;2021-02-28;0;0;10707;5273;4.6;2.3
70;2021-03-01;249;241;10956;5514;4.7;2.4
70;2021-03-02;487;275;11443;5789;4.9;2.5
70;2021-03-03;467;254;11910;6043;5.1;2.6
70;2021-03-04;690;272;12600;6315;5.4;2.7
70;2021-03-05;766;258;13366;6573;5.7;2.8
70;2021-03-06;540;115;13906;6688;6.0;2.9
70;2021-03-07;216;24;14122;6712;6.1;2.9
70;2021-03-08;554;209;14676;6921;6.3;3.0
70;2021-03-09;865;174;15541;7095;6.7;3.0
70;2021-03-10;659;177;16200;7272;6.9;3.1
70;2021-03-11;698;251;16898;7523;7.2;3.2
70;2021-03-12;985;178;17883;7701;7.7;3.3
70;2021-03-13;581;117;18464;7818;7.9;3.4
70;2021-03-14;19;0;18483;7818;7.9;3.4
70;2021-03-15;774;105;19257;7923;8.3;3.4
70;2021-03-16;654;90;19911;8013;8.5;3.4
70;2021-03-17;595;180;20506;8193;8.8;3.5
70;2021-03-18;633;140;21139;8333;9.1;3.6
70;2021-03-19;1018;136;22157;8469;9.5;3.6
70;2021-03-20;641;184;22798;8653;9.8;3.7
70;2021-03-21;9;0;22807;8653;9.8;3.7
70;2021-03-22;757;97;23564;8750;10.1;3.8
70;2021-03-23;1306;156;24870;8906;10.7;3.8
70;2021-03-24;1270;101;26140;9007;11.2;3.9
70;2021-03-25;1244;192;27384;9199;11.7;3.9
70;2021-03-26;1487;291;28871;9490;12.4;4.1
70;2021-03-27;957;125;29828;9615;12.8;4.1
70;2021-03-28;0;10;29828;9625;12.8;4.1
70;2021-03-29;718;410;30546;10035;13.1;4.3
70;2021-03-30;1093;315;31639;10350;13.6;4.4
70;2021-03-31;878;317;32517;10667;13.9;4.6
70;2021-04-01;1153;425;33670;11092;14.4;4.8
70;2021-04-02;1310;340;34980;11432;15.0;4.9
70;2021-04-03;639;320;35619;11752;15.3;5.0
70;2021-04-04;10;0;35629;11752;15.3;5.0
70;2021-04-05;4;2;35633;11754;15.3;5.0
70;2021-04-06;830;554;36463;12308;15.6;5.3
70;2021-04-07;859;585;37322;12893;16.0;5.5
70;2021-04-08;1318;560;38640;13453;16.6;5.8
70;2021-04-09;1402;529;40042;13982;17.2;6.0
70;2021-04-10;858;348;40900;14330;17.5;6.1
70;2021-04-11;21;1;40921;14331;17.5;6.1
70;2021-04-12;695;658;41616;14989;17.8;6.4
70;2021-04-13;921;765;42537;15754;18.2;6.8
70;2021-04-14;815;576;43352;16330;18.6;7.0
70;2021-04-15;1079;604;44431;16934;19.1;7.3
70;2021-04-16;1244;547;45675;17481;19.6;7.5
70;2021-04-17;689;469;46364;17950;19.9;7.7
70;2021-04-18;57;4;46421;17954;19.9;7.7
70;2021-04-19;540;807;46961;18761;20.1;8.0
70;2021-04-20;664;855;47625;19616;20.4;8.4
70;2021-04-21;484;927;48109;20543;20.6;8.8
70;2021-04-22;776;799;48885;21342;21.0;9.2
70;2021-04-23;876;741;49761;22083;21.3;9.5
70;2021-04-24;432;642;50193;22725;21.5;9.7
70;2021-04-25;11;0;50204;22725;21.5;9.7
70;2021-04-26;924;599;51128;23324;21.9;10.0
70;2021-04-27;1210;751;52338;24075;22.4;10.3
70;2021-04-28;889;808;53227;24883;22.8;10.7
70;2021-04-29;1343;931;54570;25814;23.4;11.1
70;2021-04-30;1532;874;56102;26688;24.1;11.4
70;2021-05-01;1693;119;57795;26807;24.8;11.5
70;2021-05-02;2;0;57797;26807;24.8;11.5
70;2021-05-03;1188;577;58985;27384;25.3;11.7
70;2021-05-04;1354;750;60339;28134;25.9;12.1
70;2021-05-05;1190;871;61529;29005;26.4;12.4
70;2021-05-06;1849;1266;63378;30271;27.2;13.0
70;2021-05-07;2126;1235;65504;31506;28.1;13.5
70;2021-05-08;1340;188;66844;31694;28.7;13.6
70;2021-05-09;8;58;66852;31752;28.7;13.6
70;2021-05-10;959;945;67811;32697;29.1;14.0
70;2021-05-11;1239;1067;69050;33764;29.6;14.5
70;2021-05-12;1176;866;70226;34630;30.1;14.9
70;2021-05-13;1544;146;71770;34776;30.8;14.9
70;2021-05-14;2062;755;73832;35531;31.7;15.2
70;2021-05-15;2658;530;76490;36061;32.8;15.5
70;2021-05-16;999;71;77489;36132;33.2;15.5
70;2021-05-17;1237;385;78726;36517;33.8;15.7
70;2021-05-18;1296;590;80022;37107;34.3;15.9
70;2021-05-19;1476;480;81498;37587;34.9;16.1
70;2021-05-20;1780;629;83278;38216;35.7;16.4
70;2021-05-21;1690;819;84968;39035;36.4;16.7
70;2021-05-22;1221;663;86189;39698;37.0;17.0
70;2021-05-23;8;14;86197;39712;37.0;17.0
70;2021-05-24;225;25;86422;39737;37.1;17.0
70;2021-05-25;835;925;87257;40662;37.4;17.4
70;2021-05-26;1047;946;88304;41608;37.9;17.8
70;2021-05-27;1263;995;89567;42603;38.4;18.3
70;2021-05-28;1546;1160;91113;43763;39.1;18.8
70;2021-05-29;1371;587;92484;44350;39.7;19.0
70;2021-05-30;1;8;92485;44358;39.7;19.0
70;2021-05-31;969;677;93454;45035;40.1;19.3
70;2021-06-01;1213;850;94667;45885;40.6;19.7
70;2021-06-02;1264;677;95931;46562;41.1;20.0
70;2021-06-03;1430;841;97361;47403;41.8;20.3
70;2021-06-04;1336;1108;98697;48511;42.3;20.8
70;2021-06-05;1025;662;99722;49173;42.8;21.1
70;2021-06-06;599;79;100321;49252;43.0;21.1
70;2021-06-07;941;850;101262;50102;43.4;21.5
70;2021-06-08;1217;1184;102479;51286;43.9;22.0
70;2021-06-09;1156;988;103635;52274;44.4;22.4
70;2021-06-10;1566;825;105201;53099;45.1;22.8
70;2021-06-11;1587;1956;106788;55055;45.8;23.6
70;2021-06-12;829;1970;107617;57025;46.1;24.5
70;2021-06-13;142;14;107759;57039;46.2;24.5
70;2021-06-14;558;1245;108317;58284;46.4;25.0
70;2021-06-15;451;1505;108768;59789;46.6;25.6
70;2021-06-16;799;1393;109567;61182;47.0;26.2
70;2021-06-17;1149;2095;110716;63277;47.5;27.1
70;2021-06-18;994;2254;111710;65531;47.9;28.1
70;2021-06-19;1090;1638;112800;67169;48.4;28.8
70;2021-06-20;1;3;112801;67172;48.4;28.8
70;2021-06-21;691;1453;113492;68625;48.7;29.4
70;2021-06-22;652;1509;114144;70134;48.9;30.1
70;2021-06-23;661;1570;114805;71704;49.2;30.7
70;2021-06-24;875;2049;115680;73753;49.6;31.6
70;2021-06-25;683;2645;116363;76398;49.9;32.8
70;2021-06-26;943;2139;117306;78537;50.3;33.7
70;2021-06-27;140;760;117446;79297;50.4;34.0
70;2021-06-28;336;1348;117782;80645;50.5;34.6
70;2021-06-29;410;1608;118192;82253;50.7;35.3
70;2021-06-30;388;1634;118580;83887;50.9;36.0
70;2021-07-01;640;1751;119220;85638;51.1;36.7
70;2021-07-02;814;1576;120034;87214;51.5;37.4
70;2021-07-03;837;1078;120871;88292;51.8;37.9
70;2021-07-04;28;70;120899;88362;51.8;37.9
70;2021-07-05;610;1034;121509;89396;52.1;38.3
70;2021-07-06;681;1274;122190;90670;52.4;38.9
70;2021-07-07;506;1424;122696;92094;52.6;39.5
70;2021-07-08;816;1574;123512;93668;53.0;40.2
70;2021-07-09;869;1663;124381;95331;53.3;40.9
70;2021-07-10;830;1032;125211;96363;53.7;41.3
70;2021-07-11;6;20;125217;96383;53.7;41.3
70;2021-07-12;429;1398;125646;97781;53.9;41.9
70;2021-07-13;907;1867;126553;99648;54.3;42.7
70;2021-07-14;33;6;126586;99654;54.3;42.7
70;2021-07-15;1378;1694;127964;101348;54.9;43.5
70;2021-07-16;1616;2063;129580;103411;55.6;44.3
70;2021-07-17;1498;1449;131078;104860;56.2;45.0
70;2021-07-18;1138;637;132216;105497;56.7;45.2
70;2021-07-19;875;972;133091;106469;57.1;45.7
70;2021-07-20;1351;1360;134442;107829;57.7;46.2
70;2021-07-21;1278;1397;135720;109226;58.2;46.8
70;2021-07-22;1863;1821;137583;111047;59.0;47.6
70;2021-07-23;1826;2489;139409;113536;59.8;48.7
70;2021-07-24;1363;1797;140772;115333;60.4;49.5
70;2021-07-25;25;2;140797;115335;60.4;49.5
70;2021-07-26;1051;972;141848;116307;60.8;49.9
70;2021-07-27;1389;973;143237;117280;61.4;50.3
70;2021-07-28;1395;1160;144632;118440;62.0;50.8
70;2021-07-29;1869;1376;146501;119816;62.8;51.4
70;2021-07-30;1964;1339;148465;121155;63.7;52.0
70;2021-07-31;1745;1161;150210;122316;64.4;52.5
70;2021-08-01;1;4;150211;122320;64.4;52.5
70;2021-08-02;773;732;150984;123052;64.7;52.8
70;2021-08-03;1289;1029;152273;124081;65.3;53.2
70;2021-08-04;1208;912;153481;124993;65.8;53.6
70;2021-08-05;1656;1186;155137;126179;66.5;54.1
71;2020-12-27;0;0;0;0;0.0;0.0
71;2020-12-28;0;0;0;0;0.0;0.0
71;2020-12-29;0;0;0;0;0.0;0.0
71;2020-12-30;0;0;0;0;0.0;0.0
71;2020-12-31;0;0;0;0;0.0;0.0
71;2021-01-01;0;0;0;0;0.0;0.0
71;2021-01-02;0;0;0;0;0.0;0.0
71;2021-01-03;1;0;1;0;0.0;0.0
71;2021-01-04;1;0;2;0;0.0;0.0
71;2021-01-05;12;0;14;0;0.0;0.0
71;2021-01-06;72;0;86;0;0.0;0.0
71;2021-01-07;66;1;152;1;0.0;0.0
71;2021-01-08;146;0;298;1;0.1;0.0
71;2021-01-09;117;0;415;1;0.1;0.0
71;2021-01-10;1;0;416;1;0.1;0.0
71;2021-01-11;245;0;661;1;0.1;0.0
71;2021-01-12;845;1;1506;2;0.3;0.0
71;2021-01-13;562;2;2068;4;0.4;0.0
71;2021-01-14;581;9;2649;13;0.5;0.0
71;2021-01-15;666;1;3315;14;0.6;0.0
71;2021-01-16;9;0;3324;14;0.6;0.0
71;2021-01-17;0;0;3324;14;0.6;0.0
71;2021-01-18;1094;7;4418;21;0.8;0.0
71;2021-01-19;1682;7;6100;28;1.1;0.0
71;2021-01-20;1508;5;7608;33;1.4;0.0
71;2021-01-21;2056;14;9664;47;1.8;0.0
71;2021-01-22;1411;6;11075;53;2.0;0.0
71;2021-01-23;815;5;11890;58;2.2;0.0
71;2021-01-24;0;0;11890;58;2.2;0.0
71;2021-01-25;1062;6;12952;64;2.4;0.0
71;2021-01-26;1504;19;14456;83;2.6;0.0
71;2021-01-27;1248;32;15704;115;2.9;0.0
71;2021-01-28;1082;96;16786;211;3.1;0.0
71;2021-01-29;1014;145;17800;356;3.2;0.1
71;2021-01-30;604;2;18404;358;3.4;0.1
71;2021-01-31;1;15;18405;373;3.4;0.1
71;2021-02-01;750;238;19155;611;3.5;0.1
71;2021-02-02;753;357;19908;968;3.6;0.2
71;2021-02-03;818;425;20726;1393;3.8;0.3
71;2021-02-04;780;572;21506;1965;3.9;0.4
71;2021-02-05;706;525;22212;2490;4.1;0.5
71;2021-02-06;535;9;22747;2499;4.2;0.5
71;2021-02-07;3;50;22750;2549;4.2;0.5
71;2021-02-08;603;701;23353;3250;4.3;0.6
71;2021-02-09;372;1012;23725;4262;4.3;0.8
71;2021-02-10;410;996;24135;5258;4.4;1.0
71;2021-02-11;473;1181;24608;6439;4.5;1.2
71;2021-02-12;534;1037;25142;7476;4.6;1.4
71;2021-02-13;125;515;25267;7991;4.6;1.5
71;2021-02-14;1;7;25268;7998;4.6;1.5
71;2021-02-15;324;913;25592;8911;4.7;1.6
71;2021-02-16;442;1366;26034;10277;4.8;1.9
71;2021-02-17;426;1125;26460;11402;4.8;2.1
71;2021-02-18;548;936;27008;12338;4.9;2.3
71;2021-02-19;574;855;27582;13193;5.0;2.4
71;2021-02-20;224;380;27806;13573;5.1;2.5
71;2021-02-21;3;13;27809;13586;5.1;2.5
71;2021-02-22;237;879;28046;14465;5.1;2.6
71;2021-02-23;452;925;28498;15390;5.2;2.8
71;2021-02-24;444;725;28942;16115;5.3;2.9
71;2021-02-25;530;727;29472;16842;5.4;3.1
71;2021-02-26;830;532;30302;17374;5.5;3.2
71;2021-02-27;456;339;30758;17713;5.6;3.2
71;2021-02-28;54;14;30812;17727;5.6;3.2
71;2021-03-01;1187;680;31999;18407;5.8;3.4
71;2021-03-02;1574;641;33573;19048;6.1;3.5
71;2021-03-03;1818;771;35391;19819;6.5;3.6
71;2021-03-04;1999;812;37390;20631;6.8;3.8
71;2021-03-05;2285;687;39675;21318;7.2;3.9
71;2021-03-06;755;62;40430;21380;7.4;3.9
71;2021-03-07;40;21;40470;21401;7.4;3.9
71;2021-03-08;1451;779;41921;22180;7.7;4.0
71;2021-03-09;2160;520;44081;22700;8.0;4.1
71;2021-03-10;2165;457;46246;23157;8.4;4.2
71;2021-03-11;2632;649;48878;23806;8.9;4.3
71;2021-03-12;2605;614;51483;24420;9.4;4.5
71;2021-03-13;996;97;52479;24517;9.6;4.5
71;2021-03-14;35;0;52514;24517;9.6;4.5
71;2021-03-15;1799;493;54313;25010;9.9;4.6
71;2021-03-16;1821;195;56134;25205;10.2;4.6
71;2021-03-17;2131;249;58265;25454;10.6;4.6
71;2021-03-18;1951;433;60216;25887;11.0;4.7
71;2021-03-19;2367;323;62583;26210;11.4;4.8
71;2021-03-20;1083;37;63666;26247;11.6;4.8
71;2021-03-21;16;5;63682;26252;11.6;4.8
71;2021-03-22;2576;365;66258;26617;12.1;4.9
71;2021-03-23;3346;499;69604;27116;12.7;4.9
71;2021-03-24;3346;451;72950;27567;13.3;5.0
71;2021-03-25;4025;582;76975;28149;14.1;5.1
71;2021-03-26;4050;327;81025;28476;14.8;5.2
71;2021-03-27;998;105;82023;28581;15.0;5.2
71;2021-03-28;57;8;82080;28589;15.0;5.2
71;2021-03-29;2404;1174;84484;29763;15.4;5.4
71;2021-03-30;2953;1358;87437;31121;16.0;5.7
71;2021-03-31;2556;1512;89993;32633;16.4;6.0
71;2021-04-01;2717;1297;92710;33930;16.9;6.2
71;2021-04-02;2504;1418;95214;35348;17.4;6.5
71;2021-04-03;267;33;95481;35381;17.4;6.5
71;2021-04-04;5;0;95486;35381;17.4;6.5
71;2021-04-05;61;0;95547;35381;17.4;6.5
71;2021-04-06;2260;1870;97807;37251;17.9;6.8
71;2021-04-07;2392;1790;100199;39041;18.3;7.1
71;2021-04-08;3282;1803;103481;40844;18.9;7.5
71;2021-04-09;4038;1667;107519;42511;19.6;7.8
71;2021-04-10;769;42;108288;42553;19.8;7.8
71;2021-04-11;100;3;108388;42556;19.8;7.8
71;2021-04-12;2352;1698;110740;44254;20.2;8.1
71;2021-04-13;2583;1892;113323;46146;20.7;8.4
71;2021-04-14;2368;1920;115691;48066;21.1;8.8
71;2021-04-15;2776;1685;118467;49751;21.6;9.1
71;2021-04-16;2624;1645;121091;51396;22.1;9.4
71;2021-04-17;952;343;122043;51739;22.3;9.4
71;2021-04-18;106;5;122149;51744;22.3;9.4
71;2021-04-19;1759;2573;123908;54317;22.6;9.9
71;2021-04-20;2219;2598;126127;56915;23.0;10.4
71;2021-04-21;2124;2597;128251;59512;23.4;10.9
71;2021-04-22;2510;2439;130761;61951;23.9;11.3
71;2021-04-23;2918;2265;133679;64216;24.4;11.7
71;2021-04-24;518;49;134197;64265;24.5;11.7
71;2021-04-25;24;0;134221;64265;24.5;11.7
71;2021-04-26;2567;2126;136788;66391;25.0;12.1
71;2021-04-27;2985;2258;139773;68649;25.5;12.5
71;2021-04-28;3074;2128;142847;70777;26.1;12.9
71;2021-04-29;3778;2230;146625;73007;26.8;13.3
71;2021-04-30;3928;1723;150553;74730;27.5;13.6
71;2021-05-01;38;53;150591;74783;27.5;13.7
71;2021-05-02;23;18;150614;74801;27.5;13.7
71;2021-05-03;4289;1382;154903;76183;28.3;13.9
71;2021-05-04;2956;2349;157859;78532;28.8;14.3
71;2021-05-05;3426;2092;161285;80624;29.4;14.7
71;2021-05-06;3464;2364;164749;82988;30.1;15.1
71;2021-05-07;3673;2810;168422;85798;30.7;15.7
71;2021-05-08;179;183;168601;85981;30.8;15.7
71;2021-05-09;43;47;168644;86028;30.8;15.7
71;2021-05-10;3699;2283;172343;88311;31.5;16.1
71;2021-05-11;4662;2351;177005;90662;32.3;16.5
71;2021-05-12;3975;2590;180980;93252;33.0;17.0
71;2021-05-13;1575;154;182555;93406;33.3;17.1
71;2021-05-14;3763;2191;186318;95597;34.0;17.5
71;2021-05-15;242;328;186560;95925;34.1;17.5
71;2021-05-16;2;0;186562;95925;34.1;17.5
71;2021-05-17;3864;1883;190426;97808;34.8;17.9
71;2021-05-18;3496;2423;193922;100231;35.4;18.3
71;2021-05-19;3719;2281;197641;102512;36.1;18.7
71;2021-05-20;4181;2294;201822;104806;36.8;19.1
71;2021-05-21;3722;2574;205544;107380;37.5;19.6
71;2021-05-22;168;306;205712;107686;37.6;19.7
71;2021-05-23;13;55;205725;107741;37.6;19.7
71;2021-05-24;18;96;205743;107837;37.6;19.7
71;2021-05-25;2692;3007;208435;110844;38.0;20.2
71;2021-05-26;2972;2433;211407;113277;38.6;20.7
71;2021-05-27;3389;2588;214796;115865;39.2;21.2
71;2021-05-28;2918;3161;217714;119026;39.7;21.7
71;2021-05-29;481;659;218195;119685;39.8;21.8
71;2021-05-30;75;57;218270;119742;39.8;21.9
71;2021-05-31;2773;3458;221043;123200;40.3;22.5
71;2021-06-01;3660;3541;224703;126741;41.0;23.1
71;2021-06-02;3994;2622;228697;129363;41.7;23.6
71;2021-06-03;4436;2530;233133;131893;42.6;24.1
71;2021-06-04;3716;3714;236849;135607;43.2;24.8
71;2021-06-05;683;644;237532;136251;43.4;24.9
71;2021-06-06;57;91;237589;136342;43.4;24.9
71;2021-06-07;3279;4145;240868;140487;44.0;25.6
71;2021-06-08;3896;4011;244764;144498;44.7;26.4
71;2021-06-09;4691;2747;249455;147245;45.5;26.9
71;2021-06-10;5266;2738;254721;149983;46.5;27.4
71;2021-06-11;4437;3719;259158;153702;47.3;28.1
71;2021-06-12;714;593;259872;154295;47.4;28.2
71;2021-06-13;104;187;259976;154482;47.5;28.2
71;2021-06-14;3512;3778;263488;158260;48.1;28.9
71;2021-06-15;4205;3558;267693;161818;48.9;29.5
71;2021-06-16;4596;2720;272289;164538;49.7;30.0
71;2021-06-17;4266;2998;276555;167536;50.5;30.6
71;2021-06-18;4323;3770;280878;171306;51.3;31.3
71;2021-06-19;1270;652;282148;171958;51.5;31.4
71;2021-06-20;37;27;282185;171985;51.5;31.4
71;2021-06-21;2271;4280;284456;176265;51.9;32.2
71;2021-06-22;2685;4351;287141;180616;52.4;33.0
71;2021-06-23;3062;3415;290203;184031;53.0;33.6
71;2021-06-24;3325;3021;293528;187052;53.6;34.1
71;2021-06-25;2649;4472;296177;191524;54.1;35.0
71;2021-06-26;370;550;296547;192074;54.1;35.1
71;2021-06-27;30;68;296577;192142;54.1;35.1
71;2021-06-28;1531;4618;298108;196760;54.4;35.9
71;2021-06-29;1984;4817;300092;201577;54.8;36.8
71;2021-06-30;2491;3928;302583;205505;55.2;37.5
71;2021-07-01;2637;3901;305220;209406;55.7;38.2
71;2021-07-02;2904;3984;308124;213390;56.2;39.0
71;2021-07-03;317;710;308441;214100;56.3;39.1
71;2021-07-04;28;133;308469;214233;56.3;39.1
71;2021-07-05;2472;4323;310941;218556;56.8;39.9
71;2021-07-06;2459;4568;313400;223124;57.2;40.7
71;2021-07-07;2946;3728;316346;226852;57.7;41.4
71;2021-07-08;2761;4112;319107;230964;58.2;42.2
71;2021-07-09;2284;5026;321391;235990;58.7;43.1
71;2021-07-10;207;656;321598;236646;58.7;43.2
71;2021-07-11;15;65;321613;236711;58.7;43.2
71;2021-07-12;1903;5314;323516;242025;59.1;44.2
71;2021-07-13;2527;5871;326043;247896;59.5;45.3
71;2021-07-14;947;399;326990;248295;59.7;45.3
71;2021-07-15;3011;5742;330001;254037;60.2;46.4
71;2021-07-16;3282;6018;333283;260055;60.8;47.5
71;2021-07-17;500;781;333783;260836;60.9;47.6
71;2021-07-18;87;92;333870;260928;60.9;47.6
71;2021-07-19;2853;5589;336723;266517;61.5;48.7
71;2021-07-20;3333;5923;340056;272440;62.1;49.7
71;2021-07-21;3390;5466;343446;277906;62.7;50.7
71;2021-07-22;3929;5333;347375;283239;63.4;51.7
71;2021-07-23;3211;5995;350586;289234;64.0;52.8
71;2021-07-24;699;594;351285;289828;64.1;52.9
71;2021-07-25;145;80;351430;289908;64.2;52.9
71;2021-07-26;3576;4899;355006;294807;64.8;53.8
71;2021-07-27;4054;5111;359060;299918;65.5;54.7
71;2021-07-28;4208;4814;363268;304732;66.3;55.6
71;2021-07-29;4184;4630;367452;309362;67.1;56.5
71;2021-07-30;4220;4911;371672;314273;67.8;57.4
71;2021-07-31;717;725;372389;314998;68.0;57.5
71;2021-08-01;96;33;372485;315031;68.0;57.5
71;2021-08-02;3944;3749;376429;318780;68.7;58.2
71;2021-08-03;4373;3809;380802;322589;69.5;58.9
71;2021-08-04;4351;2965;385153;325554;70.3;59.4
71;2021-08-05;4124;3229;389277;328783;71.1;60.0
72;2020-12-27;0;0;0;0;0.0;0.0
72;2020-12-28;0;0;0;0;0.0;0.0
72;2020-12-29;0;0;0;0;0.0;0.0
72;2020-12-30;0;0;0;0;0.0;0.0
72;2020-12-31;0;0;0;0;0.0;0.0
72;2021-01-01;2;0;2;0;0.0;0.0
72;2021-01-02;0;0;2;0;0.0;0.0
72;2021-01-03;0;0;2;0;0.0;0.0
72;2021-01-04;0;0;2;0;0.0;0.0
72;2021-01-05;14;0;16;0;0.0;0.0
72;2021-01-06;27;0;43;0;0.0;0.0
72;2021-01-07;110;0;153;0;0.0;0.0
72;2021-01-08;232;0;385;0;0.1;0.0
72;2021-01-09;36;0;421;0;0.1;0.0
72;2021-01-10;0;0;421;0;0.1;0.0
72;2021-01-11;484;1;905;1;0.2;0.0
72;2021-01-12;614;1;1519;2;0.3;0.0
72;2021-01-13;500;1;2019;3;0.4;0.0
72;2021-01-14;644;3;2663;6;0.5;0.0
72;2021-01-15;478;1;3141;7;0.6;0.0
72;2021-01-16;93;0;3234;7;0.6;0.0
72;2021-01-17;0;0;3234;7;0.6;0.0
72;2021-01-18;292;0;3526;7;0.6;0.0
72;2021-01-19;773;3;4299;10;0.8;0.0
72;2021-01-20;1518;6;5817;16;1.0;0.0
72;2021-01-21;1743;5;7560;21;1.3;0.0
72;2021-01-22;1150;6;8710;27;1.6;0.0
72;2021-01-23;32;0;8742;27;1.6;0.0
72;2021-01-24;0;0;8742;27;1.6;0.0
72;2021-01-25;502;6;9244;33;1.7;0.0
72;2021-01-26;1165;22;10409;55;1.9;0.0
72;2021-01-27;882;19;11291;74;2.0;0.0
72;2021-01-28;776;68;12067;142;2.2;0.0
72;2021-01-29;712;70;12779;212;2.3;0.0
72;2021-01-30;58;0;12837;212;2.3;0.0
72;2021-01-31;1;0;12838;212;2.3;0.0
72;2021-02-01;498;229;13336;441;2.4;0.1
72;2021-02-02;506;296;13842;737;2.5;0.1
72;2021-02-03;484;229;14326;966;2.6;0.2
72;2021-02-04;475;342;14801;1308;2.6;0.2
72;2021-02-05;509;410;15310;1718;2.7;0.3
72;2021-02-06;83;14;15393;1732;2.7;0.3
72;2021-02-07;19;3;15412;1735;2.8;0.3
72;2021-02-08;309;405;15721;2140;2.8;0.4
72;2021-02-09;489;532;16210;2672;2.9;0.5
72;2021-02-10;551;928;16761;3600;3.0;0.6
72;2021-02-11;851;1351;17612;4951;3.1;0.9
72;2021-02-12;849;595;18461;5546;3.3;1.0
72;2021-02-13;108;38;18569;5584;3.3;1.0
72;2021-02-14;1;22;18570;5606;3.3;1.0
72;2021-02-15;220;504;18790;6110;3.4;1.1
72;2021-02-16;498;1030;19288;7140;3.4;1.3
72;2021-02-17;464;718;19752;7858;3.5;1.4
72;2021-02-18;594;637;20346;8495;3.6;1.5
72;2021-02-19;520;600;20866;9095;3.7;1.6
72;2021-02-20;80;57;20946;9152;3.7;1.6
72;2021-02-21;0;0;20946;9152;3.7;1.6
72;2021-02-22;325;583;21271;9735;3.8;1.7
72;2021-02-23;566;531;21837;10266;3.9;1.8
72;2021-02-24;434;470;22271;10736;4.0;1.9
72;2021-02-25;920;566;23191;11302;4.1;2.0
72;2021-02-26;600;513;23791;11815;4.2;2.1
72;2021-02-27;322;67;24113;11882;4.3;2.1
72;2021-02-28;15;17;24128;11899;4.3;2.1
72;2021-03-01;377;482;24505;12381;4.4;2.2
72;2021-03-02;503;605;25008;12986;4.5;2.3
72;2021-03-03;732;653;25740;13639;4.6;2.4
72;2021-03-04;737;779;26477;14418;4.7;2.6
72;2021-03-05;936;771;27413;15189;4.9;2.7
72;2021-03-06;759;134;28172;15323;5.0;2.7
72;2021-03-07;447;24;28619;15347;5.1;2.7
72;2021-03-08;558;466;29177;15813;5.2;2.8
72;2021-03-09;1039;657;30216;16470;5.4;2.9
72;2021-03-10;1136;665;31352;17135;5.6;3.1
72;2021-03-11;1606;492;32958;17627;5.9;3.1
72;2021-03-12;1363;519;34321;18146;6.1;3.2
72;2021-03-13;981;117;35302;18263;6.3;3.3
72;2021-03-14;14;10;35316;18273;6.3;3.3
72;2021-03-15;1157;221;36473;18494;6.5;3.3
72;2021-03-16;1051;189;37524;18683;6.7;3.3
72;2021-03-17;1030;257;38554;18940;6.9;3.4
72;2021-03-18;1087;370;39641;19310;7.1;3.4
72;2021-03-19;1274;291;40915;19601;7.3;3.5
72;2021-03-20;486;91;41401;19692;7.4;3.5
72;2021-03-21;19;0;41420;19692;7.4;3.5
72;2021-03-22;1349;341;42769;20033;7.6;3.6
72;2021-03-23;1722;478;44491;20511;7.9;3.7
72;2021-03-24;1836;303;46327;20814;8.3;3.7
72;2021-03-25;2445;458;48772;21272;8.7;3.8
72;2021-03-26;2334;371;51106;21643;9.1;3.9
72;2021-03-27;611;28;51717;21671;9.2;3.9
72;2021-03-28;22;0;51739;21671;9.2;3.9
72;2021-03-29;1616;380;53355;22051;9.5;3.9
72;2021-03-30;2494;384;55849;22435;10.0;4.0
72;2021-03-31;2133;362;57982;22797;10.3;4.1
72;2021-04-01;2834;337;60816;23134;10.9;4.1
72;2021-04-02;2246;395;63062;23529;11.3;4.2
72;2021-04-03;292;38;63354;23567;11.3;4.2
72;2021-04-04;14;3;63368;23570;11.3;4.2
72;2021-04-05;51;49;63419;23619;11.3;4.2
72;2021-04-06;1760;465;65179;24084;11.6;4.3
72;2021-04-07;2563;592;67742;24676;12.1;4.4
72;2021-04-08;2715;768;70457;25444;12.6;4.5
72;2021-04-09;3861;571;74318;26015;13.3;4.6
72;2021-04-10;1111;49;75429;26064;13.5;4.7
72;2021-04-11;7;1;75436;26065;13.5;4.7
72;2021-04-12;1848;897;77284;26962;13.8;4.8
72;2021-04-13;2361;1070;79645;28032;14.2;5.0
72;2021-04-14;2246;1095;81891;29127;14.6;5.2
72;2021-04-15;2421;1112;84312;30239;15.0;5.4
72;2021-04-16;2562;957;86874;31196;15.5;5.6
72;2021-04-17;707;144;87581;31340;15.6;5.6
72;2021-04-18;57;2;87638;31342;15.6;5.6
72;2021-04-19;1396;1095;89034;32437;15.9;5.8
72;2021-04-20;3000;1294;92034;33731;16.4;6.0
72;2021-04-21;2515;1559;94549;35290;16.9;6.3
72;2021-04-22;2814;1792;97363;37082;17.4;6.6
72;2021-04-23;3210;1449;100573;38531;18.0;6.9
72;2021-04-24;1400;265;101973;38796;18.2;6.9
72;2021-04-25;881;19;102854;38815;18.4;6.9
72;2021-04-26;3512;1470;106366;40285;19.0;7.2
72;2021-04-27;4090;1856;110456;42141;19.7;7.5
72;2021-04-28;3832;1860;114288;44001;20.4;7.9
72;2021-04-29;4157;1811;118445;45812;21.1;8.2
72;2021-04-30;3614;1707;122059;47519;21.8;8.5
72;2021-05-01;1642;224;123701;47743;22.1;8.5
72;2021-05-02;1533;156;125234;47899;22.4;8.5
72;2021-05-03;3456;1149;128690;49048;23.0;8.8
72;2021-05-04;4012;1796;132702;50844;23.7;9.1
72;2021-05-05;3866;2175;136568;53019;24.4;9.5
72;2021-05-06;3595;1936;140163;54955;25.0;9.8
72;2021-05-07;3545;2151;143708;57106;25.7;10.2
72;2021-05-08;1901;150;145609;57256;26.0;10.2
72;2021-05-09;2082;204;147691;57460;26.4;10.3
72;2021-05-10;3771;1518;151462;58978;27.0;10.5
72;2021-05-11;4597;1992;156059;60970;27.9;10.9
72;2021-05-12;4082;1819;160141;62789;28.6;11.2
72;2021-05-13;3031;270;163172;63059;29.1;11.3
72;2021-05-14;3663;1385;166835;64444;29.8;11.5
72;2021-05-15;3122;362;169957;64806;30.3;11.6
72;2021-05-16;2501;152;172458;64958;30.8;11.6
72;2021-05-17;3724;1281;176182;66239;31.4;11.8
72;2021-05-18;4332;1686;180514;67925;32.2;12.1
72;2021-05-19;3978;1505;184492;69430;32.9;12.4
72;2021-05-20;4261;1451;188753;70881;33.7;12.7
72;2021-05-21;3791;1385;192544;72266;34.4;12.9
72;2021-05-22;2560;506;195104;72772;34.8;13.0
72;2021-05-23;1391;162;196495;72934;35.1;13.0
72;2021-05-24;2353;295;198848;73229;35.5;13.1
72;2021-05-25;4073;1407;202921;74636;36.2;13.3
72;2021-05-26;4097;1410;207018;76046;37.0;13.6
72;2021-05-27;4346;2042;211364;78088;37.7;13.9
72;2021-05-28;4107;2014;215471;80102;38.5;14.3
72;2021-05-29;2667;809;218138;80911;38.9;14.4
72;2021-05-30;1142;871;219280;81782;39.1;14.6
72;2021-05-31;3120;2329;222400;84111;39.7;15.0
72;2021-06-01;3563;2667;225963;86778;40.3;15.5
72;2021-06-02;3610;2783;229573;89561;41.0;16.0
72;2021-06-03;4241;2995;233814;92556;41.7;16.5
72;2021-06-04;3892;2750;237706;95306;42.4;17.0
72;2021-06-05;1439;2564;239145;97870;42.7;17.5
72;2021-06-06;910;1539;240055;99409;42.8;17.7
72;2021-06-07;1746;3422;241801;102831;43.2;18.4
72;2021-06-08;2928;3832;244729;106663;43.7;19.0
72;2021-06-09;2651;3365;247380;110028;44.2;19.6
72;2021-06-10;2828;3312;250208;113340;44.7;20.2
72;2021-06-11;2839;3771;253047;117111;45.2;20.9
72;2021-06-12;1243;2599;254290;119710;45.4;21.4
72;2021-06-13;388;1858;254678;121568;45.5;21.7
72;2021-06-14;1326;4124;256004;125692;45.7;22.4
72;2021-06-15;2753;3512;258757;129204;46.2;23.1
72;2021-06-16;2427;3573;261184;132777;46.6;23.7
72;2021-06-17;2320;3876;263504;136653;47.0;24.4
72;2021-06-18;2307;4308;265811;140961;47.4;25.2
72;2021-06-19;1127;2762;266938;143723;47.6;25.7
72;2021-06-20;339;2057;267277;145780;47.7;26.0
72;2021-06-21;1567;4031;268844;149811;48.0;26.7
72;2021-06-22;1711;4990;270555;154801;48.3;27.6
72;2021-06-23;2004;4219;272559;159020;48.7;28.4
72;2021-06-24;2229;4010;274788;163030;49.0;29.1
72;2021-06-25;1770;4842;276558;167872;49.4;30.0
72;2021-06-26;1188;2877;277746;170749;49.6;30.5
72;2021-06-27;392;2112;278138;172861;49.6;30.9
72;2021-06-28;1439;4294;279577;177155;49.9;31.6
72;2021-06-29;1764;4744;281341;181899;50.2;32.5
72;2021-06-30;1977;4168;283318;186067;50.6;33.2
72;2021-07-01;1938;4415;285256;190482;50.9;34.0
72;2021-07-02;1847;4716;287103;195198;51.2;34.8
72;2021-07-03;1288;3117;288391;198315;51.5;35.4
72;2021-07-04;581;1946;288972;200261;51.6;35.7
72;2021-07-05;1188;4166;290160;204427;51.8;36.5
72;2021-07-06;1459;5165;291619;209592;52.1;37.4
72;2021-07-07;1579;4615;293198;214207;52.3;38.2
72;2021-07-08;1646;4330;294844;218537;52.6;39.0
72;2021-07-09;2101;4624;296945;223161;53.0;39.8
72;2021-07-10;1584;2693;298529;225854;53.3;40.3
72;2021-07-11;949;1590;299478;227444;53.5;40.6
72;2021-07-12;1592;3758;301070;231202;53.7;41.3
72;2021-07-13;2085;4778;303155;235980;54.1;42.1
72;2021-07-14;1318;2367;304473;238347;54.3;42.5
72;2021-07-15;3478;3434;307951;241781;55.0;43.2
72;2021-07-16;3161;4134;311112;245915;55.5;43.9
72;2021-07-17;2626;1763;313738;247678;56.0;44.2
72;2021-07-18;1704;815;315442;248493;56.3;44.4
72;2021-07-19;2904;3513;318346;252006;56.8;45.0
72;2021-07-20;3024;4291;321370;256297;57.4;45.7
72;2021-07-21;2870;3597;324240;259894;57.9;46.4
72;2021-07-22;3745;2911;327985;262805;58.5;46.9
72;2021-07-23;3446;3784;331431;266589;59.2;47.6
72;2021-07-24;2811;1460;334242;268049;59.7;47.8
72;2021-07-25;1449;1076;335691;269125;59.9;48.0
72;2021-07-26;2714;2920;338405;272045;60.4;48.6
72;2021-07-27;3838;3814;342243;275859;61.1;49.2
72;2021-07-28;3556;3120;345799;278979;61.7;49.8
72;2021-07-29;3555;2709;349354;281688;62.4;50.3
72;2021-07-30;3744;3370;353098;285058;63.0;50.9
72;2021-07-31;2542;1742;355640;286800;63.5;51.2
72;2021-08-01;1826;428;357466;287228;63.8;51.3
72;2021-08-02;3200;2279;360666;289507;64.4;51.7
72;2021-08-03;3222;3298;363888;292805;65.0;52.3
72;2021-08-04;3744;2532;367632;295337;65.6;52.7
72;2021-08-05;3722;2434;371354;297771;66.3;53.2
73;2020-12-27;0;0;0;0;0.0;0.0
73;2020-12-28;1;0;1;0;0.0;0.0
73;2020-12-29;0;0;1;0;0.0;0.0
73;2020-12-30;0;0;1;0;0.0;0.0
73;2020-12-31;0;0;1;0;0.0;0.0
73;2021-01-01;0;0;1;0;0.0;0.0
73;2021-01-02;0;0;1;0;0.0;0.0
73;2021-01-03;0;0;1;0;0.0;0.0
73;2021-01-04;1;0;2;0;0.0;0.0
73;2021-01-05;0;0;2;0;0.0;0.0
73;2021-01-06;1;0;3;0;0.0;0.0
73;2021-01-07;30;0;33;0;0.0;0.0
73;2021-01-08;81;0;114;0;0.0;0.0
73;2021-01-09;0;0;114;0;0.0;0.0
73;2021-01-10;0;0;114;0;0.0;0.0
73;2021-01-11;86;0;200;0;0.0;0.0
73;2021-01-12;303;1;503;1;0.1;0.0
73;2021-01-13;356;1;859;2;0.2;0.0
73;2021-01-14;512;2;1371;4;0.3;0.0
73;2021-01-15;617;1;1988;5;0.5;0.0
73;2021-01-16;127;0;2115;5;0.5;0.0
73;2021-01-17;0;0;2115;5;0.5;0.0
73;2021-01-18;624;0;2739;5;0.6;0.0
73;2021-01-19;1238;3;3977;8;0.9;0.0
73;2021-01-20;951;1;4928;9;1.1;0.0
73;2021-01-21;982;5;5910;14;1.4;0.0
73;2021-01-22;945;0;6855;14;1.6;0.0
73;2021-01-23;387;0;7242;14;1.7;0.0
73;2021-01-24;0;0;7242;14;1.7;0.0
73;2021-01-25;656;5;7898;19;1.8;0.0
73;2021-01-26;761;2;8659;21;2.0;0.0
73;2021-01-27;1103;5;9762;26;2.3;0.0
73;2021-01-28;960;5;10722;31;2.5;0.0
73;2021-01-29;684;5;11406;36;2.6;0.0
73;2021-01-30;345;3;11751;39;2.7;0.0
73;2021-01-31;0;0;11751;39;2.7;0.0
73;2021-02-01;620;40;12371;79;2.9;0.0
73;2021-02-02;751;334;13122;413;3.0;0.1
73;2021-02-03;653;349;13775;762;3.2;0.2
73;2021-02-04;624;234;14399;996;3.3;0.2
73;2021-02-05;678;410;15077;1406;3.5;0.3
73;2021-02-06;261;38;15338;1444;3.5;0.3
73;2021-02-07;1;0;15339;1444;3.5;0.3
73;2021-02-08;521;253;15860;1697;3.7;0.4
73;2021-02-09;793;443;16653;2140;3.8;0.5
73;2021-02-10;896;394;17549;2534;4.1;0.6
73;2021-02-11;958;709;18507;3243;4.3;0.7
73;2021-02-12;810;499;19317;3742;4.5;0.9
73;2021-02-13;263;58;19580;3800;4.5;0.9
73;2021-02-14;1;0;19581;3800;4.5;0.9
73;2021-02-15;346;529;19927;4329;4.6;1.0
73;2021-02-16;453;762;20380;5091;4.7;1.2
73;2021-02-17;451;963;20831;6054;4.8;1.4
73;2021-02-18;469;556;21300;6610;4.9;1.5
73;2021-02-19;444;635;21744;7245;5.0;1.7
73;2021-02-20;70;249;21814;7494;5.0;1.7
73;2021-02-21;0;0;21814;7494;5.0;1.7
73;2021-02-22;240;442;22054;7936;5.1;1.8
73;2021-02-23;325;517;22379;8453;5.2;2.0
73;2021-02-24;486;745;22865;9198;5.3;2.1
73;2021-02-25;502;505;23367;9703;5.4;2.2
73;2021-02-26;730;566;24097;10269;5.6;2.4
73;2021-02-27;331;238;24428;10507;5.6;2.4
73;2021-02-28;1;1;24429;10508;5.6;2.4
73;2021-03-01;556;510;24985;11018;5.8;2.5
73;2021-03-02;667;898;25652;11916;5.9;2.8
73;2021-03-03;640;1196;26292;13112;6.1;3.0
73;2021-03-04;1035;897;27327;14009;6.3;3.2
73;2021-03-05;1238;608;28565;14617;6.6;3.4
73;2021-03-06;1092;331;29657;14948;6.9;3.5
73;2021-03-07;455;90;30112;15038;7.0;3.5
73;2021-03-08;605;426;30717;15464;7.1;3.6
73;2021-03-09;985;536;31702;16000;7.3;3.7
73;2021-03-10;1035;867;32737;16867;7.6;3.9
73;2021-03-11;1555;655;34292;17522;7.9;4.1
73;2021-03-12;2016;531;36308;18053;8.4;4.2
73;2021-03-13;1178;204;37486;18257;8.7;4.2
73;2021-03-14;66;3;37552;18260;8.7;4.2
73;2021-03-15;1184;394;38736;18654;9.0;4.3
73;2021-03-16;792;397;39528;19051;9.1;4.4
73;2021-03-17;876;475;40404;19526;9.3;4.5
73;2021-03-18;1351;256;41755;19782;9.7;4.6
73;2021-03-19;1765;390;43520;20172;10.1;4.7
73;2021-03-20;886;127;44406;20299;10.3;4.7
73;2021-03-21;123;2;44529;20301;10.3;4.7
73;2021-03-22;1182;388;45711;20689;10.6;4.8
73;2021-03-23;1447;231;47158;20920;10.9;4.8
73;2021-03-24;1592;342;48750;21262;11.3;4.9
73;2021-03-25;2061;381;50811;21643;11.7;5.0
73;2021-03-26;2471;357;53282;22000;12.3;5.1
73;2021-03-27;886;143;54168;22143;12.5;5.1
73;2021-03-28;310;10;54478;22153;12.6;5.1
73;2021-03-29;1509;234;55987;22387;12.9;5.2
73;2021-03-30;2086;476;58073;22863;13.4;5.3
73;2021-03-31;2088;394;60161;23257;13.9;5.4
73;2021-04-01;2087;328;62248;23585;14.4;5.5
73;2021-04-02;2355;216;64603;23801;14.9;5.5
73;2021-04-03;848;145;65451;23946;15.1;5.5
73;2021-04-04;188;18;65639;23964;15.2;5.5
73;2021-04-05;212;25;65851;23989;15.2;5.5
73;2021-04-06;1506;500;67357;24489;15.6;5.7
73;2021-04-07;1947;643;69304;25132;16.0;5.8
73;2021-04-08;2491;812;71795;25944;16.6;6.0
73;2021-04-09;3060;508;74855;26452;17.3;6.1
73;2021-04-10;1134;312;75989;26764;17.6;6.2
73;2021-04-11;163;8;76152;26772;17.6;6.2
73;2021-04-12;1698;972;77850;27744;18.0;6.4
73;2021-04-13;1892;1123;79742;28867;18.4;6.7
73;2021-04-14;2016;1085;81758;29952;18.9;6.9
73;2021-04-15;2415;1167;84173;31119;19.5;7.2
73;2021-04-16;1893;926;86066;32045;19.9;7.4
73;2021-04-17;1176;554;87242;32599;20.2;7.5
73;2021-04-18;155;75;87397;32674;20.2;7.6
73;2021-04-19;1381;1052;88778;33726;20.5;7.8
73;2021-04-20;1790;1310;90568;35036;20.9;8.1
73;2021-04-21;1574;1298;92142;36334;21.3;8.4
73;2021-04-22;1814;1221;93956;37555;21.7;8.7
73;2021-04-23;1896;1249;95852;38804;22.2;9.0
73;2021-04-24;980;669;96832;39473;22.4;9.1
73;2021-04-25;79;97;96911;39570;22.4;9.1
73;2021-04-26;1165;1317;98076;40887;22.7;9.5
73;2021-04-27;1441;1465;99517;42352;23.0;9.8
73;2021-04-28;1732;1458;101249;43810;23.4;10.1
73;2021-04-29;2412;1564;103661;45374;24.0;10.5
73;2021-04-30;2398;1437;106059;46811;24.5;10.8
73;2021-05-01;1068;304;107127;47115;24.8;10.9
73;2021-05-02;34;165;107161;47280;24.8;10.9
73;2021-05-03;1393;1590;108554;48870;25.1;11.3
73;2021-05-04;1706;1829;110260;50699;25.5;11.7
73;2021-05-05;1973;1683;112233;52382;25.9;12.1
73;2021-05-06;2429;1698;114662;54080;26.5;12.5
73;2021-05-07;2261;1847;116923;55927;27.0;12.9
73;2021-05-08;1835;378;118758;56305;27.5;13.0
73;2021-05-09;127;122;118885;56427;27.5;13.0
73;2021-05-10;1606;1888;120491;58315;27.9;13.5
73;2021-05-11;2378;2367;122869;60682;28.4;14.0
73;2021-05-12;3554;2090;126423;62772;29.2;14.5
73;2021-05-13;1554;273;127977;63045;29.6;14.6
73;2021-05-14;1586;1487;129563;64532;30.0;14.9
73;2021-05-15;1445;942;131008;65474;30.3;15.1
73;2021-05-16;131;62;131139;65536;30.3;15.2
73;2021-05-17;1709;1949;132848;67485;30.7;15.6
73;2021-05-18;2495;1733;135343;69218;31.3;16.0
73;2021-05-19;2540;1622;137883;70840;31.9;16.4
73;2021-05-20;3162;1501;141045;72341;32.6;16.7
73;2021-05-21;2473;1848;143518;74189;33.2;17.2
73;2021-05-22;1989;921;145507;75110;33.6;17.4
73;2021-05-23;211;14;145718;75124;33.7;17.4
73;2021-05-24;2565;329;148283;75453;34.3;17.4
73;2021-05-25;2139;1740;150422;77193;34.8;17.8
73;2021-05-26;2343;1999;152765;79192;35.3;18.3
73;2021-05-27;3083;1711;155848;80903;36.0;18.7
73;2021-05-28;2917;2374;158765;83277;36.7;19.3
73;2021-05-29;2317;1321;161082;84598;37.2;19.6
73;2021-05-30;186;14;161268;84612;37.3;19.6
73;2021-05-31;2410;1628;163678;86240;37.8;19.9
73;2021-06-01;3177;1790;166855;88030;38.6;20.4
73;2021-06-02;3101;1459;169956;89489;39.3;20.7
73;2021-06-03;4422;1742;174378;91231;40.3;21.1
73;2021-06-04;4277;2181;178655;93412;41.3;21.6
73;2021-06-05;3157;1279;181812;94691;42.0;21.9
73;2021-06-06;1882;298;183694;94989;42.5;22.0
73;2021-06-07;2755;2146;186449;97135;43.1;22.5
73;2021-06-08;2685;1876;189134;99011;43.7;22.9
73;2021-06-09;2364;1789;191498;100800;44.3;23.3
73;2021-06-10;2005;1652;193503;102452;44.7;23.7
73;2021-06-11;2192;2442;195695;104894;45.2;24.3
73;2021-06-12;2245;1332;197940;106226;45.8;24.6
73;2021-06-13;44;82;197984;106308;45.8;24.6
73;2021-06-14;1348;2930;199332;109238;46.1;25.3
73;2021-06-15;1593;2756;200925;111994;46.5;25.9
73;2021-06-16;1466;2571;202391;114565;46.8;26.5
73;2021-06-17;944;1726;203335;116291;47.0;26.9
73;2021-06-18;1884;2931;205219;119222;47.4;27.6
73;2021-06-19;1419;1986;206638;121208;47.8;28.0
73;2021-06-20;448;306;207086;121514;47.9;28.1
73;2021-06-21;1110;2938;208196;124452;48.1;28.8
73;2021-06-22;1093;2871;209289;127323;48.4;29.4
73;2021-06-23;1082;3137;210371;130460;48.6;30.2
73;2021-06-24;881;1791;211252;132251;48.8;30.6
73;2021-06-25;1328;2800;212580;135051;49.1;31.2
73;2021-06-26;968;2398;213548;137449;49.4;31.8
73;2021-06-27;328;548;213876;137997;49.4;31.9
73;2021-06-28;963;3558;214839;141555;49.7;32.7
73;2021-06-29;1073;3335;215912;144890;49.9;33.5
73;2021-06-30;1234;3118;217146;148008;50.2;34.2
73;2021-07-01;1133;2364;218279;150372;50.5;34.8
73;2021-07-02;1205;3617;219484;153989;50.7;35.6
73;2021-07-03;958;2791;220442;156780;51.0;36.2
73;2021-07-04;301;618;220743;157398;51.0;36.4
73;2021-07-05;1152;3686;221895;161084;51.3;37.2
73;2021-07-06;1242;2945;223137;164029;51.6;37.9
73;2021-07-07;1432;2955;224569;166984;51.9;38.6
73;2021-07-08;1366;2300;225935;169284;52.2;39.1
73;2021-07-09;1429;4028;227364;173312;52.6;40.1
73;2021-07-10;884;3013;228248;176325;52.8;40.8
73;2021-07-11;561;1467;228809;177792;52.9;41.1
73;2021-07-12;1057;4206;229866;181998;53.1;42.1
73;2021-07-13;1725;4229;231591;186227;53.5;43.1
73;2021-07-14;1840;1914;233431;188141;54.0;43.5
73;2021-07-15;2735;3800;236166;191941;54.6;44.4
73;2021-07-16;2390;4010;238556;195951;55.2;45.3
73;2021-07-17;1501;2600;240057;198551;55.5;45.9
73;2021-07-18;1175;1217;241232;199768;55.8;46.2
73;2021-07-19;2420;3241;243652;203009;56.3;46.9
73;2021-07-20;3345;2845;246997;205854;57.1;47.6
73;2021-07-21;3366;2769;250363;208623;57.9;48.2
73;2021-07-22;2709;2209;253072;210832;58.5;48.7
73;2021-07-23;3381;2890;256453;213722;59.3;49.4
73;2021-07-24;2046;2268;258499;215990;59.8;49.9
73;2021-07-25;621;792;259120;216782;59.9;50.1
73;2021-07-26;2614;2485;261734;219267;60.5;50.7
73;2021-07-27;3779;2256;265513;221523;61.4;51.2
73;2021-07-28;3512;2079;269025;223602;62.2;51.7
73;2021-07-29;3943;2133;272968;225735;63.1;52.2
73;2021-07-30;3536;2459;276504;228194;63.9;52.8
73;2021-07-31;2452;1577;278956;229771;64.5;53.1
73;2021-08-01;829;614;279785;230385;64.7;53.3
73;2021-08-02;3074;2083;282859;232468;65.4;53.7
73;2021-08-03;3475;1974;286334;234442;66.2;54.2
73;2021-08-04;3269;1998;289603;236440;67.0;54.7
73;2021-08-05;2844;2212;292447;238652;67.6;55.2
74;2020-12-27;3;0;3;0;0.0;0.0
74;2020-12-28;2;0;5;0;0.0;0.0
74;2020-12-29;0;0;5;0;0.0;0.0
74;2020-12-30;0;0;5;0;0.0;0.0
74;2020-12-31;0;0;5;0;0.0;0.0
74;2021-01-01;0;0;5;0;0.0;0.0
74;2021-01-02;1;1;6;1;0.0;0.0
74;2021-01-03;0;0;6;1;0.0;0.0
74;2021-01-04;0;0;6;1;0.0;0.0
74;2021-01-05;1;0;7;1;0.0;0.0
74;2021-01-06;44;0;51;1;0.0;0.0
74;2021-01-07;218;1;269;2;0.0;0.0
74;2021-01-08;291;1;560;3;0.1;0.0
74;2021-01-09;78;0;638;3;0.1;0.0
74;2021-01-10;73;0;711;3;0.1;0.0
74;2021-01-11;373;0;1084;3;0.1;0.0
74;2021-01-12;403;3;1487;6;0.2;0.0
74;2021-01-13;395;0;1882;6;0.2;0.0
74;2021-01-14;460;1;2342;7;0.3;0.0
74;2021-01-15;638;4;2980;11;0.4;0.0
74;2021-01-16;251;1;3231;12;0.4;0.0
74;2021-01-17;130;1;3361;13;0.4;0.0
74;2021-01-18;521;0;3882;13;0.5;0.0
74;2021-01-19;809;2;4691;15;0.6;0.0
74;2021-01-20;1275;4;5966;19;0.7;0.0
74;2021-01-21;1560;1;7526;20;0.9;0.0
74;2021-01-22;1221;6;8747;26;1.1;0.0
74;2021-01-23;344;1;9091;27;1.1;0.0
74;2021-01-24;90;0;9181;27;1.1;0.0
74;2021-01-25;795;2;9976;29;1.2;0.0
74;2021-01-26;1353;11;11329;40;1.4;0.0
74;2021-01-27;1073;10;12402;50;1.5;0.0
74;2021-01-28;985;29;13387;79;1.6;0.0
74;2021-01-29;877;42;14264;121;1.7;0.0
74;2021-01-30;304;1;14568;122;1.8;0.0
74;2021-01-31;84;1;14652;123;1.8;0.0
74;2021-02-01;627;44;15279;167;1.8;0.0
74;2021-02-02;641;155;15920;322;1.9;0.0
74;2021-02-03;603;124;16523;446;2.0;0.1
74;2021-02-04;612;136;17135;582;2.1;0.1
74;2021-02-05;544;226;17679;808;2.1;0.1
74;2021-02-06;268;140;17947;948;2.2;0.1
74;2021-02-07;93;127;18040;1075;2.2;0.1
74;2021-02-08;617;350;18657;1425;2.3;0.2
74;2021-02-09;535;534;19192;1959;2.3;0.2
74;2021-02-10;686;522;19878;2481;2.4;0.3
74;2021-02-11;1060;1019;20938;3500;2.5;0.4
74;2021-02-12;903;616;21841;4116;2.6;0.5
74;2021-02-13;400;240;22241;4356;2.7;0.5
74;2021-02-14;316;113;22557;4469;2.7;0.5
74;2021-02-15;276;854;22833;5323;2.8;0.6
74;2021-02-16;487;1069;23320;6392;2.8;0.8
74;2021-02-17;541;1113;23861;7505;2.9;0.9
74;2021-02-18;472;994;24333;8499;2.9;1.0
74;2021-02-19;618;656;24951;9155;3.0;1.1
74;2021-02-20;114;192;25065;9347;3.0;1.1
74;2021-02-21;46;62;25111;9409;3.0;1.1
74;2021-02-22;316;785;25427;10194;3.1;1.2
74;2021-02-23;303;824;25730;11018;3.1;1.3
74;2021-02-24;239;682;25969;11700;3.1;1.4
74;2021-02-25;518;752;26487;12452;3.2;1.5
74;2021-02-26;971;700;27458;13152;3.3;1.6
74;2021-02-27;254;186;27712;13338;3.3;1.6
74;2021-02-28;124;71;27836;13409;3.4;1.6
74;2021-03-01;719;631;28555;14040;3.4;1.7
74;2021-03-02;1088;684;29643;14724;3.6;1.8
74;2021-03-03;1009;632;30652;15356;3.7;1.9
74;2021-03-04;1606;1013;32258;16369;3.9;2.0
74;2021-03-05;2083;894;34341;17263;4.1;2.1
74;2021-03-06;1750;320;36091;17583;4.4;2.1
74;2021-03-07;1383;105;37474;17688;4.5;2.1
74;2021-03-08;1194;956;38668;18644;4.7;2.3
74;2021-03-09;1944;657;40612;19301;4.9;2.3
74;2021-03-10;1741;905;42353;20206;5.1;2.4
74;2021-03-11;2439;713;44792;20919;5.4;2.5
74;2021-03-12;3239;1004;48031;21923;5.8;2.6
74;2021-03-13;1995;270;50026;22193;6.0;2.7
74;2021-03-14;607;101;50633;22294;6.1;2.7
74;2021-03-15;2121;549;52754;22843;6.4;2.8
74;2021-03-16;1951;403;54705;23246;6.6;2.8
74;2021-03-17;1969;308;56674;23554;6.8;2.8
74;2021-03-18;2127;283;58801;23837;7.1;2.9
74;2021-03-19;2626;289;61427;24126;7.4;2.9
74;2021-03-20;1373;88;62800;24214;7.6;2.9
74;2021-03-21;287;30;63087;24244;7.6;2.9
74;2021-03-22;2045;314;65132;24558;7.9;3.0
74;2021-03-23;2715;323;67847;24881;8.2;3.0
74;2021-03-24;2938;286;70785;25167;8.5;3.0
74;2021-03-25;3865;287;74650;25454;9.0;3.1
74;2021-03-26;4087;369;78737;25823;9.5;3.1
74;2021-03-27;1936;246;80673;26069;9.7;3.1
74;2021-03-28;437;76;81110;26145;9.8;3.2
74;2021-03-29;3029;708;84139;26853;10.2;3.2
74;2021-03-30;3539;753;87678;27606;10.6;3.3
74;2021-03-31;3136;711;90814;28317;11.0;3.4
74;2021-04-01;4220;876;95034;29193;11.5;3.5
74;2021-04-02;3698;768;98732;29961;11.9;3.6
74;2021-04-03;1693;534;100425;30495;12.1;3.7
74;2021-04-04;235;120;100660;30615;12.2;3.7
74;2021-04-05;431;16;101091;30631;12.2;3.7
74;2021-04-06;2620;1205;103711;31836;12.5;3.8
74;2021-04-07;3184;1233;106895;33069;12.9;4.0
74;2021-04-08;3858;1168;110753;34237;13.4;4.1
74;2021-04-09;4095;1162;114848;35399;13.9;4.3
74;2021-04-10;1945;1034;116793;36433;14.1;4.4
74;2021-04-11;252;182;117045;36615;14.1;4.4
74;2021-04-12;2712;1767;119757;38382;14.5;4.6
74;2021-04-13;3111;2083;122868;40465;14.8;4.9
74;2021-04-14;2891;1947;125759;42412;15.2;5.1
74;2021-04-15;3450;1892;129209;44304;15.6;5.3
74;2021-04-16;3376;1766;132585;46070;16.0;5.6
74;2021-04-17;1930;1031;134515;47101;16.2;5.7
74;2021-04-18;218;206;134733;47307;16.3;5.7
74;2021-04-19;2096;2092;136829;49399;16.5;6.0
74;2021-04-20;3060;2413;139889;51812;16.9;6.3
74;2021-04-21;2460;2367;142349;54179;17.2;6.5
74;2021-04-22;2622;2317;144971;56496;17.5;6.8
74;2021-04-23;2560;2234;147531;58730;17.8;7.1
74;2021-04-24;1484;1535;149015;60265;18.0;7.3
74;2021-04-25;224;150;149239;60415;18.0;7.3
74;2021-04-26;2388;2454;151627;62869;18.3;7.6
74;2021-04-27;3266;2899;154893;65768;18.7;7.9
74;2021-04-28;3459;2619;158352;68387;19.1;8.3
74;2021-04-29;3910;2660;162262;71047;19.6;8.6
74;2021-04-30;4074;2208;166336;73255;20.1;8.8
74;2021-05-01;2117;369;168453;73624;20.3;8.9
74;2021-05-02;204;234;168657;73858;20.4;8.9
74;2021-05-03;2594;2998;171251;76856;20.7;9.3
74;2021-05-04;3220;3089;174471;79945;21.1;9.7
74;2021-05-05;3395;3009;177866;82954;21.5;10.0
74;2021-05-06;3856;2624;181722;85578;21.9;10.3
74;2021-05-07;3594;3535;185316;89113;22.4;10.8
74;2021-05-08;1148;820;186464;89933;22.5;10.9
74;2021-05-09;193;248;186657;90181;22.5;10.9
74;2021-05-10;3468;3135;190125;93316;23.0;11.3
74;2021-05-11;4322;3427;194447;96743;23.5;11.7
74;2021-05-12;5297;2954;199744;99697;24.1;12.0
74;2021-05-13;2361;945;202105;100642;24.4;12.1
74;2021-05-14;5944;2388;208049;103030;25.1;12.4
74;2021-05-15;4515;1851;212564;104881;25.7;12.7
74;2021-05-16;3005;335;215569;105216;26.0;12.7
74;2021-05-17;5397;2876;220966;108092;26.7;13.0
74;2021-05-18;6776;2797;227742;110889;27.5;13.4
74;2021-05-19;6229;2291;233971;113180;28.2;13.7
74;2021-05-20;6641;2545;240612;115725;29.0;14.0
74;2021-05-21;6524;2978;247136;118703;29.8;14.3
74;2021-05-22;5290;1568;252426;120271;30.5;14.5
74;2021-05-23;2050;282;254476;120553;30.7;14.6
74;2021-05-24;2359;661;256835;121214;31.0;14.6
74;2021-05-25;5067;3333;261902;124547;31.6;15.0
74;2021-05-26;5249;2558;267151;127105;32.2;15.3
74;2021-05-27;5999;2981;273150;130086;33.0;15.7
74;2021-05-28;5658;3580;278808;133666;33.7;16.1
74;2021-05-29;3795;2146;282603;135812;34.1;16.4
74;2021-05-30;487;308;283090;136120;34.2;16.4
74;2021-05-31;5069;3550;288159;139670;34.8;16.9
74;2021-06-01;4921;3720;293080;143390;35.4;17.3
74;2021-06-02;5255;3199;298335;146589;36.0;17.7
74;2021-06-03;6887;3245;305222;149834;36.8;18.1
74;2021-06-04;6902;4426;312124;154260;37.7;18.6
74;2021-06-05;4610;2708;316734;156968;38.2;18.9
74;2021-06-06;123;112;316857;157080;38.2;19.0
74;2021-06-07;5027;4143;321884;161223;38.9;19.5
74;2021-06-08;5017;3945;326901;165168;39.5;19.9
74;2021-06-09;5068;3483;331969;168651;40.1;20.4
74;2021-06-10;5118;2869;337087;171520;40.7;20.7
74;2021-06-11;5211;3804;342298;175324;41.3;21.2
74;2021-06-12;3570;2382;345868;177706;41.8;21.5
74;2021-06-13;118;89;345986;177795;41.8;21.5
74;2021-06-14;3593;4485;349579;182280;42.2;22.0
74;2021-06-15;3663;3898;353242;186178;42.6;22.5
74;2021-06-16;4814;3121;358056;189299;43.2;22.9
74;2021-06-17;3814;2953;361870;192252;43.7;23.2
74;2021-06-18;4109;4662;365979;196914;44.2;23.8
74;2021-06-19;2993;3099;368972;200013;44.5;24.1
74;2021-06-20;123;97;369095;200110;44.6;24.2
74;2021-06-21;2380;5421;371475;205531;44.8;24.8
74;2021-06-22;2487;5313;373962;210844;45.1;25.5
74;2021-06-23;2963;4615;376925;215459;45.5;26.0
74;2021-06-24;2854;4627;379779;220086;45.8;26.6
74;2021-06-25;2920;6768;382699;226854;46.2;27.4
74;2021-06-26;1705;5397;384404;232251;46.4;28.0
74;2021-06-27;63;1664;384467;233915;46.4;28.2
74;2021-06-28;1914;7219;386381;241134;46.6;29.1
74;2021-06-29;2297;7417;388678;248551;46.9;30.0
74;2021-06-30;2730;6541;391408;255092;47.2;30.8
74;2021-07-01;3051;5406;394459;260498;47.6;31.4
74;2021-07-02;2995;6631;397454;267129;48.0;32.2
74;2021-07-03;1695;5081;399149;272210;48.2;32.9
74;2021-07-04;79;1022;399228;273232;48.2;33.0
74;2021-07-05;2031;6841;401259;280073;48.4;33.8
74;2021-07-06;2554;6489;403813;286562;48.7;34.6
74;2021-07-07;2943;5446;406756;292008;49.1;35.2
74;2021-07-08;3773;4897;410529;296905;49.6;35.8
74;2021-07-09;2597;6976;413126;303881;49.9;36.7
74;2021-07-10;1601;5130;414727;309011;50.1;37.3
74;2021-07-11;72;141;414799;309152;50.1;37.3
74;2021-07-12;2054;7899;416853;317051;50.3;38.3
74;2021-07-13;3930;7579;420783;324630;50.8;39.2
74;2021-07-14;1952;2237;422735;326867;51.0;39.5
74;2021-07-15;3547;6862;426282;333729;51.5;40.3
74;2021-07-16;4140;7741;430422;341470;52.0;41.2
74;2021-07-17;2818;5322;433240;346792;52.3;41.9
74;2021-07-18;149;157;433389;346949;52.3;41.9
74;2021-07-19;4230;7334;437619;354283;52.8;42.8
74;2021-07-20;5759;6447;443378;360730;53.5;43.5
74;2021-07-21;5498;6655;448876;367385;54.2;44.3
74;2021-07-22;4718;5315;453594;372700;54.8;45.0
74;2021-07-23;6062;6959;459656;379659;55.5;45.8
74;2021-07-24;3025;4308;462681;383967;55.9;46.4
74;2021-07-25;160;174;462841;384141;55.9;46.4
74;2021-07-26;5408;6103;468249;390244;56.5;47.1
74;2021-07-27;6719;5142;474968;395386;57.3;47.7
74;2021-07-28;6431;5088;481399;400474;58.1;48.3
74;2021-07-29;5229;3913;486628;404387;58.7;48.8
74;2021-07-30;6595;5462;493223;409849;59.5;49.5
74;2021-07-31;4324;3096;497547;412945;60.1;49.8
74;2021-08-01;176;151;497723;413096;60.1;49.9
74;2021-08-02;5816;4353;503539;417449;60.8;50.4
74;2021-08-03;5808;3819;509347;421268;61.5;50.9
74;2021-08-04;6016;3443;515363;424711;62.2;51.3
74;2021-08-05;4832;3215;520195;427926;62.8;51.7
75;2020-12-27;34;1;34;1;0.0;0.0
75;2020-12-28;44;0;78;1;0.0;0.0
75;2020-12-29;15;0;93;1;0.0;0.0
75;2020-12-30;43;0;136;1;0.0;0.0
75;2020-12-31;31;0;167;1;0.0;0.0
75;2021-01-01;34;2;201;3;0.0;0.0
75;2021-01-02;56;1;257;4;0.0;0.0
75;2021-01-03;92;0;349;4;0.0;0.0
75;2021-01-04;294;1;643;5;0.0;0.0
75;2021-01-05;863;13;1506;18;0.1;0.0
75;2021-01-06;1347;16;2853;34;0.1;0.0
75;2021-01-07;2058;18;4911;52;0.2;0.0
75;2021-01-08;2859;31;7770;83;0.4;0.0
75;2021-01-09;1089;2;8859;85;0.4;0.0
75;2021-01-10;1094;5;9953;90;0.5;0.0
75;2021-01-11;3070;46;13023;136;0.6;0.0
75;2021-01-12;3469;54;16492;190;0.8;0.0
75;2021-01-13;3543;43;20035;233;0.9;0.0
75;2021-01-14;3665;61;23700;294;1.1;0.0
75;2021-01-15;3299;45;26999;339;1.3;0.0
75;2021-01-16;1123;16;28122;355;1.3;0.0
75;2021-01-17;543;14;28665;369;1.3;0.0
75;2021-01-18;3252;74;31917;443;1.5;0.0
75;2021-01-19;3843;45;35760;488;1.7;0.0
75;2021-01-20;4379;64;40139;552;1.9;0.0
75;2021-01-21;4884;79;45023;631;2.1;0.0
75;2021-01-22;4558;81;49581;712;2.3;0.0
75;2021-01-23;1749;14;51330;726;2.4;0.0
75;2021-01-24;734;6;52064;732;2.4;0.0
75;2021-01-25;1696;25;53760;757;2.5;0.0
75;2021-01-26;2537;87;56297;844;2.6;0.0
75;2021-01-27;3089;160;59386;1004;2.8;0.0
75;2021-01-28;4750;262;64136;1266;3.0;0.1
75;2021-01-29;4033;267;68169;1533;3.2;0.1
75;2021-01-30;1349;34;69518;1567;3.2;0.1
75;2021-01-31;212;3;69730;1570;3.2;0.1
75;2021-02-01;1604;380;71334;1950;3.3;0.1
75;2021-02-02;2122;650;73456;2600;3.4;0.1
75;2021-02-03;1869;687;75325;3287;3.5;0.2
75;2021-02-04;2125;1130;77450;4417;3.6;0.2
75;2021-02-05;2189;869;79639;5286;3.7;0.2
75;2021-02-06;1083;93;80722;5379;3.8;0.3
75;2021-02-07;164;6;80886;5385;3.8;0.3
75;2021-02-08;1240;1473;82126;6858;3.8;0.3
75;2021-02-09;1750;2384;83876;9242;3.9;0.4
75;2021-02-10;2394;2403;86270;11645;4.0;0.5
75;2021-02-11;2914;6448;89184;18093;4.2;0.8
75;2021-02-12;3099;2410;92283;20503;4.3;1.0
75;2021-02-13;839;1057;93122;21560;4.3;1.0
75;2021-02-14;193;42;93315;21602;4.3;1.0
75;2021-02-15;986;2473;94301;24075;4.4;1.1
75;2021-02-16;1423;6553;95724;30628;4.5;1.4
75;2021-02-17;1298;3238;97022;33866;4.5;1.6
75;2021-02-18;1739;5875;98761;39741;4.6;1.8
75;2021-02-19;2198;4145;100959;43886;4.7;2.0
75;2021-02-20;466;1694;101425;45580;4.7;2.1
75;2021-02-21;184;160;101609;45740;4.7;2.1
75;2021-02-22;1199;1934;102808;47674;4.8;2.2
75;2021-02-23;1427;2727;104235;50401;4.9;2.3
75;2021-02-24;1671;2340;105906;52741;4.9;2.5
75;2021-02-25;2757;5338;108663;58079;5.1;2.7
75;2021-02-26;3338;2735;112001;60814;5.2;2.8
75;2021-02-27;1388;937;113389;61751;5.3;2.9
75;2021-02-28;313;141;113702;61892;5.3;2.9
75;2021-03-01;2575;1686;116277;63578;5.4;3.0
75;2021-03-02;4137;2208;120414;65786;5.6;3.1
75;2021-03-03;5381;2342;125795;68128;5.9;3.2
75;2021-03-04;8001;2586;133796;70714;6.2;3.3
75;2021-03-05;10504;2747;144300;73461;6.7;3.4
75;2021-03-06;11031;1068;155331;74529;7.2;3.5
75;2021-03-07;9473;1512;164804;76041;7.7;3.5
75;2021-03-08;5853;1566;170657;77607;7.9;3.6
75;2021-03-09;7481;2128;178138;79735;8.3;3.7
75;2021-03-10;7455;2117;185593;81852;8.6;3.8
75;2021-03-11;10286;2512;195879;84364;9.1;3.9
75;2021-03-12;12018;2534;207897;86898;9.7;4.0
75;2021-03-13;8514;759;216411;87657;10.1;4.1
75;2021-03-14;4146;234;220557;87891;10.3;4.1
75;2021-03-15;7412;964;227969;88855;10.6;4.1
75;2021-03-16;5120;680;233089;89535;10.9;4.2
75;2021-03-17;5387;826;238476;90361;11.1;4.2
75;2021-03-18;6578;865;245054;91226;11.4;4.2
75;2021-03-19;9705;976;254759;92202;11.9;4.3
75;2021-03-20;5900;605;260659;92807;12.1;4.3
75;2021-03-21;1569;433;262228;93240;12.2;4.3
75;2021-03-22;8592;1013;270820;94253;12.6;4.4
75;2021-03-23;10913;1241;281733;95494;13.1;4.4
75;2021-03-24;10949;1315;292682;96809;13.6;4.5
75;2021-03-25;14163;1511;306845;98320;14.3;4.6
75;2021-03-26;13922;1673;320767;99993;14.9;4.7
75;2021-03-27;7248;771;328015;100764;15.3;4.7
75;2021-03-28;1765;147;329780;100911;15.4;4.7
75;2021-03-29;7933;2214;337713;103125;15.7;4.8
75;2021-03-30;10873;3242;348586;106367;16.2;5.0
75;2021-03-31;9698;3607;358284;109974;16.7;5.1
75;2021-04-01;10632;5204;368916;115178;17.2;5.4
75;2021-04-02;9008;5569;377924;120747;17.6;5.6
75;2021-04-03;4095;4893;382019;125640;17.8;5.8
75;2021-04-04;1402;1500;383421;127140;17.8;5.9
75;2021-04-05;2214;1439;385635;128579;18.0;6.0
75;2021-04-06;6845;4307;392480;132886;18.3;6.2
75;2021-04-07;8032;4418;400512;137304;18.6;6.4
75;2021-04-08;11021;4155;411533;141459;19.2;6.6
75;2021-04-09;12161;4595;423694;146054;19.7;6.8
75;2021-04-10;5805;4273;429499;150327;20.0;7.0
75;2021-04-11;1908;1796;431407;152123;20.1;7.1
75;2021-04-12;7441;3782;438848;155905;20.4;7.3
75;2021-04-13;8530;6868;447378;162773;20.8;7.6
75;2021-04-14;8244;5221;455622;167994;21.2;7.8
75;2021-04-15;8854;6128;464476;174122;21.6;8.1
75;2021-04-16;9331;6110;473807;180232;22.1;8.4
75;2021-04-17;4806;3653;478613;183885;22.3;8.6
75;2021-04-18;1649;879;480262;184764;22.4;8.6
75;2021-04-19;5547;4942;485809;189706;22.6;8.8
75;2021-04-20;6427;5951;492236;195657;22.9;9.1
75;2021-04-21;6831;5569;499067;201226;23.2;9.4
75;2021-04-22;7510;5914;506577;207140;23.6;9.6
75;2021-04-23;8458;6269;515035;213409;24.0;9.9
75;2021-04-24;6146;3340;521181;216749;24.3;10.1
75;2021-04-25;2946;757;524127;217506;24.4;10.1
75;2021-04-26;7012;4725;531139;222231;24.7;10.3
75;2021-04-27;10562;6418;541701;228649;25.2;10.6
75;2021-04-28;12168;6023;553869;234672;25.8;10.9
75;2021-04-29;13731;6323;567600;240995;26.4;11.2
75;2021-04-30;13643;6166;581243;247161;27.1;11.5
75;2021-05-01;5058;1326;586301;248487;27.3;11.6
75;2021-05-02;2375;792;588676;249279;27.4;11.6
75;2021-05-03;10262;13536;598938;262815;27.9;12.2
75;2021-05-04;11149;8070;610087;270885;28.4;12.6
75;2021-05-05;13517;6706;623604;277591;29.0;12.9
75;2021-05-06;13975;8184;637579;285775;29.7;13.3
75;2021-05-07;13950;8584;651529;294359;30.3;13.7
75;2021-05-08;10051;5525;661580;299884;30.8;14.0
75;2021-05-09;3809;3201;665389;303085;31.0;14.1
75;2021-05-10;14270;6720;679659;309805;31.6;14.4
75;2021-05-11;16818;8426;696477;318231;32.4;14.8
75;2021-05-12;17929;8163;714406;326394;33.3;15.2
75;2021-05-13;13600;2506;728006;328900;33.9;15.3
75;2021-05-14;18357;5143;746363;334043;34.7;15.5
75;2021-05-15;12279;2639;758642;336682;35.3;15.7
75;2021-05-16;3837;762;762479;337444;35.5;15.7
75;2021-05-17;15969;4654;778448;342098;36.2;15.9
75;2021-05-18;19115;5326;797563;347424;37.1;16.2
75;2021-05-19;20690;10733;818253;358157;38.1;16.7
75;2021-05-20;21550;8676;839803;366833;39.1;17.1
75;2021-05-21;20999;6548;860802;373381;40.1;17.4
75;2021-05-22;15913;3311;876715;376692;40.8;17.5
75;2021-05-23;5618;1338;882333;378030;41.1;17.6
75;2021-05-24;15618;2567;897951;380597;41.8;17.7
75;2021-05-25;17983;9596;915934;390193;42.6;18.2
75;2021-05-26;18836;8215;934770;398408;43.5;18.5
75;2021-05-27;20112;9821;954882;408229;44.4;19.0
75;2021-05-28;19320;10871;974202;419100;45.3;19.5
75;2021-05-29;16101;5836;990303;424936;46.1;19.8
75;2021-05-30;7023;2143;997326;427079;46.4;19.9
75;2021-05-31;18076;9462;1015402;436541;47.3;20.3
75;2021-06-01;18560;12994;1033962;449535;48.1;20.9
75;2021-06-02;18069;10301;1052031;459836;49.0;21.4
75;2021-06-03;20164;11967;1072195;471803;49.9;22.0
75;2021-06-04;18082;12878;1090277;484681;50.8;22.6
75;2021-06-05;11957;9628;1102234;494309;51.3;23.0
75;2021-06-06;6699;3160;1108933;497469;51.6;23.2
75;2021-06-07;13851;11845;1122784;509314;52.3;23.7
75;2021-06-08;14756;13973;1137540;523287;53.0;24.4
75;2021-06-09;16430;15249;1153970;538536;53.7;25.1
75;2021-06-10;18287;26329;1172257;564865;54.6;26.3
75;2021-06-11;15193;16471;1187450;581336;55.3;27.1
75;2021-06-12;13264;9997;1200714;591333;55.9;27.5
75;2021-06-13;6260;3792;1206974;595125;56.2;27.7
75;2021-06-14;11771;15425;1218745;610550;56.7;28.4
75;2021-06-15;12497;19547;1231242;630097;57.3;29.3
75;2021-06-16;12091;17234;1243333;647331;57.9;30.1
75;2021-06-17;12575;17678;1255908;665009;58.5;31.0
75;2021-06-18;10679;22617;1266587;687626;59.0;32.0
75;2021-06-19;7507;11833;1274094;699459;59.3;32.6
75;2021-06-20;2807;5487;1276901;704946;59.4;32.8
75;2021-06-21;8386;16338;1285287;721284;59.8;33.6
75;2021-06-22;8736;21815;1294023;743099;60.2;34.6
75;2021-06-23;10242;21422;1304265;764521;60.7;35.6
75;2021-06-24;11257;20633;1315522;785154;61.2;36.5
75;2021-06-25;9751;24697;1325273;809851;61.7;37.7
75;2021-06-26;7912;15420;1333185;825271;62.1;38.4
75;2021-06-27;2687;6329;1335872;831600;62.2;38.7
75;2021-06-28;8402;20135;1344274;851735;62.6;39.6
75;2021-06-29;9278;23835;1353552;875570;63.0;40.8
75;2021-06-30;9958;23609;1363510;899179;63.5;41.9
75;2021-07-01;11056;23479;1374566;922658;64.0;42.9
75;2021-07-02;10223;24761;1384789;947419;64.5;44.1
75;2021-07-03;7738;19812;1392527;967231;64.8;45.0
75;2021-07-04;3884;9556;1396411;976787;65.0;45.5
75;2021-07-05;8801;21555;1405212;998342;65.4;46.5
75;2021-07-06;9864;23997;1415076;1022339;65.9;47.6
75;2021-07-07;9795;25082;1424871;1047421;66.3;48.8
75;2021-07-08;10415;24991;1435286;1072412;66.8;49.9
75;2021-07-09;10275;24007;1445561;1096419;67.3;51.0
75;2021-07-10;7840;18504;1453401;1114923;67.7;51.9
75;2021-07-11;4324;8535;1457725;1123458;67.9;52.3
75;2021-07-12;9175;23062;1466900;1146520;68.3;53.4
75;2021-07-13;14021;24788;1480921;1171308;68.9;54.5
75;2021-07-14;8081;9690;1489002;1180998;69.3;55.0
75;2021-07-15;14900;25641;1503902;1206639;70.0;56.2
75;2021-07-16;15185;22086;1519087;1228725;70.7;57.2
75;2021-07-17;11386;16867;1530473;1245592;71.2;58.0
75;2021-07-18;6200;6804;1536673;1252396;71.5;58.3
75;2021-07-19;14071;21262;1550744;1273658;72.2;59.3
75;2021-07-20;15831;21822;1566575;1295480;72.9;60.3
75;2021-07-21;15455;20670;1582030;1316150;73.6;61.3
75;2021-07-22;16834;20034;1598864;1336184;74.4;62.2
75;2021-07-23;16695;18986;1615559;1355170;75.2;63.1
75;2021-07-24;10888;14012;1626447;1369182;75.7;63.7
75;2021-07-25;4936;5064;1631383;1374246;75.9;64.0
75;2021-07-26;14937;16804;1646320;1391050;76.6;64.8
75;2021-07-27;17793;16501;1664113;1407551;77.5;65.5
75;2021-07-28;16862;15357;1680975;1422908;78.2;66.2
75;2021-07-29;16507;14956;1697482;1437864;79.0;66.9
75;2021-07-30;15960;14194;1713442;1452058;79.8;67.6
75;2021-07-31;9155;9801;1722597;1461859;80.2;68.0
75;2021-08-01;3438;3266;1726035;1465125;80.3;68.2
75;2021-08-02;10295;11855;1736330;1476980;80.8;68.8
75;2021-08-03;10696;10707;1747026;1487687;81.3;69.3
75;2021-08-04;9212;9370;1756238;1497057;81.8;69.7
75;2021-08-05;8137;9397;1764375;1506454;82.1;70.1
76;2020-12-27;0;0;0;0;0.0;0.0
76;2020-12-28;0;0;0;0;0.0;0.0
76;2020-12-29;0;0;0;0;0.0;0.0
76;2020-12-30;0;0;0;0;0.0;0.0
76;2020-12-31;0;0;0;0;0.0;0.0
76;2021-01-01;0;0;0;0;0.0;0.0
76;2021-01-02;0;0;0;0;0.0;0.0
76;2021-01-03;0;0;0;0;0.0;0.0
76;2021-01-04;17;0;17;0;0.0;0.0
76;2021-01-05;138;0;155;0;0.0;0.0
76;2021-01-06;682;2;837;2;0.1;0.0
76;2021-01-07;1355;6;2192;8;0.2;0.0
76;2021-01-08;1534;1;3726;9;0.3;0.0
76;2021-01-09;736;2;4462;11;0.4;0.0
76;2021-01-10;492;1;4954;12;0.4;0.0
76;2021-01-11;1358;2;6312;14;0.5;0.0
76;2021-01-12;1357;1;7669;15;0.6;0.0
76;2021-01-13;1187;5;8856;20;0.7;0.0
76;2021-01-14;2173;22;11029;42;0.9;0.0
76;2021-01-15;1910;6;12939;48;1.0;0.0
76;2021-01-16;987;5;13926;53;1.1;0.0
76;2021-01-17;2898;19;16824;72;1.4;0.0
76;2021-01-18;4387;15;21211;87;1.7;0.0
76;2021-01-19;3012;7;24223;94;1.9;0.0
76;2021-01-20;2068;9;26291;103;2.1;0.0
76;2021-01-21;1773;4;28064;107;2.3;0.0
76;2021-01-22;1704;4;29768;111;2.4;0.0
76;2021-01-23;449;1;30217;112;2.4;0.0
76;2021-01-24;99;0;30316;112;2.4;0.0
76;2021-01-25;1474;140;31790;252;2.6;0.0
76;2021-01-26;1389;335;33179;587;2.7;0.0
76;2021-01-27;1340;432;34519;1019;2.8;0.1
76;2021-01-28;1283;384;35802;1403;2.9;0.1
76;2021-01-29;1152;460;36954;1863;3.0;0.1
76;2021-01-30;283;303;37237;2166;3.0;0.2
76;2021-01-31;4;99;37241;2265;3.0;0.2
76;2021-02-01;838;817;38079;3082;3.1;0.2
76;2021-02-02;1056;1019;39135;4101;3.1;0.3
76;2021-02-03;917;1000;40052;5101;3.2;0.4
76;2021-02-04;975;1457;41027;6558;3.3;0.5
76;2021-02-05;974;1105;42001;7663;3.4;0.6
76;2021-02-06;260;880;42261;8543;3.4;0.7
76;2021-02-07;467;1658;42728;10201;3.4;0.8
76;2021-02-08;1922;3735;44650;13936;3.6;1.1
76;2021-02-09;1757;2999;46407;16935;3.7;1.4
76;2021-02-10;1488;1814;47895;18749;3.9;1.5
76;2021-02-11;1675;1530;49570;20279;4.0;1.6
76;2021-02-12;1709;1578;51279;21857;4.1;1.8
76;2021-02-13;230;336;51509;22193;4.1;1.8
76;2021-02-14;9;82;51518;22275;4.1;1.8
76;2021-02-15;553;1723;52071;23998;4.2;1.9
76;2021-02-16;741;1639;52812;25637;4.2;2.1
76;2021-02-17;626;1455;53438;27092;4.3;2.2
76;2021-02-18;779;1391;54217;28483;4.4;2.3
76;2021-02-19;868;1346;55085;29829;4.4;2.4
76;2021-02-20;270;289;55355;30118;4.5;2.4
76;2021-02-21;0;0;55355;30118;4.5;2.4
76;2021-02-22;371;1313;55726;31431;4.5;2.5
76;2021-02-23;575;1242;56301;32673;4.5;2.6
76;2021-02-24;598;1201;56899;33874;4.6;2.7
76;2021-02-25;1666;1263;58565;35137;4.7;2.8
76;2021-02-26;2171;1049;60736;36186;4.9;2.9
76;2021-02-27;1108;270;61844;36456;5.0;2.9
76;2021-02-28;27;197;61871;36653;5.0;2.9
76;2021-03-01;823;2111;62694;38764;5.0;3.1
76;2021-03-02;1379;1715;64073;40479;5.2;3.3
76;2021-03-03;1940;1396;66013;41875;5.3;3.4
76;2021-03-04;2815;1103;68828;42978;5.5;3.5
76;2021-03-05;4176;797;73004;43775;5.9;3.5
76;2021-03-06;3361;151;76365;43926;6.1;3.5
76;2021-03-07;1257;31;77622;43957;6.2;3.5
76;2021-03-08;2098;1251;79720;45208;6.4;3.6
76;2021-03-09;3573;1158;83293;46366;6.7;3.7
76;2021-03-10;3592;1056;86885;47422;7.0;3.8
76;2021-03-11;5633;936;92518;48358;7.4;3.9
76;2021-03-12;6824;586;99342;48944;8.0;3.9
76;2021-03-13;4639;133;103981;49077;8.4;3.9
76;2021-03-14;1069;26;105050;49103;8.4;3.9
76;2021-03-15;2914;226;107964;49329;8.7;4.0
76;2021-03-16;2554;396;110518;49725;8.9;4.0
76;2021-03-17;2695;312;113213;50037;9.1;4.0
76;2021-03-18;2998;300;116211;50337;9.3;4.0
76;2021-03-19;4394;422;120605;50759;9.7;4.1
76;2021-03-20;3975;271;124580;51030;10.0;4.1
76;2021-03-21;837;13;125417;51043;10.1;4.1
76;2021-03-22;3992;339;129409;51382;10.4;4.1
76;2021-03-23;5708;345;135117;51727;10.9;4.2
76;2021-03-24;5668;378;140785;52105;11.3;4.2
76;2021-03-25;7508;559;148293;52664;11.9;4.2
76;2021-03-26;8717;568;157010;53232;12.6;4.3
76;2021-03-27;4810;365;161820;53597;13.0;4.3
76;2021-03-28;1021;27;162841;53624;13.1;4.3
76;2021-03-29;5390;816;168231;54440;13.5;4.4
76;2021-03-30;6584;1040;174815;55480;14.1;4.5
76;2021-03-31;6452;1242;181267;56722;14.6;4.6
76;2021-04-01;6782;2027;188049;58749;15.1;4.7
76;2021-04-02;6485;2666;194534;61415;15.6;4.9
76;2021-04-03;2443;1074;196977;62489;15.8;5.0
76;2021-04-04;263;11;197240;62500;15.9;5.0
76;2021-04-05;866;376;198106;62876;15.9;5.1
76;2021-04-06;3555;2790;201661;65666;16.2;5.3
76;2021-04-07;4416;2396;206077;68062;16.6;5.5
76;2021-04-08;5841;2763;211918;70825;17.0;5.7
76;2021-04-09;8803;3057;220721;73882;17.7;5.9
76;2021-04-10;4876;1402;225597;75284;18.1;6.1
76;2021-04-11;813;527;226410;75811;18.2;6.1
76;2021-04-12;4724;2845;231134;78656;18.6;6.3
76;2021-04-13;5925;2868;237059;81524;19.1;6.6
76;2021-04-14;4806;3140;241865;84664;19.4;6.8
76;2021-04-15;5562;3355;247427;88019;19.9;7.1
76;2021-04-16;7351;3437;254778;91456;20.5;7.4
76;2021-04-17;4386;1428;259164;92884;20.8;7.5
76;2021-04-18;339;140;259503;93024;20.9;7.5
76;2021-04-19;3477;3770;262980;96794;21.1;7.8
76;2021-04-20;4343;4274;267323;101068;21.5;8.1
76;2021-04-21;4188;4680;271511;105748;21.8;8.5
76;2021-04-22;4560;5437;276071;111185;22.2;8.9
76;2021-04-23;5437;5945;281508;117130;22.6;9.4
76;2021-04-24;4163;2180;285671;119310;23.0;9.6
76;2021-04-25;891;267;286562;119577;23.0;9.6
76;2021-04-26;4480;4472;291042;124049;23.4;10.0
76;2021-04-27;4995;5001;296037;129050;23.8;10.4
76;2021-04-28;5346;4159;301383;133209;24.2;10.7
76;2021-04-29;6926;4163;308309;137372;24.8;11.0
76;2021-04-30;8217;4637;316526;142009;25.4;11.4
76;2021-05-01;4827;1004;321353;143013;25.8;11.5
76;2021-05-02;1843;257;323196;143270;26.0;11.5
76;2021-05-03;4703;3317;327899;146587;26.4;11.8
76;2021-05-04;4821;4560;332720;151147;26.8;12.2
76;2021-05-05;4785;5177;337505;156324;27.1;12.6
76;2021-05-06;5922;5583;343427;161907;27.6;13.0
76;2021-05-07;6140;6755;349567;168662;28.1;13.6
76;2021-05-08;5055;895;354622;169557;28.5;13.6
76;2021-05-09;2536;234;357158;169791;28.7;13.7
76;2021-05-10;4949;5056;362107;174847;29.1;14.1
76;2021-05-11;6518;5674;368625;180521;29.6;14.5
76;2021-05-12;6266;5070;374891;185591;30.1;14.9
76;2021-05-13;8847;1275;383738;186866;30.9;15.0
76;2021-05-14;10416;4668;394154;191534;31.7;15.4
76;2021-05-15;9117;2452;403271;193986;32.4;15.6
76;2021-05-16;6232;475;409503;194461;32.9;15.6
76;2021-05-17;7226;3273;416729;197734;33.5;15.9
76;2021-05-18;8304;2807;425033;200541;34.2;16.1
76;2021-05-19;8405;3188;433438;203729;34.8;16.4
76;2021-05-20;9644;3413;443082;207142;35.6;16.7
76;2021-05-21;8368;4090;451450;211232;36.3;17.0
76;2021-05-22;7162;2353;458612;213585;36.9;17.2
76;2021-05-23;6390;407;465002;213992;37.4;17.2
76;2021-05-24;6867;1528;471869;215520;37.9;17.3
76;2021-05-25;8025;4080;479894;219600;38.6;17.7
76;2021-05-26;7573;3606;487467;223206;39.2;17.9
76;2021-05-27;8348;4700;495815;227906;39.9;18.3
76;2021-05-28;8234;6573;504049;234479;40.5;18.9
76;2021-05-29;6220;3516;510269;237995;41.0;19.1
76;2021-05-30;3146;430;513415;238425;41.3;19.2
76;2021-05-31;8167;3972;521582;242397;41.9;19.5
76;2021-06-01;9209;5027;530791;247424;42.7;19.9
76;2021-06-02;7926;4438;538717;251862;43.3;20.2
76;2021-06-03;9537;5405;548254;257267;44.1;20.7
76;2021-06-04;9243;6672;557497;263939;44.8;21.2
76;2021-06-05;6288;3810;563785;267749;45.3;21.5
76;2021-06-06;2552;650;566337;268399;45.5;21.6
76;2021-06-07;6983;5453;573320;273852;46.1;22.0
76;2021-06-08;8653;6280;581973;280132;46.8;22.5
76;2021-06-09;7211;6083;589184;286215;47.4;23.0
76;2021-06-10;7992;6563;597176;292778;48.0;23.5
76;2021-06-11;7581;8229;604757;301007;48.6;24.2
76;2021-06-12;7166;5871;611923;306878;49.2;24.7
76;2021-06-13;2961;1293;614884;308171;49.4;24.8
76;2021-06-14;6476;6715;621360;314886;50.0;25.3
76;2021-06-15;6132;7453;627492;322339;50.5;25.9
76;2021-06-16;6647;7481;634139;329820;51.0;26.5
76;2021-06-17;7001;7754;641140;337574;51.5;27.1
76;2021-06-18;7687;9232;648827;346806;52.2;27.9
76;2021-06-19;5984;6259;654811;353065;52.6;28.4
76;2021-06-20;2811;1812;657622;354877;52.9;28.5
76;2021-06-21;5554;8170;663176;363047;53.3;29.2
76;2021-06-22;4918;9870;668094;372917;53.7;30.0
76;2021-06-23;4726;9437;672820;382354;54.1;30.7
76;2021-06-24;4791;9912;677611;392266;54.5;31.5
76;2021-06-25;5221;11567;682832;403833;54.9;32.5
76;2021-06-26;3452;7874;686284;411707;55.2;33.1
76;2021-06-27;1365;5164;687649;416871;55.3;33.5
76;2021-06-28;3604;9939;691253;426810;55.6;34.3
76;2021-06-29;3861;10234;695114;437044;55.9;35.1
76;2021-06-30;4254;9838;699368;446882;56.2;35.9
76;2021-07-01;4573;9891;703941;456773;56.6;36.7
76;2021-07-02;4353;12012;708294;468785;56.9;37.7
76;2021-07-03;3585;8447;711879;477232;57.2;38.4
76;2021-07-04;1484;5308;713363;482540;57.4;38.8
76;2021-07-05;3932;9328;717295;491868;57.7;39.5
76;2021-07-06;4039;10074;721334;501942;58.0;40.4
76;2021-07-07;4003;9328;725337;511270;58.3;41.1
76;2021-07-08;4461;9460;729798;520730;58.7;41.9
76;2021-07-09;4358;12412;734156;533142;59.0;42.9
76;2021-07-10;3132;8555;737288;541697;59.3;43.6
76;2021-07-11;1773;2820;739061;544517;59.4;43.8
76;2021-07-12;3145;11151;742206;555668;59.7;44.7
76;2021-07-13;4918;12256;747124;567924;60.1;45.7
76;2021-07-14;4799;5536;751923;573460;60.5;46.1
76;2021-07-15;5878;11782;757801;585242;60.9;47.1
76;2021-07-16;6693;12019;764494;597261;61.5;48.0
76;2021-07-17;5265;8699;769759;605960;61.9;48.7
76;2021-07-18;2253;3352;772012;609312;62.1;49.0
76;2021-07-19;5140;11144;777152;620456;62.5;49.9
76;2021-07-20;6260;11628;783412;632084;63.0;50.8
76;2021-07-21;6320;10545;789732;642629;63.5;51.7
76;2021-07-22;8194;9653;797926;652282;64.2;52.4
76;2021-07-23;7609;11973;805535;664255;64.8;53.4
76;2021-07-24;4980;7703;810515;671958;65.2;54.0
76;2021-07-25;2855;3143;813370;675101;65.4;54.3
76;2021-07-26;5418;10134;818788;685235;65.8;55.1
76;2021-07-27;8299;9537;827087;694772;66.5;55.9
76;2021-07-28;8223;7787;835310;702559;67.2;56.5
76;2021-07-29;9538;6956;844848;709515;67.9;57.0
76;2021-07-30;7956;7808;852804;717323;68.6;57.7
76;2021-07-31;6566;5286;859370;722609;69.1;58.1
76;2021-08-01;3856;2051;863226;724660;69.4;58.3
76;2021-08-02;6523;7065;869749;731725;69.9;58.8
76;2021-08-03;7939;6310;877688;738035;70.6;59.3
76;2021-08-04;7195;5817;884883;743852;71.1;59.8
76;2021-08-05;7965;5652;892848;749504;71.8;60.3
77;2020-12-27;1;0;1;0;0.0;0.0
77;2020-12-28;1;0;2;0;0.0;0.0
77;2020-12-29;0;0;2;0;0.0;0.0
77;2020-12-30;0;0;2;0;0.0;0.0
77;2020-12-31;0;0;2;0;0.0;0.0
77;2021-01-01;2;0;4;0;0.0;0.0
77;2021-01-02;0;0;4;0;0.0;0.0
77;2021-01-03;0;0;4;0;0.0;0.0
77;2021-01-04;6;0;10;0;0.0;0.0
77;2021-01-05;199;0;209;0;0.0;0.0
77;2021-01-06;222;2;431;2;0.0;0.0
77;2021-01-07;518;3;949;5;0.1;0.0
77;2021-01-08;612;1;1561;6;0.1;0.0
77;2021-01-09;273;1;1834;7;0.1;0.0
77;2021-01-10;235;2;2069;9;0.1;0.0
77;2021-01-11;783;2;2852;11;0.2;0.0
77;2021-01-12;883;1;3735;12;0.3;0.0
77;2021-01-13;935;1;4670;13;0.3;0.0
77;2021-01-14;847;7;5517;20;0.4;0.0
77;2021-01-15;858;10;6375;30;0.4;0.0
77;2021-01-16;168;1;6543;31;0.5;0.0
77;2021-01-17;131;2;6674;33;0.5;0.0
77;2021-01-18;1193;4;7867;37;0.6;0.0
77;2021-01-19;1718;8;9585;45;0.7;0.0
77;2021-01-20;2536;5;12121;50;0.9;0.0
77;2021-01-21;2052;20;14173;70;1.0;0.0
77;2021-01-22;1147;7;15320;77;1.1;0.0
77;2021-01-23;349;0;15669;77;1.1;0.0
77;2021-01-24;43;0;15712;77;1.1;0.0
77;2021-01-25;939;65;16651;142;1.2;0.0
77;2021-01-26;1702;30;18353;172;1.3;0.0
77;2021-01-27;1362;42;19715;214;1.4;0.0
77;2021-01-28;1696;89;21411;303;1.5;0.0
77;2021-01-29;1283;146;22694;449;1.6;0.0
77;2021-01-30;211;2;22905;451;1.6;0.0
77;2021-01-31;0;0;22905;451;1.6;0.0
77;2021-02-01;568;212;23473;663;1.6;0.0
77;2021-02-02;866;269;24339;932;1.7;0.1
77;2021-02-03;794;538;25133;1470;1.8;0.1
77;2021-02-04;789;808;25922;2278;1.8;0.2
77;2021-02-05;856;855;26778;3133;1.9;0.2
77;2021-02-06;165;103;26943;3236;1.9;0.2
77;2021-02-07;16;92;26959;3328;1.9;0.2
77;2021-02-08;493;941;27452;4269;1.9;0.3
77;2021-02-09;591;1467;28043;5736;2.0;0.4
77;2021-02-10;1028;1839;29071;7575;2.0;0.5
77;2021-02-11;1059;1656;30130;9231;2.1;0.6
77;2021-02-12;1097;1172;31227;10403;2.2;0.7
77;2021-02-13;187;175;31414;10578;2.2;0.7
77;2021-02-14;12;57;31426;10635;2.2;0.7
77;2021-02-15;554;1031;31980;11666;2.2;0.8
77;2021-02-16;599;1538;32579;13204;2.3;0.9
77;2021-02-17;514;1192;33093;14396;2.3;1.0
77;2021-02-18;840;1621;33933;16017;2.4;1.1
77;2021-02-19;775;1174;34708;17191;2.4;1.2
77;2021-02-20;53;176;34761;17367;2.4;1.2
77;2021-02-21;7;31;34768;17398;2.4;1.2
77;2021-02-22;303;774;35071;18172;2.5;1.3
77;2021-02-23;358;1134;35429;19306;2.5;1.4
77;2021-02-24;511;900;35940;20206;2.5;1.4
77;2021-02-25;793;975;36733;21181;2.6;1.5
77;2021-02-26;841;846;37574;22027;2.6;1.5
77;2021-02-27;460;169;38034;22196;2.7;1.6
77;2021-02-28;32;5;38066;22201;2.7;1.6
77;2021-03-01;674;710;38740;22911;2.7;1.6
77;2021-03-02;1092;1027;39832;23938;2.8;1.7
77;2021-03-03;1952;1180;41784;25118;2.9;1.8
77;2021-03-04;2797;1135;44581;26253;3.1;1.8
77;2021-03-05;3378;1041;47959;27294;3.4;1.9
77;2021-03-06;4820;249;52779;27543;3.7;1.9
77;2021-03-07;3189;97;55968;27640;3.9;1.9
77;2021-03-08;1230;504;57198;28144;4.0;2.0
77;2021-03-09;2503;627;59701;28771;4.2;2.0
77;2021-03-10;2396;570;62097;29341;4.4;2.1
77;2021-03-11;3498;763;65595;30104;4.6;2.1
77;2021-03-12;3889;680;69484;30784;4.9;2.2
77;2021-03-13;4481;200;73965;30984;5.2;2.2
77;2021-03-14;2150;110;76115;31094;5.3;2.2
77;2021-03-15;2509;273;78624;31367;5.5;2.2
77;2021-03-16;2443;369;81067;31736;5.7;2.2
77;2021-03-17;2548;421;83615;32157;5.9;2.3
77;2021-03-18;3009;395;86624;32552;6.1;2.3
77;2021-03-19;3358;429;89982;32981;6.3;2.3
77;2021-03-20;1965;74;91947;33055;6.5;2.3
77;2021-03-21;242;13;92189;33068;6.5;2.3
77;2021-03-22;3018;402;95207;33470;6.7;2.4
77;2021-03-23;4518;514;99725;33984;7.0;2.4
77;2021-03-24;4149;623;103874;34607;7.3;2.4
77;2021-03-25;5903;409;109777;35016;7.7;2.5
77;2021-03-26;6265;427;116042;35443;8.2;2.5
77;2021-03-27;3320;113;119362;35556;8.4;2.5
77;2021-03-28;1730;43;121092;35599;8.5;2.5
77;2021-03-29;2653;683;123745;36282;8.7;2.5
77;2021-03-30;3994;1202;127739;37484;9.0;2.6
77;2021-03-31;3751;1214;131490;38698;9.2;2.7
77;2021-04-01;4140;1800;135630;40498;9.5;2.8
77;2021-04-02;3989;2014;139619;42512;9.8;3.0
77;2021-04-03;1745;2276;141364;44788;9.9;3.1
77;2021-04-04;425;1426;141789;46214;10.0;3.2
77;2021-04-05;158;162;141947;46376;10.0;3.3
77;2021-04-06;2711;1920;144658;48296;10.2;3.4
77;2021-04-07;3314;2081;147972;50377;10.4;3.5
77;2021-04-08;4530;2362;152502;52739;10.7;3.7
77;2021-04-09;4844;2086;157346;54825;11.1;3.9
77;2021-04-10;3071;2743;160417;57568;11.3;4.0
77;2021-04-11;587;716;161004;58284;11.3;4.1
77;2021-04-12;2230;1824;163234;60108;11.5;4.2
77;2021-04-13;3357;2633;166591;62741;11.7;4.4
77;2021-04-14;2522;2645;169113;65386;11.9;4.6
77;2021-04-15;3317;3111;172430;68497;12.1;4.8
77;2021-04-16;3574;2716;176004;71213;12.4;5.0
77;2021-04-17;1387;473;177391;71686;12.5;5.0
77;2021-04-18;150;11;177541;71697;12.5;5.0
77;2021-04-19;2081;2510;179622;74207;12.6;5.2
77;2021-04-20;2569;3381;182191;77588;12.8;5.5
77;2021-04-21;2192;3473;184383;81061;13.0;5.7
77;2021-04-22;3003;3852;187386;84913;13.2;6.0
77;2021-04-23;3525;3633;190911;88546;13.4;6.2
77;2021-04-24;4899;2509;195810;91055;13.8;6.4
77;2021-04-25;4081;1233;199891;92288;14.0;6.5
77;2021-04-26;3229;2036;203120;94324;14.3;6.6
77;2021-04-27;3994;2513;207114;96837;14.5;6.8
77;2021-04-28;4072;2605;211186;99442;14.8;7.0
77;2021-04-29;4476;3077;215662;102519;15.1;7.2
77;2021-04-30;4904;3331;220566;105850;15.5;7.4
77;2021-05-01;2463;593;223029;106443;15.7;7.5
77;2021-05-02;3142;276;226171;106719;15.9;7.5
77;2021-05-03;5988;2063;232159;108782;16.3;7.6
77;2021-05-04;6437;2984;238596;111766;16.8;7.9
77;2021-05-05;6014;3021;244610;114787;17.2;8.1
77;2021-05-06;6889;3591;251499;118378;17.7;8.3
77;2021-05-07;8206;3257;259705;121635;18.2;8.5
77;2021-05-08;5706;805;265411;122440;18.6;8.6
77;2021-05-09;4906;473;270317;122913;19.0;8.6
77;2021-05-10;8087;2323;278404;125236;19.6;8.8
77;2021-05-11;9579;2913;287983;128149;20.2;9.0
77;2021-05-12;8977;2279;296960;130428;20.9;9.2
77;2021-05-13;9301;870;306261;131298;21.5;9.2
77;2021-05-14;10425;1651;316686;132949;22.2;9.3
77;2021-05-15;8987;1248;325673;134197;22.9;9.4
77;2021-05-16;5150;464;330823;134661;23.2;9.5
77;2021-05-17;10370;1471;341193;136132;24.0;9.6
77;2021-05-18;11779;1798;352972;137930;24.8;9.7
77;2021-05-19;10908;1599;363880;139529;25.6;9.8
77;2021-05-20;12208;2165;376088;141694;26.4;10.0
77;2021-05-21;11652;2690;387740;144384;27.2;10.1
77;2021-05-22;9819;1731;397559;146115;27.9;10.3
77;2021-05-23;6986;806;404545;146921;28.4;10.3
77;2021-05-24;6762;775;411307;147696;28.9;10.4
77;2021-05-25;8306;2806;419613;150502;29.5;10.6
77;2021-05-26;7564;2971;427177;153473;30.0;10.8
77;2021-05-27;7548;3954;434725;157427;30.5;11.1
77;2021-05-28;7637;4013;442362;161440;31.1;11.3
77;2021-05-29;7355;2337;449717;163777;31.6;11.5
77;2021-05-30;4357;892;454074;164669;31.9;11.6
77;2021-05-31;8385;3832;462459;168501;32.5;11.8
77;2021-06-01;9639;4346;472098;172847;33.2;12.1
77;2021-06-02;8907;3888;481005;176735;33.8;12.4
77;2021-06-03;8998;5260;490003;181995;34.4;12.8
77;2021-06-04;9110;5487;499113;187482;35.1;13.2
77;2021-06-05;6644;4993;505757;192475;35.5;13.5
77;2021-06-06;4909;3206;510666;195681;35.9;13.7
77;2021-06-07;6418;4539;517084;200220;36.3;14.1
77;2021-06-08;5726;5208;522810;205428;36.7;14.4
77;2021-06-09;5058;4955;527868;210383;37.1;14.8
77;2021-06-10;5014;5457;532882;215840;37.4;15.2
77;2021-06-11;5752;6031;538634;221871;37.8;15.6
77;2021-06-12;6547;4747;545181;226618;38.3;15.9
77;2021-06-13;3505;3050;548686;229668;38.5;16.1
77;2021-06-14;3217;7926;551903;237594;38.8;16.7
77;2021-06-15;4127;8479;556030;246073;39.1;17.3
77;2021-06-16;4803;8376;560833;254449;39.4;17.9
77;2021-06-17;4470;9023;565303;263472;39.7;18.5
77;2021-06-18;4359;9782;569662;273254;40.0;19.2
77;2021-06-19;5304;6921;574966;280175;40.4;19.7
77;2021-06-20;2094;3798;577060;283973;40.5;19.9
77;2021-06-21;3219;9579;580279;293552;40.8;20.6
77;2021-06-22;3665;11365;583944;304917;41.0;21.4
77;2021-06-23;3438;10049;587382;314966;41.3;22.1
77;2021-06-24;3360;10905;590742;325871;41.5;22.9
77;2021-06-25;3623;10799;594365;336670;41.8;23.6
77;2021-06-26;4080;10065;598445;346735;42.0;24.4
77;2021-06-27;2122;6426;600567;353161;42.2;24.8
77;2021-06-28;2801;10831;603368;363992;42.4;25.6
77;2021-06-29;3373;12519;606741;376511;42.6;26.4
77;2021-06-30;3284;11444;610025;387955;42.9;27.3
77;2021-07-01;3270;11656;613295;399611;43.1;28.1
77;2021-07-02;3429;12241;616724;411852;43.3;28.9
77;2021-07-03;3174;10789;619898;422641;43.5;29.7
77;2021-07-04;1993;6493;621891;429134;43.7;30.1
77;2021-07-05;3585;9545;625476;438679;43.9;30.8
77;2021-07-06;3728;9520;629204;448199;44.2;31.5
77;2021-07-07;4019;8947;633223;457146;44.5;32.1
77;2021-07-08;3898;8751;637121;465897;44.8;32.7
77;2021-07-09;4684;10340;641805;476237;45.1;33.5
77;2021-07-10;4032;9839;645837;486076;45.4;34.1
77;2021-07-11;3063;5075;648900;491151;45.6;34.5
77;2021-07-12;3273;10862;652173;502013;45.8;35.3
77;2021-07-13;6091;12020;658264;514033;46.2;36.1
77;2021-07-14;3535;6438;661799;520471;46.5;36.6
77;2021-07-15;7122;11953;668921;532424;47.0;37.4
77;2021-07-16;7758;9882;676679;542306;47.5;38.1
77;2021-07-17;5763;9455;682442;551761;47.9;38.8
77;2021-07-18;4133;5324;686575;557085;48.2;39.1
77;2021-07-19;7452;8933;694027;566018;48.8;39.8
77;2021-07-20;9502;7998;703529;574016;49.4;40.3
77;2021-07-21;9434;7440;712963;581456;50.1;40.8
77;2021-07-22;10414;7472;723377;588928;50.8;41.4
77;2021-07-23;9741;8149;733118;597077;51.5;41.9
77;2021-07-24;7155;7839;740273;604916;52.0;42.5
77;2021-07-25;5851;4010;746124;608926;52.4;42.8
77;2021-07-26;9143;5944;755267;614870;53.1;43.2
77;2021-07-27;10800;5988;766067;620858;53.8;43.6
77;2021-07-28;9315;6373;775382;627231;54.5;44.1
77;2021-07-29;9463;5462;784845;632693;55.1;44.4
77;2021-07-30;9620;6314;794465;639007;55.8;44.9
77;2021-07-31;7196;6598;801661;645605;56.3;45.3
77;2021-08-01;2935;1179;804596;646784;56.5;45.4
77;2021-08-02;6994;5696;811590;652480;57.0;45.8
77;2021-08-03;5715;4458;817305;656938;57.4;46.1
77;2021-08-04;4643;4350;821948;661288;57.7;46.5
77;2021-08-05;3170;2921;825118;664209;58.0;46.7
78;2020-12-27;2;0;2;0;0.0;0.0
78;2020-12-28;0;0;2;0;0.0;0.0
78;2020-12-29;0;0;2;0;0.0;0.0
78;2020-12-30;0;0;2;0;0.0;0.0
78;2020-12-31;15;0;17;0;0.0;0.0
78;2021-01-01;0;0;17;0;0.0;0.0
78;2021-01-02;1;0;18;0;0.0;0.0
78;2021-01-03;2;0;20;0;0.0;0.0
78;2021-01-04;145;3;165;3;0.0;0.0
78;2021-01-05;175;1;340;4;0.0;0.0
78;2021-01-06;208;3;548;7;0.0;0.0
78;2021-01-07;469;2;1017;9;0.1;0.0
78;2021-01-08;651;4;1668;13;0.1;0.0
78;2021-01-09;22;0;1690;13;0.1;0.0
78;2021-01-10;1;0;1691;13;0.1;0.0
78;2021-01-11;791;3;2482;16;0.2;0.0
78;2021-01-12;946;7;3428;23;0.2;0.0
78;2021-01-13;736;8;4164;31;0.3;0.0
78;2021-01-14;810;9;4974;40;0.3;0.0
78;2021-01-15;847;7;5821;47;0.4;0.0
78;2021-01-16;32;1;5853;48;0.4;0.0
78;2021-01-17;0;0;5853;48;0.4;0.0
78;2021-01-18;1381;22;7234;70;0.5;0.0
78;2021-01-19;1840;27;9074;97;0.6;0.0
78;2021-01-20;1646;14;10720;111;0.7;0.0
78;2021-01-21;3245;13;13965;124;1.0;0.0
78;2021-01-22;2212;16;16177;140;1.1;0.0
78;2021-01-23;279;0;16456;140;1.1;0.0
78;2021-01-24;5;0;16461;140;1.1;0.0
78;2021-01-25;958;32;17419;172;1.2;0.0
78;2021-01-26;1559;19;18978;191;1.3;0.0
78;2021-01-27;2059;48;21037;239;1.5;0.0
78;2021-01-28;2434;105;23471;344;1.6;0.0
78;2021-01-29;1488;64;24959;408;1.7;0.0
78;2021-01-30;210;3;25169;411;1.7;0.0
78;2021-01-31;3;0;25172;411;1.7;0.0
78;2021-02-01;786;225;25958;636;1.8;0.0
78;2021-02-02;968;347;26926;983;1.9;0.1
78;2021-02-03;975;241;27901;1224;1.9;0.1
78;2021-02-04;1116;445;29017;1669;2.0;0.1
78;2021-02-05;1189;512;30206;2181;2.1;0.2
78;2021-02-06;197;44;30403;2225;2.1;0.2
78;2021-02-07;139;13;30542;2238;2.1;0.2
78;2021-02-08;760;612;31302;2850;2.2;0.2
78;2021-02-09;1122;943;32424;3793;2.2;0.3
78;2021-02-10;1248;1182;33672;4975;2.3;0.3
78;2021-02-11;1818;1901;35490;6876;2.4;0.5
78;2021-02-12;1818;1416;37308;8292;2.6;0.6
78;2021-02-13;172;80;37480;8372;2.6;0.6
78;2021-02-14;26;25;37506;8397;2.6;0.6
78;2021-02-15;446;1439;37952;9836;2.6;0.7
78;2021-02-16;627;1558;38579;11394;2.7;0.8
78;2021-02-17;584;2223;39163;13617;2.7;0.9
78;2021-02-18;996;2283;40159;15900;2.8;1.1
78;2021-02-19;819;1737;40978;17637;2.8;1.2
78;2021-02-20;147;124;41125;17761;2.8;1.2
78;2021-02-21;0;12;41125;17773;2.8;1.2
78;2021-02-22;498;1059;41623;18832;2.9;1.3
78;2021-02-23;540;1123;42163;19955;2.9;1.4
78;2021-02-24;619;1239;42782;21194;3.0;1.5
78;2021-02-25;863;1159;43645;22353;3.0;1.5
78;2021-02-26;1132;1244;44777;23597;3.1;1.6
78;2021-02-27;739;148;45516;23745;3.1;1.6
78;2021-02-28;65;18;45581;23763;3.1;1.6
78;2021-03-01;963;906;46544;24669;3.2;1.7
78;2021-03-02;1723;1051;48267;25720;3.3;1.8
78;2021-03-03;1964;1227;50231;26947;3.5;1.9
78;2021-03-04;2945;1578;53176;28525;3.7;2.0
78;2021-03-05;3252;1650;56428;30175;3.9;2.1
78;2021-03-06;6239;271;62667;30446;4.3;2.1
78;2021-03-07;3444;83;66111;30529;4.6;2.1
78;2021-03-08;1453;758;67564;31287;4.7;2.2
78;2021-03-09;2937;902;70501;32189;4.9;2.2
78;2021-03-10;3071;1109;73572;33298;5.1;2.3
78;2021-03-11;4175;1303;77747;34601;5.4;2.4
78;2021-03-12;5369;1329;83116;35930;5.7;2.5
78;2021-03-13;4654;183;87770;36113;6.1;2.5
78;2021-03-14;1034;37;88804;36150;6.1;2.5
78;2021-03-15;3622;262;92426;36412;6.4;2.5
78;2021-03-16;2563;554;94989;36966;6.6;2.6
78;2021-03-17;2965;432;97954;37398;6.8;2.6
78;2021-03-18;3779;426;101733;37824;7.0;2.6
78;2021-03-19;5315;478;107048;38302;7.4;2.6
78;2021-03-20;2256;120;109304;38422;7.5;2.7
78;2021-03-21;163;7;109467;38429;7.6;2.7
78;2021-03-22;3525;374;112992;38803;7.8;2.7
78;2021-03-23;5227;534;118219;39337;8.2;2.7
78;2021-03-24;4891;537;123110;39874;8.5;2.8
78;2021-03-25;6936;553;130046;40427;9.0;2.8
78;2021-03-26;6935;703;136981;41130;9.5;2.8
78;2021-03-27;3743;183;140724;41313;9.7;2.9
78;2021-03-28;1918;42;142642;41355;9.8;2.9
78;2021-03-29;3864;755;146506;42110;10.1;2.9
78;2021-03-30;5522;1051;152028;43161;10.5;3.0
78;2021-03-31;5328;1276;157356;44437;10.9;3.1
78;2021-04-01;5592;2327;162948;46764;11.2;3.2
78;2021-04-02;5192;2617;168140;49381;11.6;3.4
78;2021-04-03;2197;2555;170337;51936;11.8;3.6
78;2021-04-04;172;14;170509;51950;11.8;3.6
78;2021-04-05;198;18;170707;51968;11.8;3.6
78;2021-04-06;3616;2299;174323;54267;12.0;3.7
78;2021-04-07;4356;2583;178679;56850;12.3;3.9
78;2021-04-08;5521;2659;184200;59509;12.7;4.1
78;2021-04-09;6902;2434;191102;61943;13.2;4.3
78;2021-04-10;3992;1892;195094;63835;13.5;4.4
78;2021-04-11;373;606;195467;64441;13.5;4.4
78;2021-04-12;3529;2364;198996;66805;13.7;4.6
78;2021-04-13;5458;2490;204454;69295;14.1;4.8
78;2021-04-14;4953;3382;209407;72677;14.5;5.0
78;2021-04-15;4612;3838;214019;76515;14.8;5.3
78;2021-04-16;5630;4012;219649;80527;15.2;5.6
78;2021-04-17;3615;711;223264;81238;15.4;5.6
78;2021-04-18;272;42;223536;81280;15.4;5.6
78;2021-04-19;3241;2814;226777;84094;15.7;5.8
78;2021-04-20;4708;3687;231485;87781;16.0;6.1
78;2021-04-21;4530;3498;236015;91279;16.3;6.3
78;2021-04-22;4569;4684;240584;95963;16.6;6.6
78;2021-04-23;5050;4421;245634;100384;17.0;6.9
78;2021-04-24;4866;2621;250500;103005;17.3;7.1
78;2021-04-25;3042;1728;253542;104733;17.5;7.2
78;2021-04-26;4768;3317;258310;108050;17.8;7.5
78;2021-04-27;5467;4310;263777;112360;18.2;7.8
78;2021-04-28;5649;4782;269426;117142;18.6;8.1
78;2021-04-29;6256;4059;275682;121201;19.0;8.4
78;2021-04-30;7205;4447;282887;125648;19.5;8.7
78;2021-05-01;612;255;283499;125903;19.6;8.7
78;2021-05-02;2006;164;285505;126067;19.7;8.7
78;2021-05-03;7457;1272;292962;127339;20.2;8.8
78;2021-05-04;6078;3979;299040;131318;20.6;9.1
78;2021-05-05;7293;4544;306333;135862;21.1;9.4
78;2021-05-06;6475;5170;312808;141032;21.6;9.7
78;2021-05-07;8311;5143;321119;146175;22.2;10.1
78;2021-05-08;2916;1450;324035;147625;22.4;10.2
78;2021-05-09;2817;347;326852;147972;22.6;10.2
78;2021-05-10;7343;4455;334195;152427;23.1;10.5
78;2021-05-11;8141;5411;342336;157838;23.6;10.9
78;2021-05-12;8726;3910;351062;161748;24.2;11.2
78;2021-05-13;6631;600;357693;162348;24.7;11.2
78;2021-05-14;10214;2216;367907;164564;25.4;11.4
78;2021-05-15;4934;2367;372841;166931;25.7;11.5
78;2021-05-16;3695;793;376536;167724;26.0;11.6
78;2021-05-17;8741;1343;385277;169067;26.6;11.7
78;2021-05-18;9882;1878;395159;170945;27.3;11.8
78;2021-05-19;11648;1706;406807;172651;28.1;11.9
78;2021-05-20;11588;2269;418395;174920;28.9;12.1
78;2021-05-21;12126;2628;430521;177548;29.7;12.3
78;2021-05-22;6545;1374;437066;178922;30.2;12.4
78;2021-05-23;3124;385;440190;179307;30.4;12.4
78;2021-05-24;3521;415;443711;179722;30.6;12.4
78;2021-05-25;9987;2501;453698;182223;31.3;12.6
78;2021-05-26;10163;3778;463861;186001;32.0;12.8
78;2021-05-27;10958;4641;474819;190642;32.8;13.2
78;2021-05-28;11414;6013;486233;196655;33.6;13.6
78;2021-05-29;4225;3383;490458;200038;33.9;13.8
78;2021-05-30;135;346;490593;200384;33.9;13.8
78;2021-05-31;7970;5358;498563;205742;34.4;14.2
78;2021-06-01;10031;6528;508594;212270;35.1;14.7
78;2021-06-02;8578;6212;517172;218482;35.7;15.1
78;2021-06-03;9893;6475;527065;224957;36.4;15.5
78;2021-06-04;9789;8146;536854;233103;37.1;16.1
78;2021-06-05;5515;6140;542369;239243;37.4;16.5
78;2021-06-06;2148;2012;544517;241255;37.6;16.7
78;2021-06-07;8122;6517;552639;247772;38.1;17.1
78;2021-06-08;8061;7316;560700;255088;38.7;17.6
78;2021-06-09;7318;6728;568018;261816;39.2;18.1
78;2021-06-10;7080;7098;575098;268914;39.7;18.6
78;2021-06-11;7577;8177;582675;277091;40.2;19.1
78;2021-06-12;6371;2917;589046;280008;40.7;19.3
78;2021-06-13;944;2459;589990;282467;40.7;19.5
78;2021-06-14;3403;9812;593393;292279;41.0;20.2
78;2021-06-15;5791;8288;599184;300567;41.4;20.7
78;2021-06-16;5413;8633;604597;309200;41.7;21.3
78;2021-06-17;5481;8534;610078;317734;42.1;21.9
78;2021-06-18;6092;9786;616170;327520;42.5;22.6
78;2021-06-19;5221;4817;621391;332337;42.9;22.9
78;2021-06-20;624;2835;622015;335172;42.9;23.1
78;2021-06-21;4073;9466;626088;344638;43.2;23.8
78;2021-06-22;3338;10313;629426;354951;43.4;24.5
78;2021-06-23;3830;10389;633256;365340;43.7;25.2
78;2021-06-24;3786;9975;637042;375315;44.0;25.9
78;2021-06-25;3999;13153;641041;388468;44.3;26.8
78;2021-06-26;4212;7953;645253;396421;44.5;27.4
78;2021-06-27;1038;2542;646291;398963;44.6;27.5
78;2021-06-28;3289;10899;649580;409862;44.8;28.3
78;2021-06-29;3535;11246;653115;421108;45.1;29.1
78;2021-06-30;4109;13225;657224;434333;45.4;30.0
78;2021-07-01;3932;12692;661156;447025;45.6;30.9
78;2021-07-02;4179;13929;665335;460954;45.9;31.8
78;2021-07-03;3149;8625;668484;469579;46.1;32.4
78;2021-07-04;759;1742;669243;471321;46.2;32.5
78;2021-07-05;3275;9686;672518;481007;46.4;33.2
78;2021-07-06;3509;12040;676027;493047;46.7;34.0
78;2021-07-07;3740;11607;679767;504654;46.9;34.8
78;2021-07-08;3859;11673;683626;516327;47.2;35.6
78;2021-07-09;4392;12733;688018;529060;47.5;36.5
78;2021-07-10;2613;6603;690631;535663;47.7;37.0
78;2021-07-11;745;2052;691376;537715;47.7;37.1
78;2021-07-12;2985;11740;694361;549455;47.9;37.9
78;2021-07-13;5298;11969;699659;561424;48.3;38.8
78;2021-07-14;2524;4969;702183;566393;48.5;39.1
78;2021-07-15;5641;11944;707824;578337;48.9;39.9
78;2021-07-16;7243;10759;715067;589096;49.4;40.7
78;2021-07-17;4704;4883;719771;593979;49.7;41.0
78;2021-07-18;1119;454;720890;594433;49.8;41.0
78;2021-07-19;3824;10340;724714;604773;50.0;41.7
78;2021-07-20;5546;9901;730260;614674;50.4;42.4
78;2021-07-21;5875;9835;736135;624509;50.8;43.1
78;2021-07-22;5924;9284;742059;633793;51.2;43.8
78;2021-07-23;6168;9186;748227;642979;51.7;44.4
78;2021-07-24;2924;4956;751151;647935;51.9;44.7
78;2021-07-25;980;371;752131;648306;51.9;44.8
78;2021-07-26;4827;6952;756958;655258;52.3;45.2
78;2021-07-27;7537;6874;764495;662132;52.8;45.7
78;2021-07-28;6916;5907;771411;668039;53.3;46.1
78;2021-07-29;7871;5961;779282;674000;53.8;46.5
78;2021-07-30;7621;7005;786903;681005;54.3;47.0
78;2021-07-31;2633;2721;789536;683726;54.5;47.2
78;2021-08-01;99;68;789635;683794;54.5;47.2
78;2021-08-02;2363;2093;791998;685887;54.7;47.3
78;2021-08-03;4194;4227;796192;690114;55.0;47.6
78;2021-08-04;4331;2771;800523;692885;55.3;47.8
78;2021-08-05;3824;3114;804347;695999;55.5;48.0
79;2020-12-27;0;0;0;0;0.0;0.0
79;2020-12-28;3;0;3;0;0.0;0.0
79;2020-12-29;0;0;3;0;0.0;0.0
79;2020-12-30;0;0;3;0;0.0;0.0
79;2020-12-31;0;0;3;0;0.0;0.0
79;2021-01-01;0;0;3;0;0.0;0.0
79;2021-01-02;0;0;3;0;0.0;0.0
79;2021-01-03;0;0;3;0;0.0;0.0
79;2021-01-04;1;0;4;0;0.0;0.0
79;2021-01-05;0;0;4;0;0.0;0.0
79;2021-01-06;0;0;4;0;0.0;0.0
79;2021-01-07;158;0;162;0;0.0;0.0
79;2021-01-08;165;0;327;0;0.1;0.0
79;2021-01-09;98;0;425;0;0.1;0.0
79;2021-01-10;3;0;428;0;0.1;0.0
79;2021-01-11;184;1;612;1;0.2;0.0
79;2021-01-12;246;2;858;3;0.2;0.0
79;2021-01-13;258;0;1116;3;0.3;0.0
79;2021-01-14;502;7;1618;10;0.4;0.0
79;2021-01-15;616;4;2234;14;0.6;0.0
79;2021-01-16;66;0;2300;14;0.6;0.0
79;2021-01-17;0;0;2300;14;0.6;0.0
79;2021-01-18;477;1;2777;15;0.7;0.0
79;2021-01-19;1351;0;4128;15;1.1;0.0
79;2021-01-20;1646;1;5774;16;1.5;0.0
79;2021-01-21;1997;6;7771;22;2.1;0.0
79;2021-01-22;873;3;8644;25;2.3;0.0
79;2021-01-23;65;0;8709;25;2.3;0.0
79;2021-01-24;0;0;8709;25;2.3;0.0
79;2021-01-25;643;7;9352;32;2.5;0.0
79;2021-01-26;581;13;9933;45;2.7;0.0
79;2021-01-27;741;83;10674;128;2.9;0.0
79;2021-01-28;731;150;11405;278;3.1;0.1
79;2021-01-29;490;88;11895;366;3.2;0.1
79;2021-01-30;0;0;11895;366;3.2;0.1
79;2021-01-31;0;0;11895;366;3.2;0.1
79;2021-02-01;206;111;12101;477;3.2;0.1
79;2021-02-02;324;72;12425;549;3.3;0.1
79;2021-02-03;389;60;12814;609;3.4;0.2
79;2021-02-04;323;110;13137;719;3.5;0.2
79;2021-02-05;356;274;13493;993;3.6;0.3
79;2021-02-06;3;0;13496;993;3.6;0.3
79;2021-02-07;22;0;13518;993;3.6;0.3
79;2021-02-08;283;170;13801;1163;3.7;0.3
79;2021-02-09;457;786;14258;1949;3.8;0.5
79;2021-02-10;618;1197;14876;3146;4.0;0.8
79;2021-02-11;777;1236;15653;4382;4.2;1.2
79;2021-02-12;468;770;16121;5152;4.3;1.4
79;2021-02-13;53;74;16174;5226;4.3;1.4
79;2021-02-14;0;0;16174;5226;4.3;1.4
79;2021-02-15;186;507;16360;5733;4.4;1.5
79;2021-02-16;333;734;16693;6467;4.5;1.7
79;2021-02-17;247;878;16940;7345;4.5;2.0
79;2021-02-18;353;945;17293;8290;4.6;2.2
79;2021-02-19;267;565;17560;8855;4.7;2.4
79;2021-02-20;4;22;17564;8877;4.7;2.4
79;2021-02-21;1;0;17565;8877;4.7;2.4
79;2021-02-22;137;464;17702;9341;4.8;2.5
79;2021-02-23;248;569;17950;9910;4.8;2.7
79;2021-02-24;245;543;18195;10453;4.9;2.8
79;2021-02-25;516;471;18711;10924;5.0;2.9
79;2021-02-26;598;402;19309;11326;5.2;3.0
79;2021-02-27;406;5;19715;11331;5.3;3.0
79;2021-02-28;35;0;19750;11331;5.3;3.0
79;2021-03-01;89;360;19839;11691;5.3;3.1
79;2021-03-02;303;507;20142;12198;5.4;3.3
79;2021-03-03;659;540;20801;12738;5.6;3.4
79;2021-03-04;904;570;21705;13308;5.8;3.6
79;2021-03-05;1217;447;22922;13755;6.2;3.7
79;2021-03-06;610;4;23532;13759;6.3;3.7
79;2021-03-07;77;0;23609;13759;6.3;3.7
79;2021-03-08;344;309;23953;14068;6.4;3.8
79;2021-03-09;841;341;24794;14409;6.7;3.9
79;2021-03-10;1145;403;25939;14812;7.0;4.0
79;2021-03-11;1640;317;27579;15129;7.4;4.1
79;2021-03-12;1717;117;29296;15246;7.9;4.1
79;2021-03-13;1135;11;30431;15257;8.2;4.1
79;2021-03-14;50;0;30481;15257;8.2;4.1
79;2021-03-15;496;158;30977;15415;8.3;4.1
79;2021-03-16;734;143;31711;15558;8.5;4.2
79;2021-03-17;576;108;32287;15666;8.7;4.2
79;2021-03-18;553;200;32840;15866;8.8;4.3
79;2021-03-19;662;255;33502;16121;9.0;4.3
79;2021-03-20;1006;12;34508;16133;9.3;4.3
79;2021-03-21;3;0;34511;16133;9.3;4.3
79;2021-03-22;954;201;35465;16334;9.5;4.4
79;2021-03-23;1590;170;37055;16504;9.9;4.4
79;2021-03-24;1828;152;38883;16656;10.4;4.5
79;2021-03-25;2498;184;41381;16840;11.1;4.5
79;2021-03-26;2401;134;43782;16974;11.7;4.6
79;2021-03-27;769;16;44551;16990;12.0;4.6
79;2021-03-28;1;0;44552;16990;12.0;4.6
79;2021-03-29;2147;111;46699;17101;12.5;4.6
79;2021-03-30;2816;60;49515;17161;13.3;4.6
79;2021-03-31;2778;381;52293;17542;14.0;4.7
79;2021-04-01;2694;376;54987;17918;14.8;4.8
79;2021-04-02;2822;386;57809;18304;15.5;4.9
79;2021-04-03;633;53;58442;18357;15.7;4.9
79;2021-04-04;3;0;58445;18357;15.7;4.9
79;2021-04-05;380;4;58825;18361;15.8;4.9
79;2021-04-06;1793;583;60618;18944;16.3;5.1
79;2021-04-07;3115;730;63733;19674;17.1;5.3
79;2021-04-08;2629;690;66362;20364;17.8;5.5
79;2021-04-09;3736;537;70098;20901;18.8;5.6
79;2021-04-10;1464;379;71562;21280;19.2;5.7
79;2021-04-11;4;0;71566;21280;19.2;5.7
79;2021-04-12;1753;352;73319;21632;19.7;5.8
79;2021-04-13;2175;745;75494;22377;20.3;6.0
79;2021-04-14;2479;668;77973;23045;20.9;6.2
79;2021-04-15;2215;661;80188;23706;21.5;6.4
79;2021-04-16;1414;439;81602;24145;21.9;6.5
79;2021-04-17;581;350;82183;24495;22.1;6.6
79;2021-04-18;1;14;82184;24509;22.1;6.6
79;2021-04-19;1089;841;83273;25350;22.3;6.8
79;2021-04-20;1506;1229;84779;26579;22.8;7.1
79;2021-04-21;1417;1435;86196;28014;23.1;7.5
79;2021-04-22;1571;1079;87767;29093;23.6;7.8
79;2021-04-23;1318;1186;89085;30279;23.9;8.1
79;2021-04-24;651;462;89736;30741;24.1;8.2
79;2021-04-25;0;0;89736;30741;24.1;8.2
79;2021-04-26;1343;1812;91079;32553;24.4;8.7
79;2021-04-27;1898;2350;92977;34903;25.0;9.4
79;2021-04-28;1458;2866;94435;37769;25.3;10.1
79;2021-04-29;2107;2253;96542;40022;25.9;10.7
79;2021-04-30;2113;2453;98655;42475;26.5;11.4
79;2021-05-01;519;378;99174;42853;26.6;11.5
79;2021-05-02;1;11;99175;42864;26.6;11.5
79;2021-05-03;1182;1290;100357;44154;26.9;11.8
79;2021-05-04;1733;2323;102090;46477;27.4;12.5
79;2021-05-05;1695;2483;103785;48960;27.9;13.1
79;2021-05-06;2317;2210;106102;51170;28.5;13.7
79;2021-05-07;2085;2798;108187;53968;29.0;14.5
79;2021-05-08;199;508;108386;54476;29.1;14.6
79;2021-05-09;0;0;108386;54476;29.1;14.6
79;2021-05-10;1584;1784;109970;56260;29.5;15.1
79;2021-05-11;2311;1648;112281;57908;30.1;15.5
79;2021-05-12;1996;2676;114277;60584;30.7;16.3
79;2021-05-13;640;289;114917;60873;30.8;16.3
79;2021-05-14;2100;671;117017;61544;31.4;16.5
79;2021-05-15;1399;498;118416;62042;31.8;16.6
79;2021-05-16;1;22;118417;62064;31.8;16.7
79;2021-05-17;1873;1081;120290;63145;32.3;16.9
79;2021-05-18;2969;1269;123259;64414;33.1;17.3
79;2021-05-19;2895;966;126154;65380;33.9;17.5
79;2021-05-20;3103;1245;129257;66625;34.7;17.9
79;2021-05-21;2769;1063;132026;67688;35.4;18.2
79;2021-05-22;1084;260;133110;67948;35.7;18.2
79;2021-05-23;1;0;133111;67948;35.7;18.2
79;2021-05-24;161;20;133272;67968;35.8;18.2
79;2021-05-25;3199;985;136471;68953;36.6;18.5
79;2021-05-26;3314;850;139785;69803;37.5;18.7
79;2021-05-27;3588;1718;143373;71521;38.5;19.2
79;2021-05-28;3329;1819;146702;73340;39.4;19.7
79;2021-05-29;1073;451;147775;73791;39.7;19.8
79;2021-05-30;3;1;147778;73792;39.7;19.8
79;2021-05-31;2382;732;150160;74524;40.3;20.0
79;2021-06-01;3017;1574;153177;76098;41.1;20.4
79;2021-06-02;4061;1167;157238;77265;42.2;20.7
79;2021-06-03;4082;1753;161320;79018;43.3;21.2
79;2021-06-04;4144;2031;165464;81049;44.4;21.8
79;2021-06-05;2802;757;168266;81806;45.2;22.0
79;2021-06-06;696;39;168962;81845;45.3;22.0
79;2021-06-07;2811;1412;171773;83257;46.1;22.3
79;2021-06-08;2981;2066;174754;85323;46.9;22.9
79;2021-06-09;3629;1937;178383;87260;47.9;23.4
79;2021-06-10;3018;1973;181401;89233;48.7;23.9
79;2021-06-11;3767;2314;185168;91547;49.7;24.6
79;2021-06-12;1707;608;186875;92155;50.2;24.7
79;2021-06-13;214;24;187089;92179;50.2;24.7
79;2021-06-14;1246;1691;188335;93870;50.5;25.2
79;2021-06-15;1881;2362;190216;96232;51.0;25.8
79;2021-06-16;2204;2246;192420;98478;51.6;26.4
79;2021-06-17;2236;2615;194656;101093;52.2;27.1
79;2021-06-18;2410;2319;197066;103412;52.9;27.8
79;2021-06-19;1244;581;198310;103993;53.2;27.9
79;2021-06-20;3;2;198313;103995;53.2;27.9
79;2021-06-21;1230;2281;199543;106276;53.6;28.5
79;2021-06-22;1545;2872;201088;109148;54.0;29.3
79;2021-06-23;1767;2546;202855;111694;54.4;30.0
79;2021-06-24;2101;2004;204956;113698;55.0;30.5
79;2021-06-25;1483;2840;206439;116538;55.4;31.3
79;2021-06-26;867;809;207306;117347;55.6;31.5
79;2021-06-27;13;6;207319;117353;55.6;31.5
79;2021-06-28;1052;2621;208371;119974;55.9;32.2
79;2021-06-29;1462;3546;209833;123520;56.3;33.1
79;2021-06-30;1349;3447;211182;126967;56.7;34.1
79;2021-07-01;1178;3783;212360;130750;57.0;35.1
79;2021-07-02;1473;3346;213833;134096;57.4;36.0
79;2021-07-03;397;1504;214230;135600;57.5;36.4
79;2021-07-04;2;9;214232;135609;57.5;36.4
79;2021-07-05;744;2122;214976;137731;57.7;37.0
79;2021-07-06;942;3665;215918;141396;57.9;37.9
79;2021-07-07;1324;4308;217242;145704;58.3;39.1
79;2021-07-08;1078;4046;218320;149750;58.6;40.2
79;2021-07-09;834;3725;219154;153475;58.8;41.2
79;2021-07-10;510;1318;219664;154793;59.0;41.5
79;2021-07-11;1;12;219665;154805;59.0;41.5
79;2021-07-12;540;3696;220205;158501;59.1;42.5
79;2021-07-13;997;5196;221202;163697;59.4;43.9
79;2021-07-14;132;875;221334;164572;59.4;44.2
79;2021-07-15;1217;4683;222551;169255;59.7;45.4
79;2021-07-16;1322;4360;223873;173615;60.1;46.6
79;2021-07-17;571;2420;224444;176035;60.2;47.2
79;2021-07-18;43;498;224487;176533;60.2;47.4
79;2021-07-19;731;3320;225218;179853;60.4;48.3
79;2021-07-20;1222;3951;226440;183804;60.8;49.3
79;2021-07-21;1173;4197;227613;188001;61.1;50.5
79;2021-07-22;1343;3988;228956;191989;61.4;51.5
79;2021-07-23;1346;4561;230302;196550;61.8;52.7
79;2021-07-24;863;1498;231165;198048;62.0;53.1
79;2021-07-25;55;326;231220;198374;62.1;53.2
79;2021-07-26;1365;2594;232585;200968;62.4;53.9
79;2021-07-27;2076;2993;234661;203961;63.0;54.7
79;2021-07-28;2483;2492;237144;206453;63.6;55.4
79;2021-07-29;2996;2852;240140;209305;64.4;56.2
79;2021-07-30;2131;2824;242271;212129;65.0;56.9
79;2021-07-31;880;1155;243151;213284;65.3;57.2
79;2021-08-01;3;3;243154;213287;65.3;57.2
79;2021-08-02;1785;1541;244939;214828;65.7;57.7
79;2021-08-03;2810;2045;247749;216873;66.5;58.2
79;2021-08-04;2971;1734;250720;218607;67.3;58.7
79;2021-08-05;2885;2208;253605;220815;68.1;59.3
80;2020-12-27;0;0;0;0;0.0;0.0
80;2020-12-28;0;0;0;0;0.0;0.0
80;2020-12-29;11;0;11;0;0.0;0.0
80;2020-12-30;0;0;11;0;0.0;0.0
80;2020-12-31;0;0;11;0;0.0;0.0
80;2021-01-01;0;0;11;0;0.0;0.0
80;2021-01-02;0;0;11;0;0.0;0.0
80;2021-01-03;1;0;12;0;0.0;0.0
80;2021-01-04;0;0;12;0;0.0;0.0
80;2021-01-05;0;0;12;0;0.0;0.0
80;2021-01-06;30;0;42;0;0.0;0.0
80;2021-01-07;276;2;318;2;0.1;0.0
80;2021-01-08;330;0;648;2;0.1;0.0
80;2021-01-09;108;0;756;2;0.1;0.0
80;2021-01-10;21;0;777;2;0.1;0.0
80;2021-01-11;276;0;1053;2;0.2;0.0
80;2021-01-12;428;1;1481;3;0.3;0.0
80;2021-01-13;514;3;1995;6;0.4;0.0
80;2021-01-14;453;4;2448;10;0.4;0.0
80;2021-01-15;330;1;2778;11;0.5;0.0
80;2021-01-16;103;1;2881;12;0.5;0.0
80;2021-01-17;102;1;2983;13;0.5;0.0
80;2021-01-18;412;2;3395;15;0.6;0.0
80;2021-01-19;962;16;4357;31;0.8;0.0
80;2021-01-20;1086;4;5443;35;1.0;0.0
80;2021-01-21;1011;8;6454;43;1.1;0.0
80;2021-01-22;1113;4;7567;47;1.3;0.0
80;2021-01-23;908;0;8475;47;1.5;0.0
80;2021-01-24;824;4;9299;51;1.6;0.0
80;2021-01-25;1539;7;10838;58;1.9;0.0
80;2021-01-26;1479;10;12317;68;2.2;0.0
80;2021-01-27;822;28;13139;96;2.3;0.0
80;2021-01-28;623;174;13762;270;2.4;0.0
80;2021-01-29;637;219;14399;489;2.5;0.1
80;2021-01-30;85;60;14484;549;2.5;0.1
80;2021-01-31;0;0;14484;549;2.5;0.1
80;2021-02-01;26;257;14510;806;2.5;0.1
80;2021-02-02;21;446;14531;1252;2.6;0.2
80;2021-02-03;29;542;14560;1794;2.6;0.3
80;2021-02-04;277;349;14837;2143;2.6;0.4
80;2021-02-05;347;211;15184;2354;2.7;0.4
80;2021-02-06;167;70;15351;2424;2.7;0.4
80;2021-02-07;1;0;15352;2424;2.7;0.4
80;2021-02-08;425;241;15777;2665;2.8;0.5
80;2021-02-09;686;244;16463;2909;2.9;0.5
80;2021-02-10;606;495;17069;3404;3.0;0.6
80;2021-02-11;861;352;17930;3756;3.1;0.7
80;2021-02-12;943;315;18873;4071;3.3;0.7
80;2021-02-13;195;428;19068;4499;3.3;0.8
80;2021-02-14;78;572;19146;5071;3.4;0.9
80;2021-02-15;605;1018;19751;6089;3.5;1.1
80;2021-02-16;688;1137;20439;7226;3.6;1.3
80;2021-02-17;484;1172;20923;8398;3.7;1.5
80;2021-02-18;569;1137;21492;9535;3.8;1.7
80;2021-02-19;503;850;21995;10385;3.9;1.8
80;2021-02-20;22;516;22017;10901;3.9;1.9
80;2021-02-21;47;49;22064;10950;3.9;1.9
80;2021-02-22;149;576;22213;11526;3.9;2.0
80;2021-02-23;471;693;22684;12219;4.0;2.1
80;2021-02-24;431;680;23115;12899;4.1;2.3
80;2021-02-25;815;541;23930;13440;4.2;2.4
80;2021-02-26;1062;519;24992;13959;4.4;2.4
80;2021-02-27;476;72;25468;14031;4.5;2.5
80;2021-02-28;49;23;25517;14054;4.5;2.5
80;2021-03-01;728;65;26245;14119;4.6;2.5
80;2021-03-02;1014;89;27259;14208;4.8;2.5
80;2021-03-03;980;53;28239;14261;5.0;2.5
80;2021-03-04;1390;234;29629;14495;5.2;2.5
80;2021-03-05;1871;325;31500;14820;5.5;2.6
80;2021-03-06;2918;316;34418;15136;6.0;2.7
80;2021-03-07;1841;69;36259;15205;6.4;2.7
80;2021-03-08;714;606;36973;15811;6.5;2.8
80;2021-03-09;1309;907;38282;16718;6.7;2.9
80;2021-03-10;1722;746;40004;17464;7.0;3.1
80;2021-03-11;1908;819;41912;18283;7.4;3.2
80;2021-03-12;3137;731;45049;19014;7.9;3.3
80;2021-03-13;4006;191;49055;19205;8.6;3.4
80;2021-03-14;350;13;49405;19218;8.7;3.4
80;2021-03-15;1014;247;50419;19465;8.8;3.4
80;2021-03-16;882;336;51301;19801;9.0;3.5
80;2021-03-17;664;275;51965;20076;9.1;3.5
80;2021-03-18;1001;294;52966;20370;9.3;3.6
80;2021-03-19;1738;380;54704;20750;9.6;3.6
80;2021-03-20;3821;106;58525;20856;10.3;3.7
80;2021-03-21;488;30;59013;20886;10.4;3.7
80;2021-03-22;902;287;59915;21173;10.5;3.7
80;2021-03-23;1713;409;61628;21582;10.8;3.8
80;2021-03-24;1754;463;63382;22045;11.1;3.9
80;2021-03-25;2713;445;66095;22490;11.6;3.9
80;2021-03-26;3102;421;69197;22911;12.1;4.0
80;2021-03-27;2232;222;71429;23133;12.5;4.1
80;2021-03-28;675;90;72104;23223;12.7;4.1
80;2021-03-29;1981;745;74085;23968;13.0;4.2
80;2021-03-30;1970;869;76055;24837;13.3;4.4
80;2021-03-31;1495;985;77550;25822;13.6;4.5
80;2021-04-01;1952;1482;79502;27304;14.0;4.8
80;2021-04-02;2812;1572;82314;28876;14.4;5.1
80;2021-04-03;3042;856;85356;29732;15.0;5.2
80;2021-04-04;134;7;85490;29739;15.0;5.2
80;2021-04-05;684;199;86174;29938;15.1;5.3
80;2021-04-06;1280;966;87454;30904;15.3;5.4
80;2021-04-07;1624;1199;89078;32103;15.6;5.6
80;2021-04-08;2155;838;91233;32941;16.0;5.8
80;2021-04-09;3529;1345;94762;34286;16.6;6.0
80;2021-04-10;2735;1939;97497;36225;17.1;6.4
80;2021-04-11;189;175;97686;36400;17.1;6.4
80;2021-04-12;1808;484;99494;36884;17.5;6.5
80;2021-04-13;2381;1034;101875;37918;17.9;6.7
80;2021-04-14;2767;1138;104642;39056;18.4;6.9
80;2021-04-15;3732;864;108374;39920;19.0;7.0
80;2021-04-16;3335;861;111709;40781;19.6;7.2
80;2021-04-17;1652;2299;113361;43080;19.9;7.6
80;2021-04-18;372;388;113733;43468;20.0;7.6
80;2021-04-19;953;775;114686;44243;20.1;7.8
80;2021-04-20;1612;810;116298;45053;20.4;7.9
80;2021-04-21;1613;997;117911;46050;20.7;8.1
80;2021-04-22;2164;1250;120075;47300;21.1;8.3
80;2021-04-23;2638;1246;122713;48546;21.5;8.5
80;2021-04-24;1358;1189;124071;49735;21.8;8.7
80;2021-04-25;209;530;124280;50265;21.8;8.8
80;2021-04-26;1294;1444;125574;51709;22.0;9.1
80;2021-04-27;2024;1395;127598;53104;22.4;9.3
80;2021-04-28;2200;1396;129798;54500;22.8;9.6
80;2021-04-29;3215;1877;133013;56377;23.3;9.9
80;2021-04-30;3076;2848;136089;59225;23.9;10.4
80;2021-05-01;988;656;137077;59881;24.1;10.5
80;2021-05-02;370;52;137447;59933;24.1;10.5
80;2021-05-03;2721;1179;140168;61112;24.6;10.7
80;2021-05-04;2498;1706;142666;62818;25.0;11.0
80;2021-05-05;3364;1895;146030;64713;25.6;11.4
80;2021-05-06;3173;2547;149203;67260;26.2;11.8
80;2021-05-07;3454;2691;152657;69951;26.8;12.3
80;2021-05-08;2783;922;155440;70873;27.3;12.4
80;2021-05-09;1408;264;156848;71137;27.5;12.5
80;2021-05-10;1882;1831;158730;72968;27.9;12.8
80;2021-05-11;3275;1794;162005;74762;28.4;13.1
80;2021-05-12;4700;1568;166705;76330;29.3;13.4
80;2021-05-13;3834;362;170539;76692;29.9;13.5
80;2021-05-14;5190;1396;175729;78088;30.8;13.7
80;2021-05-15;5919;1051;181648;79139;31.9;13.9
80;2021-05-16;2679;305;184327;79444;32.4;13.9
80;2021-05-17;2369;817;186696;80261;32.8;14.1
80;2021-05-18;3947;849;190643;81110;33.5;14.2
80;2021-05-19;4015;944;194658;82054;34.2;14.4
80;2021-05-20;4567;1218;199225;83272;35.0;14.6
80;2021-05-21;4892;1666;204117;84938;35.8;14.9
80;2021-05-22;5031;1155;209148;86093;36.7;15.1
80;2021-05-23;1784;240;210932;86333;37.0;15.2
80;2021-05-24;1467;160;212399;86493;37.3;15.2
80;2021-05-25;2622;1134;215021;87627;37.7;15.4
80;2021-05-26;4247;1696;219268;89323;38.5;15.7
80;2021-05-27;3976;2471;223244;91794;39.2;16.1
80;2021-05-28;3864;2977;227108;94771;39.9;16.6
80;2021-05-29;3699;1623;230807;96394;40.5;16.9
80;2021-05-30;1182;199;231989;96593;40.7;17.0
80;2021-05-31;2602;1374;234591;97967;41.2;17.2
80;2021-06-01;4030;2432;238621;100399;41.9;17.6
80;2021-06-02;3335;2004;241956;102403;42.5;18.0
80;2021-06-03;4265;2927;246221;105330;43.2;18.5
80;2021-06-04;4795;3078;251016;108408;44.1;19.0
80;2021-06-05;3558;2077;254574;110485;44.7;19.4
80;2021-06-06;801;209;255375;110694;44.8;19.4
80;2021-06-07;1746;1943;257121;112637;45.1;19.8
80;2021-06-08;2743;2552;259864;115189;45.6;20.2
80;2021-06-09;3005;2728;262869;117917;46.1;20.7
80;2021-06-10;3164;3167;266033;121084;46.7;21.3
80;2021-06-11;3220;3889;269253;124973;47.3;21.9
80;2021-06-12;3041;2326;272294;127299;47.8;22.3
80;2021-06-13;473;404;272767;127703;47.9;22.4
80;2021-06-14;1263;2851;274030;130554;48.1;22.9
80;2021-06-15;2309;3420;276339;133974;48.5;23.5
80;2021-06-16;1563;4217;277902;138191;48.8;24.3
80;2021-06-17;2355;3624;280257;141815;49.2;24.9
80;2021-06-18;2551;3896;282808;145711;49.6;25.6
80;2021-06-19;2987;4343;285795;150054;50.2;26.3
80;2021-06-20;203;1077;285998;151131;50.2;26.5
80;2021-06-21;1012;2617;287010;153748;50.4;27.0
80;2021-06-22;1144;3933;288154;157681;50.6;27.7
80;2021-06-23;1850;5287;290004;162968;50.9;28.6
80;2021-06-24;1693;4682;291697;167650;51.2;29.4
80;2021-06-25;1374;6124;293071;173774;51.4;30.5
80;2021-06-26;1931;6183;295002;179957;51.8;31.6
80;2021-06-27;332;2029;295334;181986;51.8;31.9
80;2021-06-28;901;3167;296235;185153;52.0;32.5
80;2021-06-29;1913;4617;298148;189770;52.3;33.3
80;2021-06-30;1231;4782;299379;194552;52.5;34.1
80;2021-07-01;1554;4989;300933;199541;52.8;35.0
80;2021-07-02;1849;5979;302782;205520;53.1;36.1
80;2021-07-03;1292;5268;304074;210788;53.4;37.0
80;2021-07-04;690;1474;304764;212262;53.5;37.3
80;2021-07-05;871;2958;305635;215220;53.6;37.8
80;2021-07-06;1843;3982;307478;219202;54.0;38.5
80;2021-07-07;1543;4510;309021;223712;54.2;39.3
80;2021-07-08;2073;5000;311094;228712;54.6;40.1
80;2021-07-09;2587;5470;313681;234182;55.1;41.1
80;2021-07-10;1607;4016;315288;238198;55.3;41.8
80;2021-07-11;404;801;315692;238999;55.4;41.9
80;2021-07-12;860;3385;316552;242384;55.6;42.5
80;2021-07-13;2050;5090;318602;247474;55.9;43.4
80;2021-07-14;2781;1741;321383;249215;56.4;43.7
80;2021-07-15;2765;5298;324148;254513;56.9;44.7
80;2021-07-16;3864;5884;328012;260397;57.6;45.7
80;2021-07-17;3358;4459;331370;264856;58.2;46.5
80;2021-07-18;872;893;332242;265749;58.3;46.6
80;2021-07-19;2148;2875;334390;268624;58.7;47.1
80;2021-07-20;3301;4893;337691;273517;59.3;48.0
80;2021-07-21;3471;4488;341162;278005;59.9;48.8
80;2021-07-22;4326;4555;345488;282560;60.6;49.6
80;2021-07-23;5330;4809;350818;287369;61.6;50.4
80;2021-07-24;4224;4322;355042;291691;62.3;51.2
80;2021-07-25;1182;644;356224;292335;62.5;51.3
80;2021-07-26;2672;2329;358896;294664;63.0;51.7
80;2021-07-27;4353;3695;363249;298359;63.8;52.4
80;2021-07-28;5080;2791;368329;301150;64.6;52.9
80;2021-07-29;4967;3208;373296;304358;65.5;53.4
80;2021-07-30;5010;3620;378306;307978;66.4;54.1
80;2021-07-31;4143;2890;382449;310868;67.1;54.6
80;2021-08-01;1276;357;383725;311225;67.3;54.6
80;2021-08-02;2043;1749;385768;312974;67.7;54.9
80;2021-08-03;3701;2352;389469;315326;68.4;55.3
80;2021-08-04;3345;2484;392814;317810;68.9;55.8
80;2021-08-05;3120;2538;395934;320348;69.5;56.2
81;2020-12-27;0;0;0;0;0.0;0.0
81;2020-12-28;0;0;0;0;0.0;0.0
81;2020-12-29;0;0;0;0;0.0;0.0
81;2020-12-30;0;0;0;0;0.0;0.0
81;2020-12-31;0;0;0;0;0.0;0.0
81;2021-01-01;0;0;0;0;0.0;0.0
81;2021-01-02;0;0;0;0;0.0;0.0
81;2021-01-03;0;0;0;0;0.0;0.0
81;2021-01-04;1;0;1;0;0.0;0.0
81;2021-01-05;0;0;1;0;0.0;0.0
81;2021-01-06;5;0;6;0;0.0;0.0
81;2021-01-07;266;0;272;0;0.1;0.0
81;2021-01-08;312;1;584;1;0.2;0.0
81;2021-01-09;74;1;658;2;0.2;0.0
81;2021-01-10;1;0;659;2;0.2;0.0
81;2021-01-11;133;0;792;2;0.2;0.0
81;2021-01-12;167;0;959;2;0.2;0.0
81;2021-01-13;233;1;1192;3;0.3;0.0
81;2021-01-14;961;7;2153;10;0.6;0.0
81;2021-01-15;524;1;2677;11;0.7;0.0
81;2021-01-16;72;0;2749;11;0.7;0.0
81;2021-01-17;0;0;2749;11;0.7;0.0
81;2021-01-18;579;3;3328;14;0.9;0.0
81;2021-01-19;662;4;3990;18;1.0;0.0
81;2021-01-20;752;2;4742;20;1.2;0.0
81;2021-01-21;1174;3;5916;23;1.5;0.0
81;2021-01-22;852;2;6768;25;1.7;0.0
81;2021-01-23;221;1;6989;26;1.8;0.0
81;2021-01-24;102;0;7091;26;1.8;0.0
81;2021-01-25;567;3;7658;29;2.0;0.0
81;2021-01-26;634;5;8292;34;2.1;0.0
81;2021-01-27;551;4;8843;38;2.3;0.0
81;2021-01-28;687;215;9530;253;2.5;0.1
81;2021-01-29;300;183;9830;436;2.5;0.1
81;2021-01-30;202;37;10032;473;2.6;0.1
81;2021-01-31;104;1;10136;474;2.6;0.1
81;2021-02-01;320;130;10456;604;2.7;0.2
81;2021-02-02;446;142;10902;746;2.8;0.2
81;2021-02-03;476;223;11378;969;2.9;0.2
81;2021-02-04;1398;691;12776;1660;3.3;0.4
81;2021-02-05;868;315;13644;1975;3.5;0.5
81;2021-02-06;274;21;13918;1996;3.6;0.5
81;2021-02-07;103;0;14021;1996;3.6;0.5
81;2021-02-08;274;219;14295;2215;3.7;0.6
81;2021-02-09;418;220;14713;2435;3.8;0.6
81;2021-02-10;371;285;15084;2720;3.9;0.7
81;2021-02-11;651;388;15735;3108;4.1;0.8
81;2021-02-12;577;546;16312;3654;4.2;0.9
81;2021-02-13;187;159;16499;3813;4.3;1.0
81;2021-02-14;100;1;16599;3814;4.3;1.0
81;2021-02-15;234;484;16833;4298;4.3;1.1
81;2021-02-16;281;617;17114;4915;4.4;1.3
81;2021-02-17;242;520;17356;5435;4.5;1.4
81;2021-02-18;483;674;17839;6109;4.6;1.6
81;2021-02-19;566;410;18405;6519;4.7;1.7
81;2021-02-20;322;281;18727;6800;4.8;1.8
81;2021-02-21;23;80;18750;6880;4.8;1.8
81;2021-02-22;233;536;18983;7416;4.9;1.9
81;2021-02-23;168;594;19151;8010;4.9;2.1
81;2021-02-24;291;631;19442;8641;5.0;2.2
81;2021-02-25;710;1056;20152;9697;5.2;2.5
81;2021-02-26;909;959;21061;10656;5.4;2.7
81;2021-02-27;275;243;21336;10899;5.5;2.8
81;2021-02-28;21;88;21357;10987;5.5;2.8
81;2021-03-01;208;410;21565;11397;5.6;2.9
81;2021-03-02;364;542;21929;11939;5.7;3.1
81;2021-03-03;463;422;22392;12361;5.8;3.2
81;2021-03-04;1061;459;23453;12820;6.0;3.3
81;2021-03-05;1407;389;24860;13209;6.4;3.4
81;2021-03-06;981;166;25841;13375;6.7;3.4
81;2021-03-07;154;102;25995;13477;6.7;3.5
81;2021-03-08;465;359;26460;13836;6.8;3.6
81;2021-03-09;811;390;27271;14226;7.0;3.7
81;2021-03-10;899;392;28170;14618;7.3;3.8
81;2021-03-11;1346;354;29516;14972;7.6;3.9
81;2021-03-12;1690;299;31206;15271;8.0;3.9
81;2021-03-13;1030;187;32236;15458;8.3;4.0
81;2021-03-14;65;82;32301;15540;8.3;4.0
81;2021-03-15;1094;224;33395;15764;8.6;4.1
81;2021-03-16;724;228;34119;15992;8.8;4.1
81;2021-03-17;891;272;35010;16264;9.0;4.2
81;2021-03-18;970;581;35980;16845;9.3;4.3
81;2021-03-19;1271;449;37251;17294;9.6;4.5
81;2021-03-20;676;278;37927;17572;9.8;4.5
81;2021-03-21;139;22;38066;17594;9.8;4.5
81;2021-03-22;933;284;38999;17878;10.1;4.6
81;2021-03-23;1418;221;40417;18099;10.4;4.7
81;2021-03-24;1603;275;42020;18374;10.8;4.7
81;2021-03-25;2028;322;44048;18696;11.4;4.8
81;2021-03-26;2100;278;46148;18974;11.9;4.9
81;2021-03-27;1092;34;47240;19008;12.2;4.9
81;2021-03-28;734;39;47974;19047;12.4;4.9
81;2021-03-29;2866;177;50840;19224;13.1;5.0
81;2021-03-30;3054;205;53894;19429;13.9;5.0
81;2021-03-31;2690;290;56584;19719;14.6;5.1
81;2021-04-01;3311;559;59895;20278;15.4;5.2
81;2021-04-02;2613;364;62508;20642;16.1;5.3
81;2021-04-03;1146;299;63654;20941;16.4;5.4
81;2021-04-04;1401;18;65055;20959;16.8;5.4
81;2021-04-05;718;18;65773;20977;17.0;5.4
81;2021-04-06;1593;508;67366;21485;17.4;5.5
81;2021-04-07;1814;584;69180;22069;17.8;5.7
81;2021-04-08;2614;826;71794;22895;18.5;5.9
81;2021-04-09;3049;468;74843;23363;19.3;6.0
81;2021-04-10;1476;508;76319;23871;19.7;6.2
81;2021-04-11;1297;64;77616;23935;20.0;6.2
81;2021-04-12;1220;684;78836;24619;20.3;6.3
81;2021-04-13;2529;782;81365;25401;21.0;6.5
81;2021-04-14;2507;828;83872;26229;21.6;6.8
81;2021-04-15;3098;1190;86970;27419;22.4;7.1
81;2021-04-16;2820;1081;89790;28500;23.1;7.3
81;2021-04-17;1145;290;90935;28790;23.4;7.4
81;2021-04-18;518;145;91453;28935;23.6;7.5
81;2021-04-19;913;823;92366;29758;23.8;7.7
81;2021-04-20;2270;1166;94636;30924;24.4;8.0
81;2021-04-21;2224;1001;96860;31925;25.0;8.2
81;2021-04-22;2817;1058;99677;32983;25.7;8.5
81;2021-04-23;2880;965;102557;33948;26.4;8.8
81;2021-04-24;1326;743;103883;34691;26.8;8.9
81;2021-04-25;454;716;104337;35407;26.9;9.1
81;2021-04-26;1060;2424;105397;37831;27.2;9.8
81;2021-04-27;1598;2352;106995;40183;27.6;10.4
81;2021-04-28;1421;2394;108416;42577;27.9;11.0
81;2021-04-29;1816;2745;110232;45322;28.4;11.7
81;2021-04-30;2013;2353;112245;47675;28.9;12.3
81;2021-05-01;361;685;112606;48360;29.0;12.5
81;2021-05-02;291;1380;112897;49740;29.1;12.8
81;2021-05-03;1115;1169;114012;50909;29.4;13.1
81;2021-05-04;2619;1904;116631;52813;30.1;13.6
81;2021-05-05;2015;1929;118646;54742;30.6;14.1
81;2021-05-06;2745;3411;121391;58153;31.3;15.0
81;2021-05-07;2113;2858;123504;61011;31.8;15.7
81;2021-05-08;963;876;124467;61887;32.1;16.0
81;2021-05-09;534;1352;125001;63239;32.2;16.3
81;2021-05-10;824;1601;125825;64840;32.4;16.7
81;2021-05-11;1661;2575;127486;67415;32.9;17.4
81;2021-05-12;1637;2458;129123;69873;33.3;18.0
81;2021-05-13;1216;564;130339;70437;33.6;18.2
81;2021-05-14;1890;1722;132229;72159;34.1;18.6
81;2021-05-15;1511;618;133740;72777;34.5;18.8
81;2021-05-16;1368;414;135108;73191;34.8;18.9
81;2021-05-17;1166;862;136274;74053;35.1;19.1
81;2021-05-18;1699;1431;137973;75484;35.6;19.5
81;2021-05-19;2642;1244;140615;76728;36.3;19.8
81;2021-05-20;2968;1348;143583;78076;37.0;20.1
81;2021-05-21;2738;1118;146321;79194;37.7;20.4
81;2021-05-22;2816;519;149137;79713;38.4;20.5
81;2021-05-23;1178;74;150315;79787;38.8;20.6
81;2021-05-24;838;80;151153;79867;39.0;20.6
81;2021-05-25;2492;1104;153645;80971;39.6;20.9
81;2021-05-26;1891;796;155536;81767;40.1;21.1
81;2021-05-27;2556;1536;158092;83303;40.8;21.5
81;2021-05-28;2562;1663;160654;84966;41.4;21.9
81;2021-05-29;1401;540;162055;85506;41.8;22.0
81;2021-05-30;934;220;162989;85726;42.0;22.1
81;2021-05-31;1183;1338;164172;87064;42.3;22.4
81;2021-06-01;1780;2698;165952;89762;42.8;23.1
81;2021-06-02;2000;2443;167952;92205;43.3;23.8
81;2021-06-03;2001;2534;169953;94739;43.8;24.4
81;2021-06-04;1845;2948;171798;97687;44.3;25.2
81;2021-06-05;1754;1306;173552;98993;44.7;25.5
81;2021-06-06;370;366;173922;99359;44.8;25.6
81;2021-06-07;1209;1540;175131;100899;45.1;26.0
81;2021-06-08;2369;2387;177500;103286;45.8;26.6
81;2021-06-09;2438;1866;179938;105152;46.4;27.1
81;2021-06-10;1278;1564;181216;106716;46.7;27.5
81;2021-06-11;2654;2201;183870;108917;47.4;28.1
81;2021-06-12;1658;1037;185528;109954;47.8;28.3
81;2021-06-13;444;475;185972;110429;47.9;28.5
81;2021-06-14;773;1421;186745;111850;48.1;28.8
81;2021-06-15;1678;3502;188423;115352;48.6;29.7
81;2021-06-16;1266;3012;189689;118364;48.9;30.5
81;2021-06-17;1343;2523;191032;120887;49.2;31.2
81;2021-06-18;1836;2769;192868;123656;49.7;31.9
81;2021-06-19;825;949;193693;124605;49.9;32.1
81;2021-06-20;405;537;194098;125142;50.0;32.3
81;2021-06-21;425;1036;194523;126178;50.1;32.5
81;2021-06-22;1060;2566;195583;128744;50.4;33.2
81;2021-06-23;1142;2157;196725;130901;50.7;33.7
81;2021-06-24;1114;1937;197839;132838;51.0;34.2
81;2021-06-25;1237;2863;199076;135701;51.3;35.0
81;2021-06-26;722;1707;199798;137408;51.5;35.4
81;2021-06-27;526;1647;200324;139055;51.6;35.8
81;2021-06-28;476;1541;200800;140596;51.8;36.2
81;2021-06-29;1083;2637;201883;143233;52.0;36.9
81;2021-06-30;1040;3153;202923;146386;52.3;37.7
81;2021-07-01;875;2625;203798;149011;52.5;38.4
81;2021-07-02;987;2859;204785;151870;52.8;39.2
81;2021-07-03;731;2827;205516;154697;53.0;39.9
81;2021-07-04;268;1008;205784;155705;53.1;40.1
81;2021-07-05;702;1621;206486;157326;53.2;40.6
81;2021-07-06;973;3175;207459;160501;53.5;41.4
81;2021-07-07;1058;2438;208517;162939;53.8;42.0
81;2021-07-08;1027;2233;209544;165172;54.0;42.6
81;2021-07-09;1143;2698;210687;167870;54.3;43.3
81;2021-07-10;804;1523;211491;169393;54.5;43.7
81;2021-07-11;435;1010;211926;170403;54.6;43.9
81;2021-07-12;729;1726;212655;172129;54.8;44.4
81;2021-07-13;2059;3144;214714;175273;55.4;45.2
81;2021-07-14;1437;1562;216151;176835;55.7;45.6
81;2021-07-15;2533;2754;218684;179589;56.4;46.3
81;2021-07-16;2017;3021;220701;182610;56.9;47.1
81;2021-07-17;1214;2453;221915;185063;57.2;47.7
81;2021-07-18;673;1127;222588;186190;57.4;48.0
81;2021-07-19;1160;1729;223748;187919;57.7;48.4
81;2021-07-20;3037;2795;226785;190714;58.5;49.2
81;2021-07-21;3464;2328;230249;193042;59.4;49.8
81;2021-07-22;3545;2090;233794;195132;60.3;50.3
81;2021-07-23;3158;3228;236952;198360;61.1;51.1
81;2021-07-24;2513;1709;239465;200069;61.7;51.6
81;2021-07-25;1684;705;241149;200774;62.2;51.8
81;2021-07-26;1998;1535;243147;202309;62.7;52.2
81;2021-07-27;3570;2532;246717;204841;63.6;52.8
81;2021-07-28;3022;2188;249739;207029;64.4;53.4
81;2021-07-29;3318;1767;253057;208796;65.2;53.8
81;2021-07-30;2796;2238;255853;211034;66.0;54.4
81;2021-07-31;1943;999;257796;212033;66.5;54.7
81;2021-08-01;827;626;258623;212659;66.7;54.8
81;2021-08-02;1051;985;259674;213644;66.9;55.1
81;2021-08-03;2305;2103;261979;215747;67.5;55.6
81;2021-08-04;2003;1511;263982;217258;68.1;56.0
81;2021-08-05;1509;1856;265491;219114;68.4;56.5
82;2020-12-27;0;0;0;0;0.0;0.0
82;2020-12-28;2;0;2;0;0.0;0.0
82;2020-12-29;0;0;2;0;0.0;0.0
82;2020-12-30;0;0;2;0;0.0;0.0
82;2020-12-31;0;0;2;0;0.0;0.0
82;2021-01-01;0;0;2;0;0.0;0.0
82;2021-01-02;0;0;2;0;0.0;0.0
82;2021-01-03;0;0;2;0;0.0;0.0
82;2021-01-04;0;0;2;0;0.0;0.0
82;2021-01-05;86;0;88;0;0.0;0.0
82;2021-01-06;1;0;89;0;0.0;0.0
82;2021-01-07;75;0;164;0;0.1;0.0
82;2021-01-08;46;0;210;0;0.1;0.0
82;2021-01-09;77;0;287;0;0.1;0.0
82;2021-01-10;0;0;287;0;0.1;0.0
82;2021-01-11;94;0;381;0;0.1;0.0
82;2021-01-12;284;0;665;0;0.3;0.0
82;2021-01-13;336;1;1001;1;0.4;0.0
82;2021-01-14;441;4;1442;5;0.5;0.0
82;2021-01-15;612;2;2054;7;0.8;0.0
82;2021-01-16;229;3;2283;10;0.9;0.0
82;2021-01-17;89;0;2372;10;0.9;0.0
82;2021-01-18;433;2;2805;12;1.1;0.0
82;2021-01-19;479;1;3284;13;1.3;0.0
82;2021-01-20;663;1;3947;14;1.5;0.0
82;2021-01-21;446;1;4393;15;1.7;0.0
82;2021-01-22;483;2;4876;17;1.9;0.0
82;2021-01-23;151;0;5027;17;1.9;0.0
82;2021-01-24;0;0;5027;17;1.9;0.0
82;2021-01-25;376;0;5403;17;2.1;0.0
82;2021-01-26;468;0;5871;17;2.2;0.0
82;2021-01-27;519;1;6390;18;2.4;0.0
82;2021-01-28;585;34;6975;52;2.7;0.0
82;2021-01-29;405;108;7380;160;2.8;0.1
82;2021-01-30;44;22;7424;182;2.8;0.1
82;2021-01-31;0;0;7424;182;2.8;0.1
82;2021-02-01;292;55;7716;237;2.9;0.1
82;2021-02-02;344;100;8060;337;3.1;0.1
82;2021-02-03;462;66;8522;403;3.2;0.2
82;2021-02-04;764;219;9286;622;3.5;0.2
82;2021-02-05;479;148;9765;770;3.7;0.3
82;2021-02-06;93;39;9858;809;3.8;0.3
82;2021-02-07;29;79;9887;888;3.8;0.3
82;2021-02-08;149;226;10036;1114;3.8;0.4
82;2021-02-09;238;393;10274;1507;3.9;0.6
82;2021-02-10;271;602;10545;2109;4.0;0.8
82;2021-02-11;224;402;10769;2511;4.1;1.0
82;2021-02-12;190;610;10959;3121;4.2;1.2
82;2021-02-13;59;118;11018;3239;4.2;1.2
82;2021-02-14;4;81;11022;3320;4.2;1.3
82;2021-02-15;217;305;11239;3625;4.3;1.4
82;2021-02-16;280;392;11519;4017;4.4;1.5
82;2021-02-17;358;519;11877;4536;4.5;1.7
82;2021-02-18;507;506;12384;5042;4.7;1.9
82;2021-02-19;489;543;12873;5585;4.9;2.1
82;2021-02-20;78;139;12951;5724;4.9;2.2
82;2021-02-21;0;0;12951;5724;4.9;2.2
82;2021-02-22;199;408;13150;6132;5.0;2.3
82;2021-02-23;276;469;13426;6601;5.1;2.5
82;2021-02-24;283;458;13709;7059;5.2;2.7
82;2021-02-25;638;508;14347;7567;5.5;2.9
82;2021-02-26;648;397;14995;7964;5.7;3.0
82;2021-02-27;214;73;15209;8037;5.8;3.1
82;2021-02-28;30;7;15239;8044;5.8;3.1
82;2021-03-01;291;229;15530;8273;5.9;3.2
82;2021-03-02;495;402;16025;8675;6.1;3.3
82;2021-03-03;441;387;16466;9062;6.3;3.5
82;2021-03-04;600;300;17066;9362;6.5;3.6
82;2021-03-05;680;380;17746;9742;6.8;3.7
82;2021-03-06;687;41;18433;9783;7.0;3.7
82;2021-03-07;301;3;18734;9786;7.1;3.7
82;2021-03-08;603;155;19337;9941;7.4;3.8
82;2021-03-09;582;257;19919;10198;7.6;3.9
82;2021-03-10;778;246;20697;10444;7.9;4.0
82;2021-03-11;970;280;21667;10724;8.3;4.1
82;2021-03-12;992;104;22659;10828;8.6;4.1
82;2021-03-13;564;53;23223;10881;8.8;4.1
82;2021-03-14;61;5;23284;10886;8.9;4.1
82;2021-03-15;485;327;23769;11213;9.1;4.3
82;2021-03-16;197;334;23966;11547;9.1;4.4
82;2021-03-17;191;296;24157;11843;9.2;4.5
82;2021-03-18;279;350;24436;12193;9.3;4.6
82;2021-03-19;533;312;24969;12505;9.5;4.8
82;2021-03-20;252;58;25221;12563;9.6;4.8
82;2021-03-21;23;0;25244;12563;9.6;4.8
82;2021-03-22;405;319;25649;12882;9.8;4.9
82;2021-03-23;602;312;26251;13194;10.0;5.0
82;2021-03-24;620;334;26871;13528;10.2;5.2
82;2021-03-25;927;244;27798;13772;10.6;5.2
82;2021-03-26;1215;268;29013;14040;11.0;5.3
82;2021-03-27;478;78;29491;14118;11.2;5.4
82;2021-03-28;136;2;29627;14120;11.3;5.4
82;2021-03-29;925;379;30552;14499;11.6;5.5
82;2021-03-30;1187;279;31739;14778;12.1;5.6
82;2021-03-31;1018;260;32757;15038;12.5;5.7
82;2021-04-01;1073;198;33830;15236;12.9;5.8
82;2021-04-02;1211;285;35041;15521;13.3;5.9
82;2021-04-03;715;130;35756;15651;13.6;6.0
82;2021-04-04;276;13;36032;15664;13.7;6.0
82;2021-04-05;388;19;36420;15683;13.9;6.0
82;2021-04-06;952;511;37372;16194;14.2;6.2
82;2021-04-07;1017;497;38389;16691;14.6;6.4
82;2021-04-08;1454;415;39843;17106;15.2;6.5
82;2021-04-09;1656;468;41499;17574;15.8;6.7
82;2021-04-10;1712;99;43211;17673;16.5;6.7
82;2021-04-11;559;17;43770;17690;16.7;6.7
82;2021-04-12;1348;290;45118;17980;17.2;6.8
82;2021-04-13;1625;266;46743;18246;17.8;6.9
82;2021-04-14;1409;296;48152;18542;18.3;7.1
82;2021-04-15;1781;320;49933;18862;19.0;7.2
82;2021-04-16;1541;331;51474;19193;19.6;7.3
82;2021-04-17;1243;68;52717;19261;20.1;7.3
82;2021-04-18;560;14;53277;19275;20.3;7.3
82;2021-04-19;959;359;54236;19634;20.7;7.5
82;2021-04-20;1268;401;55504;20035;21.1;7.6
82;2021-04-21;1218;376;56722;20411;21.6;7.8
82;2021-04-22;1449;293;58171;20704;22.2;7.9
82;2021-04-23;1075;681;59246;21385;22.6;8.1
82;2021-04-24;1186;265;60432;21650;23.0;8.2
82;2021-04-25;736;48;61168;21698;23.3;8.3
82;2021-04-26;748;808;61916;22506;23.6;8.6
82;2021-04-27;905;924;62821;23430;23.9;8.9
82;2021-04-28;921;870;63742;24300;24.3;9.3
82;2021-04-29;1105;907;64847;25207;24.7;9.6
82;2021-04-30;1040;889;65887;26096;25.1;9.9
82;2021-05-01;1140;257;67027;26353;25.5;10.0
82;2021-05-02;697;145;67724;26498;25.8;10.1
82;2021-05-03;410;1215;68134;27713;25.9;10.6
82;2021-05-04;864;1170;68998;28883;26.3;11.0
82;2021-05-05;568;1172;69566;30055;26.5;11.4
82;2021-05-06;850;1419;70416;31474;26.8;12.0
82;2021-05-07;734;1453;71150;32927;27.1;12.5
82;2021-05-08;934;520;72084;33447;27.4;12.7
82;2021-05-09;753;580;72837;34027;27.7;13.0
82;2021-05-10;850;1365;73687;35392;28.1;13.5
82;2021-05-11;1158;1349;74845;36741;28.5;14.0
82;2021-05-12;1016;1345;75861;38086;28.9;14.5
82;2021-05-13;1455;430;77316;38516;29.4;14.7
82;2021-05-14;1691;1239;79007;39755;30.1;15.1
82;2021-05-15;1935;693;80942;40448;30.8;15.4
82;2021-05-16;558;115;81500;40563;31.0;15.4
82;2021-05-17;1090;1173;82590;41736;31.4;15.9
82;2021-05-18;1466;1188;84056;42924;32.0;16.3
82;2021-05-19;1269;978;85325;43902;32.5;16.7
82;2021-05-20;1409;1159;86734;45061;33.0;17.2
82;2021-05-21;1411;1215;88145;46276;33.6;17.6
82;2021-05-22;2070;630;90215;46906;34.4;17.9
82;2021-05-23;704;117;90919;47023;34.6;17.9
82;2021-05-24;1440;263;92359;47286;35.2;18.0
82;2021-05-25;1445;964;93804;48250;35.7;18.4
82;2021-05-26;1414;924;95218;49174;36.3;18.7
82;2021-05-27;1461;1026;96679;50200;36.8;19.1
82;2021-05-28;1539;1145;98218;51345;37.4;19.6
82;2021-05-29;1496;546;99714;51891;38.0;19.8
82;2021-05-30;402;101;100116;51992;38.1;19.8
82;2021-05-31;1489;990;101605;52982;38.7;20.2
82;2021-06-01;1749;1053;103354;54035;39.4;20.6
82;2021-06-02;1473;1005;104827;55040;39.9;21.0
82;2021-06-03;1490;1183;106317;56223;40.5;21.4
82;2021-06-04;2248;1306;108565;57529;41.3;21.9
82;2021-06-05;2271;985;110836;58514;42.2;22.3
82;2021-06-06;328;134;111164;58648;42.3;22.3
82;2021-06-07;958;1274;112122;59922;42.7;22.8
82;2021-06-08;1446;1141;113568;61063;43.2;23.3
82;2021-06-09;1708;1141;115276;62204;43.9;23.7
82;2021-06-10;1440;1208;116716;63412;44.4;24.1
82;2021-06-11;1922;1123;118638;64535;45.2;24.6
82;2021-06-12;2394;1397;121032;65932;46.1;25.1
82;2021-06-13;378;113;121410;66045;46.2;25.1
82;2021-06-14;1211;1081;122621;67126;46.7;25.6
82;2021-06-15;1461;1243;124082;68369;47.2;26.0
82;2021-06-16;1751;1168;125833;69537;47.9;26.5
82;2021-06-17;1220;1473;127053;71010;48.4;27.0
82;2021-06-18;1469;1438;128522;72448;48.9;27.6
82;2021-06-19;2272;979;130794;73427;49.8;28.0
82;2021-06-20;268;174;131062;73601;49.9;28.0
82;2021-06-21;483;1363;131545;74964;50.1;28.5
82;2021-06-22;891;1707;132436;76671;50.4;29.2
82;2021-06-23;1237;1589;133673;78260;50.9;29.8
82;2021-06-24;755;1903;134428;80163;51.2;30.5
82;2021-06-25;740;1938;135168;82101;51.5;31.3
82;2021-06-26;1239;2148;136407;84249;51.9;32.1
82;2021-06-27;195;438;136602;84687;52.0;32.2
82;2021-06-28;330;1413;136932;86100;52.1;32.8
82;2021-06-29;516;1842;137448;87942;52.3;33.5
82;2021-06-30;947;1908;138395;89850;52.7;34.2
82;2021-07-01;653;1632;139048;91482;52.9;34.8
82;2021-07-02;931;2298;139979;93780;53.3;35.7
82;2021-07-03;858;2338;140837;96118;53.6;36.6
82;2021-07-04;120;440;140957;96558;53.7;36.8
82;2021-07-05;440;1564;141397;98122;53.8;37.4
82;2021-07-06;512;1866;141909;99988;54.0;38.1
82;2021-07-07;789;1775;142698;101763;54.3;38.7
82;2021-07-08;503;1503;143201;103266;54.5;39.3
82;2021-07-09;779;2153;143980;105419;54.8;40.1
82;2021-07-10;705;2218;144685;107637;55.1;41.0
82;2021-07-11;38;382;144723;108019;55.1;41.1
82;2021-07-12;580;1884;145303;109903;55.3;41.8
82;2021-07-13;708;2003;146011;111906;55.6;42.6
82;2021-07-14;617;739;146628;112645;55.8;42.9
82;2021-07-15;850;1752;147478;114397;56.2;43.6
82;2021-07-16;1434;2632;148912;117029;56.7;44.6
82;2021-07-17;559;2193;149471;119222;56.9;45.4
82;2021-07-18;14;41;149485;119263;56.9;45.4
82;2021-07-19;729;2074;150214;121337;57.2;46.2
82;2021-07-20;917;1885;151131;123222;57.5;46.9
82;2021-07-21;1282;1760;152413;124982;58.0;47.6
82;2021-07-22;1071;1762;153484;126744;58.4;48.3
82;2021-07-23;1049;2983;154533;129727;58.8;49.4
82;2021-07-24;1097;1478;155630;131205;59.3;50.0
82;2021-07-25;301;71;155931;131276;59.4;50.0
82;2021-07-26;946;1897;156877;133173;59.7;50.7
82;2021-07-27;1327;1641;158204;134814;60.2;51.3
82;2021-07-28;1464;1497;159668;136311;60.8;51.9
82;2021-07-29;1324;1524;160992;137835;61.3;52.5
82;2021-07-30;1529;2477;162521;140312;61.9;53.4
82;2021-07-31;448;293;162969;140605;62.1;53.5
82;2021-08-01;273;50;163242;140655;62.2;53.6
82;2021-08-02;1267;868;164509;141523;62.6;53.9
82;2021-08-03;1429;822;165938;142345;63.2;54.2
82;2021-08-04;1361;1023;167299;143368;63.7;54.6
82;2021-08-05;1465;589;168764;143957;64.3;54.8
83;2020-12-27;1;0;1;0;0.0;0.0
83;2020-12-28;0;0;1;0;0.0;0.0
83;2020-12-29;0;0;1;0;0.0;0.0
83;2020-12-30;1;0;2;0;0.0;0.0
83;2020-12-31;0;0;2;0;0.0;0.0
83;2021-01-01;1;0;3;0;0.0;0.0
83;2021-01-02;0;0;3;0;0.0;0.0
83;2021-01-03;0;0;3;0;0.0;0.0
83;2021-01-04;1;0;4;0;0.0;0.0
83;2021-01-05;2;0;6;0;0.0;0.0
83;2021-01-06;69;0;75;0;0.0;0.0
83;2021-01-07;324;1;399;1;0.0;0.0
83;2021-01-08;410;0;809;1;0.1;0.0
83;2021-01-09;48;0;857;1;0.1;0.0
83;2021-01-10;1;0;858;1;0.1;0.0
83;2021-01-11;475;0;1333;1;0.1;0.0
83;2021-01-12;975;2;2308;3;0.2;0.0
83;2021-01-13;961;7;3269;10;0.3;0.0
83;2021-01-14;837;6;4106;16;0.4;0.0
83;2021-01-15;702;1;4808;17;0.4;0.0
83;2021-01-16;41;1;4849;18;0.5;0.0
83;2021-01-17;1;0;4850;18;0.5;0.0
83;2021-01-18;1218;3;6068;21;0.6;0.0
83;2021-01-19;2015;6;8083;27;0.8;0.0
83;2021-01-20;1658;9;9741;36;0.9;0.0
83;2021-01-21;2099;7;11840;43;1.1;0.0
83;2021-01-22;1655;5;13495;48;1.3;0.0
83;2021-01-23;243;0;13738;48;1.3;0.0
83;2021-01-24;21;1;13759;49;1.3;0.0
83;2021-01-25;1551;6;15310;55;1.4;0.0
83;2021-01-26;1747;15;17057;70;1.6;0.0
83;2021-01-27;2152;81;19209;151;1.8;0.0
83;2021-01-28;5077;357;24286;508;2.3;0.0
83;2021-01-29;2946;350;27232;858;2.5;0.1
83;2021-01-30;233;46;27465;904;2.6;0.1
83;2021-01-31;46;0;27511;904;2.6;0.1
83;2021-02-01;1277;422;28788;1326;2.7;0.1
83;2021-02-02;1437;729;30225;2055;2.8;0.2
83;2021-02-03;1522;638;31747;2693;3.0;0.3
83;2021-02-04;1484;751;33231;3444;3.1;0.3
83;2021-02-05;1217;683;34448;4127;3.2;0.4
83;2021-02-06;21;14;34469;4141;3.2;0.4
83;2021-02-07;1;0;34470;4141;3.2;0.4
83;2021-02-08;1086;631;35556;4772;3.3;0.4
83;2021-02-09;1324;914;36880;5686;3.4;0.5
83;2021-02-10;1526;805;38406;6491;3.6;0.6
83;2021-02-11;1604;1023;40010;7514;3.7;0.7
83;2021-02-12;1343;825;41353;8339;3.9;0.8
83;2021-02-13;52;25;41405;8364;3.9;0.8
83;2021-02-14;0;0;41405;8364;3.9;0.8
83;2021-02-15;666;1055;42071;9419;3.9;0.9
83;2021-02-16;542;1378;42613;10797;4.0;1.0
83;2021-02-17;804;1841;43417;12638;4.0;1.2
83;2021-02-18;1621;3872;45038;16510;4.2;1.5
83;2021-02-19;1473;2337;46511;18847;4.3;1.8
83;2021-02-20;62;170;46573;19017;4.3;1.8
83;2021-02-21;24;35;46597;19052;4.3;1.8
83;2021-02-22;500;1757;47097;20809;4.4;1.9
83;2021-02-23;669;1447;47766;22256;4.4;2.1
83;2021-02-24;721;1490;48487;23746;4.5;2.2
83;2021-02-25;1247;1413;49734;25159;4.6;2.3
83;2021-02-26;1298;1259;51032;26418;4.8;2.5
83;2021-02-27;551;55;51583;26473;4.8;2.5
83;2021-02-28;8;13;51591;26486;4.8;2.5
83;2021-03-01;806;1241;52397;27727;4.9;2.6
83;2021-03-02;987;1312;53384;29039;5.0;2.7
83;2021-03-03;1432;1528;54816;30567;5.1;2.8
83;2021-03-04;1885;1382;56701;31949;5.3;3.0
83;2021-03-05;2215;1233;58916;33182;5.5;3.1
83;2021-03-06;3001;108;61917;33290;5.8;3.1
83;2021-03-07;2224;33;64141;33323;6.0;3.1
83;2021-03-08;849;1320;64990;34643;6.1;3.2
83;2021-03-09;1925;1225;66915;35868;6.2;3.3
83;2021-03-10;2372;1361;69287;37229;6.5;3.5
83;2021-03-11;3667;2206;72954;39435;6.8;3.7
83;2021-03-12;3640;1505;76594;40940;7.1;3.8
83;2021-03-13;4594;171;81188;41111;7.6;3.8
83;2021-03-14;2325;44;83513;41155;7.8;3.8
83;2021-03-15;3335;665;86848;41820;8.1;3.9
83;2021-03-16;2597;695;89445;42515;8.3;4.0
83;2021-03-17;2843;783;92288;43298;8.6;4.0
83;2021-03-18;3550;796;95838;44094;8.9;4.1
83;2021-03-19;4170;580;100008;44674;9.3;4.2
83;2021-03-20;3472;62;103480;44736;9.6;4.2
83;2021-03-21;2010;29;105490;44765;9.8;4.2
83;2021-03-22;3959;890;109449;45655;10.2;4.3
83;2021-03-23;4745;587;114194;46242;10.6;4.3
83;2021-03-24;5041;715;119235;46957;11.1;4.4
83;2021-03-25;6529;839;125764;47796;11.7;4.5
83;2021-03-26;7170;741;132934;48537;12.4;4.5
83;2021-03-27;3966;384;136900;48921;12.7;4.6
83;2021-03-28;2183;29;139083;48950;13.0;4.6
83;2021-03-29;4549;760;143632;49710;13.4;4.6
83;2021-03-30;5953;930;149585;50640;13.9;4.7
83;2021-03-31;5549;1068;155134;51708;14.4;4.8
83;2021-04-01;5969;1250;161103;52958;15.0;4.9
83;2021-04-02;5757;1059;166860;54017;15.5;5.0
83;2021-04-03;1800;629;168660;54646;15.7;5.1
83;2021-04-04;854;346;169514;54992;15.8;5.1
83;2021-04-05;188;66;169702;55058;15.8;5.1
83;2021-04-06;4724;1379;174426;56437;16.2;5.3
83;2021-04-07;5827;1649;180253;58086;16.8;5.4
83;2021-04-08;7872;1980;188125;60066;17.5;5.6
83;2021-04-09;7582;2177;195707;62243;18.2;5.8
83;2021-04-10;2947;2644;198654;64887;18.5;6.0
83;2021-04-11;1723;2132;200377;67019;18.7;6.2
83;2021-04-12;4949;2860;205326;69879;19.1;6.5
83;2021-04-13;5404;2996;210730;72875;19.6;6.8
83;2021-04-14;5896;2938;216626;75813;20.2;7.1
83;2021-04-15;6772;3016;223398;78829;20.8;7.3
83;2021-04-16;6120;3500;229518;82329;21.4;7.7
83;2021-04-17;3509;2183;233027;84512;21.7;7.9
83;2021-04-18;2175;1297;235202;85809;21.9;8.0
83;2021-04-19;4104;3898;239306;89707;22.3;8.4
83;2021-04-20;4357;3865;243663;93572;22.7;8.7
83;2021-04-21;4302;4157;247965;97729;23.1;9.1
83;2021-04-22;5003;4291;252968;102020;23.6;9.5
83;2021-04-23;4524;4562;257492;106582;24.0;9.9
83;2021-04-24;2628;2710;260120;109292;24.2;10.2
83;2021-04-25;1927;1570;262047;110862;24.4;10.3
83;2021-04-26;3569;3847;265616;114709;24.7;10.7
83;2021-04-27;4131;4541;269747;119250;25.1;11.1
83;2021-04-28;4316;4368;274063;123618;25.5;11.5
83;2021-04-29;5811;5105;279874;128723;26.1;12.0
83;2021-04-30;5785;4299;285659;133022;26.6;12.4
83;2021-05-01;1693;425;287352;133447;26.8;12.4
83;2021-05-02;1237;752;288589;134199;26.9;12.5
83;2021-05-03;3751;4274;292340;138473;27.2;12.9
83;2021-05-04;3344;5096;295684;143569;27.5;13.4
83;2021-05-05;3638;4965;299322;148534;27.9;13.8
83;2021-05-06;4672;4942;303994;153476;28.3;14.3
83;2021-05-07;4171;5314;308165;158790;28.7;14.8
83;2021-05-08;2759;1007;310924;159797;29.0;14.9
83;2021-05-09;2151;1233;313075;161030;29.2;15.0
83;2021-05-10;3206;5420;316281;166450;29.5;15.5
83;2021-05-11;5120;5660;321401;172110;29.9;16.0
83;2021-05-12;6292;4845;327693;176955;30.5;16.5
83;2021-05-13;6579;1334;334272;178289;31.1;16.6
83;2021-05-14;7418;4108;341690;182397;31.8;17.0
83;2021-05-15;7753;2197;349443;184594;32.5;17.2
83;2021-05-16;6627;1246;356070;185840;33.2;17.3
83;2021-05-17;4894;4211;360964;190051;33.6;17.7
83;2021-05-18;5524;3857;366488;193908;34.1;18.1
83;2021-05-19;6206;3400;372694;197308;34.7;18.4
83;2021-05-20;6751;3783;379445;201091;35.3;18.7
83;2021-05-21;7906;3866;387351;204957;36.1;19.1
83;2021-05-22;6088;1716;393439;206673;36.6;19.2
83;2021-05-23;4683;703;398122;207376;37.1;19.3
83;2021-05-24;5811;970;403933;208346;37.6;19.4
83;2021-05-25;5510;4750;409443;213096;38.1;19.8
83;2021-05-26;4854;4434;414297;217530;38.6;20.3
83;2021-05-27;5070;5258;419367;222788;39.1;20.7
83;2021-05-28;4504;5765;423871;228553;39.5;21.3
83;2021-05-29;2704;4272;426575;232825;39.7;21.7
83;2021-05-30;1253;1374;427828;234199;39.8;21.8
83;2021-05-31;5488;4761;433316;238960;40.4;22.3
83;2021-06-01;5721;5300;439037;244260;40.9;22.7
83;2021-06-02;5247;4574;444284;248834;41.4;23.2
83;2021-06-03;5733;5127;450017;253961;41.9;23.6
83;2021-06-04;5441;6040;455458;260001;42.4;24.2
83;2021-06-05;3925;3191;459383;263192;42.8;24.5
83;2021-06-06;1933;1379;461316;264571;43.0;24.6
83;2021-06-07;3916;5084;465232;269655;43.3;25.1
83;2021-06-08;4169;4809;469401;274464;43.7;25.6
83;2021-06-09;4004;4701;473405;279165;44.1;26.0
83;2021-06-10;3992;4252;477397;283417;44.5;26.4
83;2021-06-11;3654;5441;481051;288858;44.8;26.9
83;2021-06-12;2908;2983;483959;291841;45.1;27.2
83;2021-06-13;995;1391;484954;293232;45.2;27.3
83;2021-06-14;2857;5656;487811;298888;45.4;27.8
83;2021-06-15;3161;4859;490972;303747;45.7;28.3
83;2021-06-16;2955;4504;493927;308251;46.0;28.7
83;2021-06-17;2763;5283;496690;313534;46.3;29.2
83;2021-06-18;3154;5957;499844;319491;46.5;29.8
83;2021-06-19;2319;4089;502163;323580;46.8;30.1
83;2021-06-20;672;1889;502835;325469;46.8;30.3
83;2021-06-21;2107;7582;504942;333051;47.0;31.0
83;2021-06-22;2098;7162;507040;340213;47.2;31.7
83;2021-06-23;1925;6926;508965;347139;47.4;32.3
83;2021-06-24;1948;7360;510913;354499;47.6;33.0
83;2021-06-25;2104;8398;513017;362897;47.8;33.8
83;2021-06-26;1463;6809;514480;369706;47.9;34.4
83;2021-06-27;690;3187;515170;372893;48.0;34.7
83;2021-06-28;1572;7888;516742;380781;48.1;35.5
83;2021-06-29;1895;7798;518637;388579;48.3;36.2
83;2021-06-30;2235;7262;520872;395841;48.5;36.9
83;2021-07-01;2539;6562;523411;402403;48.7;37.5
83;2021-07-02;2239;7791;525650;410194;49.0;38.2
83;2021-07-03;1500;5688;527150;415882;49.1;38.7
83;2021-07-04;567;2749;527717;418631;49.1;39.0
83;2021-07-05;1895;7529;529612;426160;49.3;39.7
83;2021-07-06;2556;5929;532168;432089;49.6;40.2
83;2021-07-07;2662;4661;534830;436750;49.8;40.7
83;2021-07-08;3228;4463;538058;441213;50.1;41.1
83;2021-07-09;3024;6959;541082;448172;50.4;41.7
83;2021-07-10;1562;4928;542644;453100;50.5;42.2
83;2021-07-11;993;1761;543637;454861;50.6;42.4
83;2021-07-12;2113;7679;545750;462540;50.8;43.1
83;2021-07-13;4003;7060;549753;469600;51.2;43.7
83;2021-07-14;2078;1309;551831;470909;51.4;43.9
83;2021-07-15;4524;6829;556355;477738;51.8;44.5
83;2021-07-16;5226;7107;561581;484845;52.3;45.2
83;2021-07-17;3575;4982;565156;489827;52.6;45.6
83;2021-07-18;1593;1304;566749;491131;52.8;45.7
83;2021-07-19;3927;6296;570676;497427;53.1;46.3
83;2021-07-20;5926;6140;576602;503567;53.7;46.9
83;2021-07-21;5972;5172;582574;508739;54.3;47.4
83;2021-07-22;7040;5493;589614;514232;54.9;47.9
83;2021-07-23;7005;5852;596619;520084;55.6;48.4
83;2021-07-24;4580;4528;601199;524612;56.0;48.9
83;2021-07-25;1323;727;602522;525339;56.1;48.9
83;2021-07-26;5481;4888;608003;530227;56.6;49.4
83;2021-07-27;6744;4849;614747;535076;57.2;49.8
83;2021-07-28;6556;4360;621303;539436;57.9;50.2
83;2021-07-29;7408;4758;628711;544194;58.5;50.7
83;2021-07-30;6899;4701;635610;548895;59.2;51.1
83;2021-07-31;4619;3161;640229;552056;59.6;51.4
83;2021-08-01;1048;832;641277;552888;59.7;51.5
83;2021-08-02;5695;3643;646972;556531;60.2;51.8
83;2021-08-03;6299;3919;653271;560450;60.8;52.2
83;2021-08-04;5838;3626;659109;564076;61.4;52.5
83;2021-08-05;6016;4011;665125;568087;61.9;52.9
84;2020-12-27;0;0;0;0;0.0;0.0
84;2020-12-28;0;0;0;0;0.0;0.0
84;2020-12-29;0;0;0;0;0.0;0.0
84;2020-12-30;0;0;0;0;0.0;0.0
84;2020-12-31;0;0;0;0;0.0;0.0
84;2021-01-01;0;0;0;0;0.0;0.0
84;2021-01-02;0;0;0;0;0.0;0.0
84;2021-01-03;0;0;0;0;0.0;0.0
84;2021-01-04;0;0;0;0;0.0;0.0
84;2021-01-05;0;0;0;0;0.0;0.0
84;2021-01-06;0;0;0;0;0.0;0.0
84;2021-01-07;69;0;69;0;0.0;0.0
84;2021-01-08;81;0;150;0;0.0;0.0
84;2021-01-09;30;0;180;0;0.0;0.0
84;2021-01-10;0;0;180;0;0.0;0.0
84;2021-01-11;219;0;399;0;0.1;0.0
84;2021-01-12;623;2;1022;2;0.2;0.0
84;2021-01-13;358;0;1380;2;0.2;0.0
84;2021-01-14;939;13;2319;15;0.4;0.0
84;2021-01-15;617;9;2936;24;0.5;0.0
84;2021-01-16;166;0;3102;24;0.6;0.0
84;2021-01-17;27;1;3129;25;0.6;0.0
84;2021-01-18;695;3;3824;28;0.7;0.0
84;2021-01-19;876;1;4700;29;0.8;0.0
84;2021-01-20;1016;3;5716;32;1.0;0.0
84;2021-01-21;1048;4;6764;36;1.2;0.0
84;2021-01-22;1132;0;7896;36;1.4;0.0
84;2021-01-23;248;0;8144;36;1.5;0.0
84;2021-01-24;3;0;8147;36;1.5;0.0
84;2021-01-25;804;0;8951;36;1.6;0.0
84;2021-01-26;938;5;9889;41;1.8;0.0
84;2021-01-27;1070;2;10959;43;2.0;0.0
84;2021-01-28;1623;18;12582;61;2.2;0.0
84;2021-01-29;1198;63;13780;124;2.5;0.0
84;2021-01-30;171;21;13951;145;2.5;0.0
84;2021-01-31;7;0;13958;145;2.5;0.0
84;2021-02-01;654;148;14612;293;2.6;0.1
84;2021-02-02;787;269;15399;562;2.7;0.1
84;2021-02-03;758;244;16157;806;2.9;0.1
84;2021-02-04;910;408;17067;1214;3.0;0.2
84;2021-02-05;726;417;17793;1631;3.2;0.3
84;2021-02-06;124;50;17917;1681;3.2;0.3
84;2021-02-07;0;0;17917;1681;3.2;0.3
84;2021-02-08;567;277;18484;1958;3.3;0.3
84;2021-02-09;690;718;19174;2676;3.4;0.5
84;2021-02-10;551;568;19725;3244;3.5;0.6
84;2021-02-11;548;586;20273;3830;3.6;0.7
84;2021-02-12;558;681;20831;4511;3.7;0.8
84;2021-02-13;46;171;20877;4682;3.7;0.8
84;2021-02-14;3;0;20880;4682;3.7;0.8
84;2021-02-15;208;892;21088;5574;3.8;1.0
84;2021-02-16;221;833;21309;6407;3.8;1.1
84;2021-02-17;447;781;21756;7188;3.9;1.3
84;2021-02-18;554;1106;22310;8294;4.0;1.5
84;2021-02-19;737;1189;23047;9483;4.1;1.7
84;2021-02-20;65;154;23112;9637;4.1;1.7
84;2021-02-21;3;37;23115;9674;4.1;1.7
84;2021-02-22;369;744;23484;10418;4.2;1.9
84;2021-02-23;268;705;23752;11123;4.2;2.0
84;2021-02-24;392;740;24144;11863;4.3;2.1
84;2021-02-25;711;846;24855;12709;4.4;2.3
84;2021-02-26;821;683;25676;13392;4.6;2.4
84;2021-02-27;133;126;25809;13518;4.6;2.4
84;2021-02-28;16;0;25825;13518;4.6;2.4
84;2021-03-01;456;672;26281;14190;4.7;2.5
84;2021-03-02;631;811;26912;15001;4.8;2.7
84;2021-03-03;821;959;27733;15960;4.9;2.8
84;2021-03-04;1093;708;28826;16668;5.1;3.0
84;2021-03-05;1309;518;30135;17186;5.4;3.1
84;2021-03-06;1461;62;31596;17248;5.6;3.1
84;2021-03-07;480;15;32076;17263;5.7;3.1
84;2021-03-08;812;606;32888;17869;5.9;3.2
84;2021-03-09;1385;785;34273;18654;6.1;3.3
84;2021-03-10;1471;663;35744;19317;6.4;3.4
84;2021-03-11;1983;642;37727;19959;6.7;3.6
84;2021-03-12;2078;627;39805;20586;7.1;3.7
84;2021-03-13;743;35;40548;20621;7.2;3.7
84;2021-03-14;247;53;40795;20674;7.3;3.7
84;2021-03-15;1067;310;41862;20984;7.5;3.7
84;2021-03-16;1179;336;43041;21320;7.7;3.8
84;2021-03-17;1142;440;44183;21760;7.9;3.9
84;2021-03-18;1455;393;45638;22153;8.1;3.9
84;2021-03-19;2174;459;47812;22612;8.5;4.0
84;2021-03-20;838;24;48650;22636;8.7;4.0
84;2021-03-21;150;9;48800;22645;8.7;4.0
84;2021-03-22;1153;458;49953;23103;8.9;4.1
84;2021-03-23;1908;460;51861;23563;9.2;4.2
84;2021-03-24;2177;394;54038;23957;9.6;4.3
84;2021-03-25;3651;392;57689;24349;10.3;4.3
84;2021-03-26;3314;475;61003;24824;10.9;4.4
84;2021-03-27;913;56;61916;24880;11.0;4.4
84;2021-03-28;71;2;61987;24882;11.0;4.4
84;2021-03-29;1716;525;63703;25407;11.4;4.5
84;2021-03-30;2665;680;66368;26087;11.8;4.7
84;2021-03-31;2398;641;68766;26728;12.3;4.8
84;2021-04-01;3015;563;71781;27291;12.8;4.9
84;2021-04-02;2450;526;74231;27817;13.2;5.0
84;2021-04-03;507;28;74738;27845;13.3;5.0
84;2021-04-04;12;0;74750;27845;13.3;5.0
84;2021-04-05;809;99;75559;27944;13.5;5.0
84;2021-04-06;2140;833;77699;28777;13.9;5.1
84;2021-04-07;2403;858;80102;29635;14.3;5.3
84;2021-04-08;3648;1025;83750;30660;14.9;5.5
84;2021-04-09;4113;938;87863;31598;15.7;5.6
84;2021-04-10;1306;127;89169;31725;15.9;5.7
84;2021-04-11;37;12;89206;31737;15.9;5.7
84;2021-04-12;2090;804;91296;32541;16.3;5.8
84;2021-04-13;2942;1366;94238;33907;16.8;6.0
84;2021-04-14;2810;1351;97048;35258;17.3;6.3
84;2021-04-15;3270;1408;100318;36666;17.9;6.5
84;2021-04-16;3427;1542;103745;38208;18.5;6.8
84;2021-04-17;1664;193;105409;38401;18.8;6.8
84;2021-04-18;34;0;105443;38401;18.8;6.8
84;2021-04-19;2503;914;107946;39315;19.2;7.0
84;2021-04-20;2625;1525;110571;40840;19.7;7.3
84;2021-04-21;2651;1488;113222;42328;20.2;7.5
84;2021-04-22;3011;1732;116233;44060;20.7;7.9
84;2021-04-23;3031;1892;119264;45952;21.3;8.2
84;2021-04-24;1530;286;120794;46238;21.5;8.2
84;2021-04-25;27;2;120821;46240;21.5;8.2
84;2021-04-26;2179;1367;123000;47607;21.9;8.5
84;2021-04-27;2551;1983;125551;49590;22.4;8.8
84;2021-04-28;2816;1841;128367;51431;22.9;9.2
84;2021-04-29;3420;2021;131787;53452;23.5;9.5
84;2021-04-30;3132;2416;134919;55868;24.0;10.0
84;2021-05-01;457;258;135376;56126;24.1;10.0
84;2021-05-02;1;0;135377;56126;24.1;10.0
84;2021-05-03;2164;1628;137541;57754;24.5;10.3
84;2021-05-04;2490;2527;140031;60281;25.0;10.7
84;2021-05-05;2349;2214;142380;62495;25.4;11.1
84;2021-05-06;3224;2251;145604;64746;26.0;11.5
84;2021-05-07;2763;2560;148367;67306;26.4;12.0
84;2021-05-08;1156;527;149523;67833;26.7;12.1
84;2021-05-09;6;52;149529;67885;26.7;12.1
84;2021-05-10;2155;2456;151684;70341;27.0;12.5
84;2021-05-11;2908;3163;154592;73504;27.6;13.1
84;2021-05-12;2849;2917;157441;76421;28.1;13.6
84;2021-05-13;2158;842;159599;77263;28.4;13.8
84;2021-05-14;2726;2031;162325;79294;28.9;14.1
84;2021-05-15;2001;983;164326;80277;29.3;14.3
84;2021-05-16;1339;182;165665;80459;29.5;14.3
84;2021-05-17;2221;2153;167886;82612;29.9;14.7
84;2021-05-18;2903;2101;170789;84713;30.4;15.1
84;2021-05-19;3231;1664;174020;86377;31.0;15.4
84;2021-05-20;3698;2203;177718;88580;31.7;15.8
84;2021-05-21;3469;2333;181187;90913;32.3;16.2
84;2021-05-22;1583;677;182770;91590;32.6;16.3
84;2021-05-23;5;9;182775;91599;32.6;16.3
84;2021-05-24;1839;425;184614;92024;32.9;16.4
84;2021-05-25;2985;2181;187599;94205;33.4;16.8
84;2021-05-26;3075;2083;190674;96288;34.0;17.2
84;2021-05-27;3854;2320;194528;98608;34.7;17.6
84;2021-05-28;3182;3301;197710;101909;35.2;18.2
84;2021-05-29;1090;1650;198800;103559;35.4;18.5
84;2021-05-30;7;85;198807;103644;35.4;18.5
84;2021-05-31;2191;2633;200998;106277;35.8;18.9
84;2021-06-01;3143;3158;204141;109435;36.4;19.5
84;2021-06-02;3172;2619;207313;112054;37.0;20.0
84;2021-06-03;4110;2981;211423;115035;37.7;20.5
84;2021-06-04;3615;3036;215038;118071;38.3;21.0
84;2021-06-05;1783;1496;216821;119567;38.6;21.3
84;2021-06-06;987;205;217808;119772;38.8;21.3
84;2021-06-07;2451;2745;220259;122517;39.3;21.8
84;2021-06-08;3319;3049;223578;125566;39.9;22.4
84;2021-06-09;3029;2675;226607;128241;40.4;22.9
84;2021-06-10;3505;2785;230112;131026;41.0;23.4
84;2021-06-11;3019;3058;233131;134084;41.6;23.9
84;2021-06-12;1963;1313;235094;135397;41.9;24.1
84;2021-06-13;413;212;235507;135609;42.0;24.2
84;2021-06-14;1929;3159;237436;138768;42.3;24.7
84;2021-06-15;2573;3449;240009;142217;42.8;25.4
84;2021-06-16;2524;2940;242533;145157;43.2;25.9
84;2021-06-17;2994;3450;245527;148607;43.8;26.5
84;2021-06-18;2423;3544;247950;152151;44.2;27.1
84;2021-06-19;1288;1543;249238;153694;44.4;27.4
84;2021-06-20;548;353;249786;154047;44.5;27.5
84;2021-06-21;1569;3128;251355;157175;44.8;28.0
84;2021-06-22;2163;4009;253518;161184;45.2;28.7
84;2021-06-23;2113;3302;255631;164486;45.6;29.3
84;2021-06-24;2198;3477;257829;167963;46.0;29.9
84;2021-06-25;1836;3883;259665;171846;46.3;30.6
84;2021-06-26;1131;1815;260796;173661;46.5;31.0
84;2021-06-27;295;345;261091;174006;46.5;31.0
84;2021-06-28;1206;3218;262297;177224;46.8;31.6
84;2021-06-29;1474;4043;263771;181267;47.0;32.3
84;2021-06-30;1708;3957;265479;185224;47.3;33.0
84;2021-07-01;1793;3939;267272;189163;47.6;33.7
84;2021-07-02;1748;3893;269020;193056;48.0;34.4
84;2021-07-03;1101;2031;270121;195087;48.2;34.8
84;2021-07-04;390;413;270511;195500;48.2;34.8
84;2021-07-05;1460;3540;271971;199040;48.5;35.5
84;2021-07-06;1595;4162;273566;203202;48.8;36.2
84;2021-07-07;1644;3101;275210;206303;49.1;36.8
84;2021-07-08;2117;3746;277327;210049;49.4;37.4
84;2021-07-09;1810;3972;279137;214021;49.8;38.2
84;2021-07-10;1240;2158;280377;216179;50.0;38.5
84;2021-07-11;333;305;280710;216484;50.0;38.6
84;2021-07-12;1374;3839;282084;220323;50.3;39.3
84;2021-07-13;2326;5006;284410;225329;50.7;40.2
84;2021-07-14;1872;1240;286282;226569;51.0;40.4
84;2021-07-15;2611;4549;288893;231118;51.5;41.2
84;2021-07-16;2757;4591;291650;235709;52.0;42.0
84;2021-07-17;1572;2433;293222;238142;52.3;42.4
84;2021-07-18;1007;542;294229;238684;52.4;42.5
84;2021-07-19;2392;3739;296621;242423;52.9;43.2
84;2021-07-20;2924;4148;299545;246571;53.4;44.0
84;2021-07-21;3157;3642;302702;250213;54.0;44.6
84;2021-07-22;3759;3770;306461;253983;54.6;45.3
84;2021-07-23;3496;3665;309957;257648;55.3;45.9
84;2021-07-24;1450;2247;311407;259895;55.5;46.3
84;2021-07-25;1033;506;312440;260401;55.7;46.4
84;2021-07-26;2707;3010;315147;263411;56.2;47.0
84;2021-07-27;3414;3547;318561;266958;56.8;47.6
84;2021-07-28;3830;3294;322391;270252;57.5;48.2
84;2021-07-29;4184;3129;326575;273381;58.2;48.7
84;2021-07-30;3938;3291;330513;276672;58.9;49.3
84;2021-07-31;1988;1663;332501;278335;59.3;49.6
84;2021-08-01;813;421;333314;278756;59.4;49.7
84;2021-08-02;2909;2654;336223;281410;59.9;50.2
84;2021-08-03;4071;2752;340294;284162;60.7;50.7
84;2021-08-04;3833;2559;344127;286721;61.3;51.1
84;2021-08-05;3804;2523;347931;289244;62.0;51.6
85;2020-12-27;1;0;1;0;0.0;0.0
85;2020-12-28;0;0;1;0;0.0;0.0
85;2020-12-29;0;0;1;0;0.0;0.0
85;2020-12-30;0;0;1;0;0.0;0.0
85;2020-12-31;0;0;1;0;0.0;0.0
85;2021-01-01;0;0;1;0;0.0;0.0
85;2021-01-02;0;0;1;0;0.0;0.0
85;2021-01-03;1;0;2;0;0.0;0.0
85;2021-01-04;25;0;27;0;0.0;0.0
85;2021-01-05;62;0;89;0;0.0;0.0
85;2021-01-06;107;1;196;1;0.0;0.0
85;2021-01-07;203;0;399;1;0.1;0.0
85;2021-01-08;291;1;690;2;0.1;0.0
85;2021-01-09;288;2;978;4;0.1;0.0
85;2021-01-10;59;0;1037;4;0.2;0.0
85;2021-01-11;453;0;1490;4;0.2;0.0
85;2021-01-12;586;2;2076;6;0.3;0.0
85;2021-01-13;544;1;2620;7;0.4;0.0
85;2021-01-14;679;3;3299;10;0.5;0.0
85;2021-01-15;437;3;3736;13;0.5;0.0
85;2021-01-16;264;3;4000;16;0.6;0.0
85;2021-01-17;37;0;4037;16;0.6;0.0
85;2021-01-18;997;2;5034;18;0.7;0.0
85;2021-01-19;1427;16;6461;34;0.9;0.0
85;2021-01-20;1873;2;8334;36;1.2;0.0
85;2021-01-21;3220;6;11554;42;1.7;0.0
85;2021-01-22;1696;17;13250;59;1.9;0.0
85;2021-01-23;466;2;13716;61;2.0;0.0
85;2021-01-24;49;0;13765;61;2.0;0.0
85;2021-01-25;577;1;14342;62;2.1;0.0
85;2021-01-26;876;34;15218;96;2.2;0.0
85;2021-01-27;1789;32;17007;128;2.5;0.0
85;2021-01-28;1630;38;18637;166;2.7;0.0
85;2021-01-29;873;63;19510;229;2.9;0.0
85;2021-01-30;149;5;19659;234;2.9;0.0
85;2021-01-31;2;48;19661;282;2.9;0.0
85;2021-02-01;479;103;20140;385;2.9;0.1
85;2021-02-02;537;176;20677;561;3.0;0.1
85;2021-02-03;414;261;21091;822;3.1;0.1
85;2021-02-04;621;267;21712;1089;3.2;0.2
85;2021-02-05;624;265;22336;1354;3.3;0.2
85;2021-02-06;153;245;22489;1599;3.3;0.2
85;2021-02-07;1;0;22490;1599;3.3;0.2
85;2021-02-08;388;654;22878;2253;3.3;0.3
85;2021-02-09;661;1061;23539;3314;3.4;0.5
85;2021-02-10;583;1132;24122;4446;3.5;0.7
85;2021-02-11;1543;3040;25665;7486;3.8;1.1
85;2021-02-12;1012;1260;26677;8746;3.9;1.3
85;2021-02-13;250;505;26927;9251;3.9;1.4
85;2021-02-14;2;133;26929;9384;3.9;1.4
85;2021-02-15;335;814;27264;10198;4.0;1.5
85;2021-02-16;570;1190;27834;11388;4.1;1.7
85;2021-02-17;783;1575;28617;12963;4.2;1.9
85;2021-02-18;1277;1932;29894;14895;4.4;2.2
85;2021-02-19;954;1208;30848;16103;4.5;2.4
85;2021-02-20;173;263;31021;16366;4.5;2.4
85;2021-02-21;1;11;31022;16377;4.5;2.4
85;2021-02-22;813;887;31835;17264;4.7;2.5
85;2021-02-23;829;485;32664;17749;4.8;2.6
85;2021-02-24;756;313;33420;18062;4.9;2.6
85;2021-02-25;1336;397;34756;18459;5.1;2.7
85;2021-02-26;1228;329;35984;18788;5.3;2.8
85;2021-02-27;400;99;36384;18887;5.3;2.8
85;2021-02-28;7;1;36391;18888;5.3;2.8
85;2021-03-01;760;430;37151;19318;5.4;2.8
85;2021-03-02;1100;790;38251;20108;5.6;2.9
85;2021-03-03;843;514;39094;20622;5.7;3.0
85;2021-03-04;1574;1171;40668;21793;6.0;3.2
85;2021-03-05;1738;848;42406;22641;6.2;3.3
85;2021-03-06;1227;129;43633;22770;6.4;3.3
85;2021-03-07;332;35;43965;22805;6.4;3.3
85;2021-03-08;1740;458;45705;23263;6.7;3.4
85;2021-03-09;2241;572;47946;23835;7.0;3.5
85;2021-03-10;1862;649;49808;24484;7.3;3.6
85;2021-03-11;3118;1085;52926;25569;7.7;3.7
85;2021-03-12;2727;865;55653;26434;8.1;3.9
85;2021-03-13;1371;159;57024;26593;8.3;3.9
85;2021-03-14;178;0;57202;26593;8.4;3.9
85;2021-03-15;1918;514;59120;27107;8.7;4.0
85;2021-03-16;1627;517;60747;27624;8.9;4.0
85;2021-03-17;980;522;61727;28146;9.0;4.1
85;2021-03-18;1900;455;63627;28601;9.3;4.2
85;2021-03-19;2201;370;65828;28971;9.6;4.2
85;2021-03-20;1068;176;66896;29147;9.8;4.3
85;2021-03-21;271;5;67167;29152;9.8;4.3
85;2021-03-22;1760;559;68927;29711;10.1;4.3
85;2021-03-23;2416;733;71343;30444;10.4;4.5
85;2021-03-24;2207;527;73550;30971;10.8;4.5
85;2021-03-25;3647;587;77197;31558;11.3;4.6
85;2021-03-26;3357;644;80554;32202;11.8;4.7
85;2021-03-27;1725;121;82279;32323;12.0;4.7
85;2021-03-28;539;3;82818;32326;12.1;4.7
85;2021-03-29;2412;755;85230;33081;12.5;4.8
85;2021-03-30;2862;1021;88092;34102;12.9;5.0
85;2021-03-31;2197;668;90289;34770;13.2;5.1
85;2021-04-01;3870;909;94159;35679;13.8;5.2
85;2021-04-02;2704;1091;96863;36770;14.2;5.4
85;2021-04-03;1412;321;98275;37091;14.4;5.4
85;2021-04-04;323;27;98598;37118;14.4;5.4
85;2021-04-05;104;175;98702;37293;14.4;5.5
85;2021-04-06;2201;1600;100903;38893;14.8;5.7
85;2021-04-07;3092;1186;103995;40079;15.2;5.9
85;2021-04-08;4529;1597;108524;41676;15.9;6.1
85;2021-04-09;4599;1224;113123;42900;16.6;6.3
85;2021-04-10;1866;396;114989;43296;16.8;6.3
85;2021-04-11;26;10;115015;43306;16.8;6.3
85;2021-04-12;4286;1484;119301;44790;17.5;6.6
85;2021-04-13;4830;1870;124131;46660;18.2;6.8
85;2021-04-14;3957;1006;128088;47666;18.7;7.0
85;2021-04-15;5514;1735;133602;49401;19.6;7.2
85;2021-04-16;5240;1533;138842;50934;20.3;7.5
85;2021-04-17;1383;437;140225;51371;20.5;7.5
85;2021-04-18;349;10;140574;51381;20.6;7.5
85;2021-04-19;3363;1701;143937;53082;21.1;7.8
85;2021-04-20;3697;1924;147634;55006;21.6;8.1
85;2021-04-21;2690;1694;150324;56700;22.0;8.3
85;2021-04-22;3804;2230;154128;58930;22.6;8.6
85;2021-04-23;3902;2080;158030;61010;23.1;8.9
85;2021-04-24;1659;1531;159689;62541;23.4;9.2
85;2021-04-25;980;561;160669;63102;23.5;9.2
85;2021-04-26;3590;2349;164259;65451;24.0;9.6
85;2021-04-27;4392;2161;168651;67612;24.7;9.9
85;2021-04-28;5746;1251;174397;68863;25.5;10.1
85;2021-04-29;5633;2001;180030;70864;26.4;10.4
85;2021-04-30;5574;1669;185604;72533;27.2;10.6
85;2021-05-01;1735;636;187339;73169;27.4;10.7
85;2021-05-02;873;470;188212;73639;27.5;10.8
85;2021-05-03;3492;2381;191704;76020;28.1;11.1
85;2021-05-04;3488;3084;195192;79104;28.6;11.6
85;2021-05-05;4532;2164;199724;81268;29.2;11.9
85;2021-05-06;4921;2591;204645;83859;30.0;12.3
85;2021-05-07;3928;3859;208573;87718;30.5;12.8
85;2021-05-08;2245;229;210818;87947;30.9;12.9
85;2021-05-09;1509;181;212327;88128;31.1;12.9
85;2021-05-10;3208;4928;215535;93056;31.5;13.6
85;2021-05-11;4026;4974;219561;98030;32.1;14.3
85;2021-05-12;5018;3932;224579;101962;32.9;14.9
85;2021-05-13;5143;610;229722;102572;33.6;15.0
85;2021-05-14;4355;3167;234077;105739;34.3;15.5
85;2021-05-15;2324;775;236401;106514;34.6;15.6
85;2021-05-16;2213;162;238614;106676;34.9;15.6
85;2021-05-17;4147;3377;242761;110053;35.5;16.1
85;2021-05-18;5216;2857;247977;112910;36.3;16.5
85;2021-05-19;6491;1763;254468;114673;37.2;16.8
85;2021-05-20;6773;2171;261241;116844;38.2;17.1
85;2021-05-21;5498;2746;266739;119590;39.0;17.5
85;2021-05-22;2583;752;269322;120342;39.4;17.6
85;2021-05-23;1330;160;270652;120502;39.6;17.6
85;2021-05-24;4572;435;275224;120937;40.3;17.7
85;2021-05-25;4517;3563;279741;124500;40.9;18.2
85;2021-05-26;4943;2678;284684;127178;41.7;18.6
85;2021-05-27;4960;3690;289644;130868;42.4;19.2
85;2021-05-28;5252;4068;294896;134936;43.2;19.8
85;2021-05-29;3958;1527;298854;136463;43.7;20.0
85;2021-05-30;1291;126;300145;136589;43.9;20.0
85;2021-05-31;4687;3381;304832;139970;44.6;20.5
85;2021-06-01;5403;3400;310235;143370;45.4;21.0
85;2021-06-02;5557;2522;315792;145892;46.2;21.4
85;2021-06-03;5915;3234;321707;149126;47.1;21.8
85;2021-06-04;5837;3817;327544;152943;47.9;22.4
85;2021-06-05;2852;1939;330396;154882;48.4;22.7
85;2021-06-06;1511;803;331907;155685;48.6;22.8
85;2021-06-07;3234;4858;335141;160543;49.1;23.5
85;2021-06-08;4089;4521;339230;165064;49.7;24.2
85;2021-06-09;4843;3513;344073;168577;50.4;24.7
85;2021-06-10;5196;3702;349269;172279;51.1;25.2
85;2021-06-11;4504;4661;353773;176940;51.8;25.9
85;2021-06-12;1489;1797;355262;178737;52.0;26.2
85;2021-06-13;1220;672;356482;179409;52.2;26.3
85;2021-06-14;2680;5092;359162;184501;52.6;27.0
85;2021-06-15;3714;4933;362876;189434;53.1;27.7
85;2021-06-16;4082;3905;366958;193339;53.7;28.3
85;2021-06-17;3939;3896;370897;197235;54.3;28.9
85;2021-06-18;3626;5678;374523;202913;54.8;29.7
85;2021-06-19;1213;2029;375736;204942;55.0;30.0
85;2021-06-20;137;520;375873;205462;55.0;30.1
85;2021-06-21;2375;5810;378248;211272;55.4;30.9
85;2021-06-22;2845;5726;381093;216998;55.8;31.8
85;2021-06-23;3392;4494;384485;221492;56.3;32.4
85;2021-06-24;3641;4558;388126;226050;56.8;33.1
85;2021-06-25;2287;6176;390413;232226;57.1;34.0
85;2021-06-26;790;3763;391203;235989;57.3;34.5
85;2021-06-27;125;1371;391328;237360;57.3;34.7
85;2021-06-28;1183;6718;392511;244078;57.5;35.7
85;2021-06-29;1755;6873;394266;250951;57.7;36.7
85;2021-06-30;2185;6200;396451;257151;58.0;37.6
85;2021-07-01;2824;6061;399275;263212;58.4;38.5
85;2021-07-02;2258;7017;401533;270229;58.8;39.6
85;2021-07-03;616;3166;402149;273395;58.9;40.0
85;2021-07-04;144;1086;402293;274481;58.9;40.2
85;2021-07-05;1059;6654;403352;281135;59.0;41.2
85;2021-07-06;1568;6461;404920;287596;59.3;42.1
85;2021-07-07;1642;5860;406562;293456;59.5;43.0
85;2021-07-08;2157;5446;408719;298902;59.8;43.8
85;2021-07-09;1642;7106;410361;306008;60.1;44.8
85;2021-07-10;560;2840;410921;308848;60.1;45.2
85;2021-07-11;526;1289;411447;310137;60.2;45.4
85;2021-07-12;1402;7058;412849;317195;60.4;46.4
85;2021-07-13;2048;7393;414897;324588;60.7;47.5
85;2021-07-14;1454;2048;416351;326636;60.9;47.8
85;2021-07-15;2667;6949;419018;333585;61.3;48.8
85;2021-07-16;3406;6845;422424;340430;61.8;49.8
85;2021-07-17;1552;2155;423976;342585;62.1;50.1
85;2021-07-18;1142;1156;425118;343741;62.2;50.3
85;2021-07-19;3531;6240;428649;349981;62.7;51.2
85;2021-07-20;4284;6219;432933;356200;63.4;52.1
85;2021-07-21;3978;6201;436911;362401;64.0;53.0
85;2021-07-22;3883;6183;440794;368584;64.5;54.0
85;2021-07-23;4505;6705;445299;375289;65.2;54.9
85;2021-07-24;1040;2295;446339;377584;65.3;55.3
85;2021-07-25;489;304;446828;377888;65.4;55.3
85;2021-07-26;4491;5356;451319;383244;66.1;56.1
85;2021-07-27;5289;5391;456608;388635;66.8;56.9
85;2021-07-28;4948;4973;461556;393608;67.6;57.6
85;2021-07-29;5851;4738;467407;398346;68.4;58.3
85;2021-07-30;5990;4947;473397;403293;69.3;59.0
85;2021-07-31;1212;1577;474609;404870;69.5;59.3
85;2021-08-01;459;194;475068;405064;69.5;59.3
85;2021-08-02;4929;3941;479997;409005;70.3;59.9
85;2021-08-03;6502;3334;486499;412339;71.2;60.4
85;2021-08-04;6569;3397;493068;415736;72.2;60.9
85;2021-08-05;6122;3578;499190;419314;73.1;61.4
86;2020-12-27;0;0;0;0;0.0;0.0
86;2020-12-28;0;0;0;0;0.0;0.0
86;2020-12-29;1;0;1;0;0.0;0.0
86;2020-12-30;0;0;1;0;0.0;0.0
86;2020-12-31;0;0;1;0;0.0;0.0
86;2021-01-01;0;0;1;0;0.0;0.0
86;2021-01-02;0;0;1;0;0.0;0.0
86;2021-01-03;2;0;3;0;0.0;0.0
86;2021-01-04;0;0;3;0;0.0;0.0
86;2021-01-05;0;0;3;0;0.0;0.0
86;2021-01-06;178;0;181;0;0.0;0.0
86;2021-01-07;671;0;852;0;0.2;0.0
86;2021-01-08;596;3;1448;3;0.3;0.0
86;2021-01-09;0;0;1448;3;0.3;0.0
86;2021-01-10;173;0;1621;3;0.4;0.0
86;2021-01-11;305;1;1926;4;0.4;0.0
86;2021-01-12;458;0;2384;4;0.5;0.0
86;2021-01-13;336;0;2720;4;0.6;0.0
86;2021-01-14;551;1;3271;5;0.7;0.0
86;2021-01-15;537;1;3808;6;0.9;0.0
86;2021-01-16;2;0;3810;6;0.9;0.0
86;2021-01-17;0;0;3810;6;0.9;0.0
86;2021-01-18;564;0;4374;6;1.0;0.0
86;2021-01-19;1907;0;6281;6;1.4;0.0
86;2021-01-20;1457;18;7738;24;1.8;0.0
86;2021-01-21;1289;0;9027;24;2.1;0.0
86;2021-01-22;830;0;9857;24;2.3;0.0
86;2021-01-23;313;0;10170;24;2.3;0.0
86;2021-01-24;0;0;10170;24;2.3;0.0
86;2021-01-25;583;110;10753;134;2.5;0.0
86;2021-01-26;749;122;11502;256;2.6;0.1
86;2021-01-27;764;156;12266;412;2.8;0.1
86;2021-01-28;1043;427;13309;839;3.0;0.2
86;2021-01-29;877;219;14186;1058;3.2;0.2
86;2021-01-30;275;104;14461;1162;3.3;0.3
86;2021-01-31;57;157;14518;1319;3.3;0.3
86;2021-02-01;432;207;14950;1526;3.4;0.3
86;2021-02-02;574;386;15524;1912;3.5;0.4
86;2021-02-03;525;224;16049;2136;3.7;0.5
86;2021-02-04;477;365;16526;2501;3.8;0.6
86;2021-02-05;439;743;16965;3244;3.9;0.7
86;2021-02-06;146;206;17111;3450;3.9;0.8
86;2021-02-07;120;7;17231;3457;3.9;0.8
86;2021-02-08;361;328;17592;3785;4.0;0.9
86;2021-02-09;749;1123;18341;4908;4.2;1.1
86;2021-02-10;975;939;19316;5847;4.4;1.3
86;2021-02-11;1005;977;20321;6824;4.6;1.6
86;2021-02-12;746;378;21067;7202;4.8;1.6
86;2021-02-13;191;95;21258;7297;4.9;1.7
86;2021-02-14;1;34;21259;7331;4.9;1.7
86;2021-02-15;244;508;21503;7839;4.9;1.8
86;2021-02-16;385;865;21888;8704;5.0;2.0
86;2021-02-17;448;896;22336;9600;5.1;2.2
86;2021-02-18;420;875;22756;10475;5.2;2.4
86;2021-02-19;600;642;23356;11117;5.3;2.5
86;2021-02-20;115;176;23471;11293;5.4;2.6
86;2021-02-21;0;0;23471;11293;5.4;2.6
86;2021-02-22;240;429;23711;11722;5.4;2.7
86;2021-02-23;369;607;24080;12329;5.5;2.8
86;2021-02-24;408;586;24488;12915;5.6;3.0
86;2021-02-25;901;667;25389;13582;5.8;3.1
86;2021-02-26;1028;540;26417;14122;6.0;3.2
86;2021-02-27;460;149;26877;14271;6.1;3.3
86;2021-02-28;3;2;26880;14273;6.1;3.3
86;2021-03-01;232;526;27112;14799;6.2;3.4
86;2021-03-02;1141;850;28253;15649;6.5;3.6
86;2021-03-03;792;624;29045;16273;6.6;3.7
86;2021-03-04;1495;618;30540;16891;7.0;3.9
86;2021-03-05;1577;314;32117;17205;7.3;3.9
86;2021-03-06;994;168;33111;17373;7.6;4.0
86;2021-03-07;370;29;33481;17402;7.7;4.0
86;2021-03-08;472;540;33953;17942;7.8;4.1
86;2021-03-09;1368;528;35321;18470;8.1;4.2
86;2021-03-10;948;610;36269;19080;8.3;4.4
86;2021-03-11;1795;475;38064;19555;8.7;4.5
86;2021-03-12;2204;435;40268;19990;9.2;4.6
86;2021-03-13;1445;99;41713;20089;9.5;4.6
86;2021-03-14;133;15;41846;20104;9.6;4.6
86;2021-03-15;784;159;42630;20263;9.7;4.6
86;2021-03-16;847;203;43477;20466;9.9;4.7
86;2021-03-17;786;203;44263;20669;10.1;4.7
86;2021-03-18;1004;99;45267;20768;10.3;4.7
86;2021-03-19;2141;323;47408;21091;10.8;4.8
86;2021-03-20;592;131;48000;21222;11.0;4.9
86;2021-03-21;10;0;48010;21222;11.0;4.9
86;2021-03-22;851;276;48861;21498;11.2;4.9
86;2021-03-23;2013;327;50874;21825;11.6;5.0
86;2021-03-24;1554;287;52428;22112;12.0;5.1
86;2021-03-25;2482;351;54910;22463;12.6;5.1
86;2021-03-26;3037;355;57947;22818;13.2;5.2
86;2021-03-27;731;143;58678;22961;13.4;5.2
86;2021-03-28;5;128;58683;23089;13.4;5.3
86;2021-03-29;1258;392;59941;23481;13.7;5.4
86;2021-03-30;2400;818;62341;24299;14.3;5.6
86;2021-03-31;1510;622;63851;24921;14.6;5.7
86;2021-04-01;2238;937;66089;25858;15.1;5.9
86;2021-04-02;1899;554;67988;26412;15.5;6.0
86;2021-04-03;827;323;68815;26735;15.7;6.1
86;2021-04-04;82;108;68897;26843;15.8;6.1
86;2021-04-05;314;4;69211;26847;15.8;6.1
86;2021-04-06;1530;960;70741;27807;16.2;6.4
86;2021-04-07;1632;626;72373;28433;16.5;6.5
86;2021-04-08;2567;762;74940;29195;17.1;6.7
86;2021-04-09;3251;647;78191;29842;17.9;6.8
86;2021-04-10;1663;191;79854;30033;18.3;6.9
86;2021-04-11;442;9;80296;30042;18.4;6.9
86;2021-04-12;821;764;81117;30806;18.5;7.0
86;2021-04-13;2448;941;83565;31747;19.1;7.3
86;2021-04-14;1871;873;85436;32620;19.5;7.5
86;2021-04-15;2273;725;87709;33345;20.1;7.6
86;2021-04-16;2467;1224;90176;34569;20.6;7.9
86;2021-04-17;1040;261;91216;34830;20.9;8.0
86;2021-04-18;118;3;91334;34833;20.9;8.0
86;2021-04-19;745;794;92079;35627;21.1;8.1
86;2021-04-20;2300;1501;94379;37128;21.6;8.5
86;2021-04-21;2109;1118;96488;38246;22.1;8.7
86;2021-04-22;2331;1442;98819;39688;22.6;9.1
86;2021-04-23;2393;1573;101212;41261;23.1;9.4
86;2021-04-24;1299;507;102511;41768;23.4;9.5
86;2021-04-25;825;26;103336;41794;23.6;9.6
86;2021-04-26;2079;889;105415;42683;24.1;9.8
86;2021-04-27;3152;1664;108567;44347;24.8;10.1
86;2021-04-28;3003;1521;111570;45868;25.5;10.5
86;2021-04-29;3555;1826;115125;47694;26.3;10.9
86;2021-04-30;2969;1478;118094;49172;27.0;11.2
86;2021-05-01;1579;197;119673;49369;27.4;11.3
86;2021-05-02;1280;43;120953;49412;27.7;11.3
86;2021-05-03;2562;999;123515;50411;28.2;11.5
86;2021-05-04;3510;1894;127025;52305;29.0;12.0
86;2021-05-05;3990;1476;131015;53781;30.0;12.3
86;2021-05-06;4289;1653;135304;55434;30.9;12.7
86;2021-05-07;4045;1821;139349;57255;31.9;13.1
86;2021-05-08;1976;397;141325;57652;32.3;13.2
86;2021-05-09;1642;203;142967;57855;32.7;13.2
86;2021-05-10;1955;1173;144922;59028;33.1;13.5
86;2021-05-11;3605;2685;148527;61713;34.0;14.1
86;2021-05-12;2247;1646;150774;63359;34.5;14.5
86;2021-05-13;1686;296;152460;63655;34.9;14.6
86;2021-05-14;2099;791;154559;64446;35.3;14.7
86;2021-05-15;1467;503;156026;64949;35.7;14.8
86;2021-05-16;778;164;156804;65113;35.8;14.9
86;2021-05-17;3221;1062;160025;66175;36.6;15.1
86;2021-05-18;4304;1664;164329;67839;37.6;15.5
86;2021-05-19;3590;1433;167919;69272;38.4;15.8
86;2021-05-20;4374;1624;172293;70896;39.4;16.2
86;2021-05-21;3440;1772;175733;72668;40.2;16.6
86;2021-05-22;2077;662;177810;73330;40.7;16.8
86;2021-05-23;1439;183;179249;73513;41.0;16.8
86;2021-05-24;1848;200;181097;73713;41.4;16.9
86;2021-05-25;2849;1642;183946;75355;42.1;17.2
86;2021-05-26;2727;1524;186673;76879;42.7;17.6
86;2021-05-27;3544;1843;190217;78722;43.5;18.0
86;2021-05-28;2161;2539;192378;81261;44.0;18.6
86;2021-05-29;1527;1286;193905;82547;44.3;18.9
86;2021-05-30;935;130;194840;82677;44.5;18.9
86;2021-05-31;1921;1820;196761;84497;45.0;19.3
86;2021-06-01;2665;2593;199426;87090;45.6;19.9
86;2021-06-02;2301;2665;201727;89755;46.1;20.5
86;2021-06-03;3331;2411;205058;92166;46.9;21.1
86;2021-06-04;2238;2863;207296;95029;47.4;21.7
86;2021-06-05;1504;1578;208800;96607;47.7;22.1
86;2021-06-06;819;899;209619;97506;47.9;22.3
86;2021-06-07;1117;2464;210736;99970;48.2;22.9
86;2021-06-08;1989;3694;212725;103664;48.6;23.7
86;2021-06-09;1901;3318;214626;106982;49.1;24.5
86;2021-06-10;2350;3234;216976;110216;49.6;25.2
86;2021-06-11;1517;2789;218493;113005;50.0;25.8
86;2021-06-12;746;2249;219239;115254;50.1;26.3
86;2021-06-13;214;1477;219453;116731;50.2;26.7
86;2021-06-14;1159;2904;220612;119635;50.4;27.4
86;2021-06-15;1689;4261;222301;123896;50.8;28.3
86;2021-06-16;1808;3131;224109;127027;51.2;29.0
86;2021-06-17;1775;4446;225884;131473;51.6;30.1
86;2021-06-18;1883;4587;227767;136060;52.1;31.1
86;2021-06-19;635;2098;228402;138158;52.2;31.6
86;2021-06-20;173;1319;228575;139477;52.3;31.9
86;2021-06-21;1101;2237;229676;141714;52.5;32.4
86;2021-06-22;1296;3457;230972;145171;52.8;33.2
86;2021-06-23;1362;2400;232334;147571;53.1;33.7
86;2021-06-24;1588;2721;233922;150292;53.5;34.4
86;2021-06-25;1192;3552;235114;153844;53.8;35.2
86;2021-06-26;390;2653;235504;156497;53.8;35.8
86;2021-06-27;136;1635;235640;158132;53.9;36.2
86;2021-06-28;268;3339;235908;161471;53.9;36.9
86;2021-06-29;859;4604;236767;166075;54.1;38.0
86;2021-06-30;1045;2974;237812;169049;54.4;38.6
86;2021-07-01;1537;3004;239349;172053;54.7;39.3
86;2021-07-02;1107;3651;240456;175704;55.0;40.2
86;2021-07-03;516;2396;240972;178100;55.1;40.7
86;2021-07-04;116;1347;241088;179447;55.1;41.0
86;2021-07-05;467;2833;241555;182280;55.2;41.7
86;2021-07-06;986;4103;242541;186383;55.5;42.6
86;2021-07-07;1254;2629;243795;189012;55.7;43.2
86;2021-07-08;1614;3151;245409;192163;56.1;43.9
86;2021-07-09;1738;3083;247147;195246;56.5;44.6
86;2021-07-10;1294;1955;248441;197201;56.8;45.1
86;2021-07-11;481;840;248922;198041;56.9;45.3
86;2021-07-12;828;2404;249750;200445;57.1;45.8
86;2021-07-13;1774;3373;251524;203818;57.5;46.6
86;2021-07-14;766;1232;252290;205050;57.7;46.9
86;2021-07-15;1879;3295;254169;208345;58.1;47.6
86;2021-07-16;1662;2666;255831;211011;58.5;48.2
86;2021-07-17;1343;1602;257174;212613;58.8;48.6
86;2021-07-18;376;906;257550;213519;58.9;48.8
86;2021-07-19;1365;1887;258915;215406;59.2;49.2
86;2021-07-20;2333;2730;261248;218136;59.7;49.9
86;2021-07-21;2292;2155;263540;220291;60.3;50.4
86;2021-07-22;2889;2789;266429;223080;60.9;51.0
86;2021-07-23;2454;2160;268883;225240;61.5;51.5
86;2021-07-24;1538;1222;270421;226462;61.8;51.8
86;2021-07-25;713;321;271134;226783;62.0;51.8
86;2021-07-26;1584;2102;272718;228885;62.4;52.3
86;2021-07-27;3536;2751;276254;231636;63.2;53.0
86;2021-07-28;3257;2122;279511;233758;63.9;53.4
86;2021-07-29;3249;2539;282760;236297;64.6;54.0
86;2021-07-30;2230;2373;284990;238670;65.2;54.6
86;2021-07-31;1420;1051;286410;239721;65.5;54.8
86;2021-08-01;646;334;287056;240055;65.6;54.9
86;2021-08-02;1923;1674;288979;241729;66.1;55.3
86;2021-08-03;3266;1980;292245;243709;66.8;55.7
86;2021-08-04;2726;1776;294971;245485;67.4;56.1
86;2021-08-05;3535;2030;298506;247515;68.2;56.6
87;2020-12-27;0;0;0;0;0.0;0.0
87;2020-12-28;1;0;1;0;0.0;0.0
87;2020-12-29;0;0;1;0;0.0;0.0
87;2020-12-30;0;0;1;0;0.0;0.0
87;2020-12-31;0;0;1;0;0.0;0.0
87;2021-01-01;0;0;1;0;0.0;0.0
87;2021-01-02;0;0;1;0;0.0;0.0
87;2021-01-03;0;0;1;0;0.0;0.0
87;2021-01-04;1;0;2;0;0.0;0.0
87;2021-01-05;1;0;3;0;0.0;0.0
87;2021-01-06;10;0;13;0;0.0;0.0
87;2021-01-07;301;0;314;0;0.1;0.0
87;2021-01-08;407;0;721;0;0.2;0.0
87;2021-01-09;64;0;785;0;0.2;0.0
87;2021-01-10;35;0;820;0;0.2;0.0
87;2021-01-11;424;0;1244;0;0.3;0.0
87;2021-01-12;651;0;1895;0;0.5;0.0
87;2021-01-13;658;1;2553;1;0.7;0.0
87;2021-01-14;515;12;3068;13;0.8;0.0
87;2021-01-15;532;3;3600;16;1.0;0.0
87;2021-01-16;203;1;3803;17;1.0;0.0
87;2021-01-17;1;0;3804;17;1.0;0.0
87;2021-01-18;645;4;4449;21;1.2;0.0
87;2021-01-19;655;1;5104;22;1.4;0.0
87;2021-01-20;674;3;5778;25;1.6;0.0
87;2021-01-21;716;1;6494;26;1.8;0.0
87;2021-01-22;758;4;7252;30;2.0;0.0
87;2021-01-23;285;0;7537;30;2.0;0.0
87;2021-01-24;0;0;7537;30;2.0;0.0
87;2021-01-25;620;10;8157;40;2.2;0.0
87;2021-01-26;570;53;8727;93;2.4;0.0
87;2021-01-27;572;40;9299;133;2.5;0.0
87;2021-01-28;856;109;10155;242;2.7;0.1
87;2021-01-29;740;272;10895;514;2.9;0.1
87;2021-01-30;327;75;11222;589;3.0;0.2
87;2021-01-31;34;71;11256;660;3.0;0.2
87;2021-02-01;413;310;11669;970;3.1;0.3
87;2021-02-02;452;482;12121;1452;3.3;0.4
87;2021-02-03;542;419;12663;1871;3.4;0.5
87;2021-02-04;613;593;13276;2464;3.6;0.7
87;2021-02-05;342;384;13618;2848;3.7;0.8
87;2021-02-06;51;154;13669;3002;3.7;0.8
87;2021-02-07;20;0;13689;3002;3.7;0.8
87;2021-02-08;245;445;13934;3447;3.8;0.9
87;2021-02-09;218;546;14152;3993;3.8;1.1
87;2021-02-10;261;626;14413;4619;3.9;1.2
87;2021-02-11;286;539;14699;5158;4.0;1.4
87;2021-02-12;284;540;14983;5698;4.0;1.5
87;2021-02-13;25;169;15008;5867;4.0;1.6
87;2021-02-14;0;3;15008;5870;4.0;1.6
87;2021-02-15;237;391;15245;6261;4.1;1.7
87;2021-02-16;329;332;15574;6593;4.2;1.8
87;2021-02-17;330;380;15904;6973;4.3;1.9
87;2021-02-18;475;646;16379;7619;4.4;2.1
87;2021-02-19;402;481;16781;8100;4.5;2.2
87;2021-02-20;122;197;16903;8297;4.6;2.2
87;2021-02-21;2;9;16905;8306;4.6;2.2
87;2021-02-22;438;577;17343;8883;4.7;2.4
87;2021-02-23;556;633;17899;9516;4.8;2.6
87;2021-02-24;450;586;18349;10102;4.9;2.7
87;2021-02-25;789;707;19138;10809;5.2;2.9
87;2021-02-26;840;476;19978;11285;5.4;3.0
87;2021-02-27;405;212;20383;11497;5.5;3.1
87;2021-02-28;3;0;20386;11497;5.5;3.1
87;2021-03-01;514;371;20900;11868;5.6;3.2
87;2021-03-02;1030;386;21930;12254;5.9;3.3
87;2021-03-03;1174;342;23104;12596;6.2;3.4
87;2021-03-04;1406;334;24510;12930;6.6;3.5
87;2021-03-05;1769;285;26279;13215;7.1;3.6
87;2021-03-06;1041;38;27320;13253;7.4;3.6
87;2021-03-07;257;5;27577;13258;7.4;3.6
87;2021-03-08;863;242;28440;13500;7.7;3.6
87;2021-03-09;1288;231;29728;13731;8.0;3.7
87;2021-03-10;1297;230;31025;13961;8.4;3.8
87;2021-03-11;1753;253;32778;14214;8.8;3.8
87;2021-03-12;2124;285;34902;14499;9.4;3.9
87;2021-03-13;1308;20;36210;14519;9.8;3.9
87;2021-03-14;80;1;36290;14520;9.8;3.9
87;2021-03-15;988;357;37278;14877;10.1;4.0
87;2021-03-16;1061;241;38339;15118;10.3;4.1
87;2021-03-17;1070;220;39409;15338;10.6;4.1
87;2021-03-18;1179;336;40588;15674;10.9;4.2
87;2021-03-19;1682;274;42270;15948;11.4;4.3
87;2021-03-20;922;85;43192;16033;11.6;4.3
87;2021-03-21;32;0;43224;16033;11.7;4.3
87;2021-03-22;1041;379;44265;16412;11.9;4.4
87;2021-03-23;1385;425;45650;16837;12.3;4.5
87;2021-03-24;1508;365;47158;17202;12.7;4.6
87;2021-03-25;2496;391;49654;17593;13.4;4.7
87;2021-03-26;2530;453;52184;18046;14.1;4.9
87;2021-03-27;889;125;53073;18171;14.3;4.9
87;2021-03-28;269;16;53342;18187;14.4;4.9
87;2021-03-29;1117;416;54459;18603;14.7;5.0
87;2021-03-30;1907;660;56366;19263;15.2;5.2
87;2021-03-31;1658;692;58024;19955;15.6;5.4
87;2021-04-01;2232;571;60256;20526;16.3;5.5
87;2021-04-02;1841;627;62097;21153;16.7;5.7
87;2021-04-03;455;265;62552;21418;16.9;5.8
87;2021-04-04;2;0;62554;21418;16.9;5.8
87;2021-04-05;82;1;62636;21419;16.9;5.8
87;2021-04-06;994;901;63630;22320;17.2;6.0
87;2021-04-07;1484;923;65114;23243;17.6;6.3
87;2021-04-08;1781;1031;66895;24274;18.0;6.5
87;2021-04-09;2643;735;69538;25009;18.8;6.7
87;2021-04-10;1189;306;70727;25315;19.1;6.8
87;2021-04-11;67;0;70794;25315;19.1;6.8
87;2021-04-12;1621;824;72415;26139;19.5;7.0
87;2021-04-13;2287;1058;74702;27197;20.1;7.3
87;2021-04-14;2525;1182;77227;28379;20.8;7.7
87;2021-04-15;2222;1071;79449;29450;21.4;7.9
87;2021-04-16;2734;1069;82183;30519;22.2;8.2
87;2021-04-17;731;386;82914;30905;22.4;8.3
87;2021-04-18;112;141;83026;31046;22.4;8.4
87;2021-04-19;1657;829;84683;31875;22.8;8.6
87;2021-04-20;2084;879;86767;32754;23.4;8.8
87;2021-04-21;2292;989;89059;33743;24.0;9.1
87;2021-04-22;2565;1155;91624;34898;24.7;9.4
87;2021-04-23;1994;1179;93618;36077;25.2;9.7
87;2021-04-24;824;617;94442;36694;25.5;9.9
87;2021-04-25;64;103;94506;36797;25.5;9.9
87;2021-04-26;1356;916;95862;37713;25.9;10.2
87;2021-04-27;2397;1205;98259;38918;26.5;10.5
87;2021-04-28;3867;1439;102126;40357;27.5;10.9
87;2021-04-29;3075;1839;105201;42196;28.4;11.4
87;2021-04-30;3171;1356;108372;43552;29.2;11.7
87;2021-05-01;613;57;108985;43609;29.4;11.8
87;2021-05-02;361;5;109346;43614;29.5;11.8
87;2021-05-03;2321;934;111667;44548;30.1;12.0
87;2021-05-04;2905;1069;114572;45617;30.9;12.3
87;2021-05-05;2988;1511;117560;47128;31.7;12.7
87;2021-05-06;2531;1722;120091;48850;32.4;13.2
87;2021-05-07;2946;1713;123037;50563;33.2;13.6
87;2021-05-08;771;293;123808;50856;33.4;13.7
87;2021-05-09;19;133;123827;50989;33.4;13.8
87;2021-05-10;1938;1602;125765;52591;33.9;14.2
87;2021-05-11;2466;1906;128231;54497;34.6;14.7
87;2021-05-12;2620;2063;130851;56560;35.3;15.3
87;2021-05-13;1085;292;131936;56852;35.6;15.3
87;2021-05-14;2245;1769;134181;58621;36.2;15.8
87;2021-05-15;950;406;135131;59027;36.4;15.9
87;2021-05-16;141;73;135272;59100;36.5;15.9
87;2021-05-17;1627;1760;136899;60860;36.9;16.4
87;2021-05-18;2634;1813;139533;62673;37.6;16.9
87;2021-05-19;2818;1548;142351;64221;38.4;17.3
87;2021-05-20;3304;1718;145655;65939;39.3;17.8
87;2021-05-21;2764;1835;148419;67774;40.0;18.3
87;2021-05-22;1457;627;149876;68401;40.4;18.4
87;2021-05-23;210;92;150086;68493;40.5;18.5
87;2021-05-24;1056;141;151142;68634;40.8;18.5
87;2021-05-25;2116;1812;153258;70446;41.3;19.0
87;2021-05-26;3220;2473;156478;72919;42.2;19.7
87;2021-05-27;3020;2353;159498;75272;43.0;20.3
87;2021-05-28;2670;2518;162168;77790;43.7;21.0
87;2021-05-29;1060;1315;163228;79105;44.0;21.3
87;2021-05-30;258;59;163486;79164;44.1;21.4
87;2021-05-31;2289;1359;165775;80523;44.7;21.7
87;2021-06-01;2549;1866;168324;82389;45.4;22.2
87;2021-06-02;2519;1855;170843;84244;46.1;22.7
87;2021-06-03;3207;2528;174050;86772;46.9;23.4
87;2021-06-04;2837;2055;176887;88827;47.7;24.0
87;2021-06-05;1311;574;178198;89401;48.1;24.1
87;2021-06-06;263;95;178461;89496;48.1;24.1
87;2021-06-07;2100;1902;180561;91398;48.7;24.7
87;2021-06-08;2933;2570;183494;93968;49.5;25.3
87;2021-06-09;2304;2812;185798;96780;50.1;26.1
87;2021-06-10;2975;2552;188773;99332;50.9;26.8
87;2021-06-11;2366;3072;191139;102404;51.6;27.6
87;2021-06-12;1221;1103;192360;103507;51.9;27.9
87;2021-06-13;292;484;192652;103991;52.0;28.0
87;2021-06-14;980;2731;193632;106722;52.2;28.8
87;2021-06-15;1361;3321;194993;110043;52.6;29.7
87;2021-06-16;1650;3422;196643;113465;53.0;30.6
87;2021-06-17;2437;2314;199080;115779;53.7;31.2
87;2021-06-18;1787;3016;200867;118795;54.2;32.0
87;2021-06-19;1046;1177;201913;119972;54.5;32.4
87;2021-06-20;205;205;202118;120177;54.5;32.4
87;2021-06-21;1041;2643;203159;122820;54.8;33.1
87;2021-06-22;1030;2884;204189;125704;55.1;33.9
87;2021-06-23;1256;3080;205445;128784;55.4;34.7
87;2021-06-24;1620;2555;207065;131339;55.8;35.4
87;2021-06-25;1445;2712;208510;134051;56.2;36.2
87;2021-06-26;529;1202;209039;135253;56.4;36.5
87;2021-06-27;26;212;209065;135465;56.4;36.5
87;2021-06-28;716;2574;209781;138039;56.6;37.2
87;2021-06-29;1154;3412;210935;141451;56.9;38.2
87;2021-06-30;1119;2651;212054;144102;57.2;38.9
87;2021-07-01;1477;2549;213531;146651;57.6;39.6
87;2021-07-02;1198;3462;214729;150113;57.9;40.5
87;2021-07-03;413;1509;215142;151622;58.0;40.9
87;2021-07-04;23;383;215165;152005;58.0;41.0
87;2021-07-05;685;2395;215850;154400;58.2;41.6
87;2021-07-06;581;3225;216431;157625;58.4;42.5
87;2021-07-07;862;3349;217293;160974;58.6;43.4
87;2021-07-08;1117;3665;218410;164639;58.9;44.4
87;2021-07-09;1104;3702;219514;168341;59.2;45.4
87;2021-07-10;285;1357;219799;169698;59.3;45.8
87;2021-07-11;49;284;219848;169982;59.3;45.8
87;2021-07-12;547;3192;220395;173174;59.4;46.7
87;2021-07-13;825;3518;221220;176692;59.7;47.7
87;2021-07-14;514;540;221734;177232;59.8;47.8
87;2021-07-15;1350;3462;223084;180694;60.2;48.7
87;2021-07-16;1721;3597;224805;184291;60.6;49.7
87;2021-07-17;648;1370;225453;185661;60.8;50.1
87;2021-07-18;81;283;225534;185944;60.8;50.2
87;2021-07-19;1423;3402;226957;189346;61.2;51.1
87;2021-07-20;1797;3592;228754;192938;61.7;52.0
87;2021-07-21;1443;3145;230197;196083;62.1;52.9
87;2021-07-22;1871;3249;232068;199332;62.6;53.8
87;2021-07-23;1863;3168;233931;202500;63.1;54.6
87;2021-07-24;808;1282;234739;203782;63.3;55.0
87;2021-07-25;105;241;234844;204023;63.3;55.0
87;2021-07-26;1533;2319;236377;206342;63.8;55.7
87;2021-07-27;2524;2057;238901;208399;64.4;56.2
87;2021-07-28;2388;1996;241289;210395;65.1;56.7
87;2021-07-29;2988;1984;244277;212379;65.9;57.3
87;2021-07-30;2529;2065;246806;214444;66.6;57.8
87;2021-07-31;1104;834;247910;215278;66.9;58.1
87;2021-08-01;282;149;248192;215427;66.9;58.1
87;2021-08-02;2105;1506;250297;216933;67.5;58.5
87;2021-08-03;2480;1323;252777;218256;68.2;58.9
87;2021-08-04;2303;1059;255080;219315;68.8;59.2
87;2021-08-05;2495;1394;257575;220709;69.5;59.5
88;2020-12-27;0;0;0;0;0.0;0.0
88;2020-12-28;0;0;0;0;0.0;0.0
88;2020-12-29;0;0;0;0;0.0;0.0
88;2020-12-30;0;0;0;0;0.0;0.0
88;2020-12-31;0;0;0;0;0.0;0.0
88;2021-01-01;2;0;2;0;0.0;0.0
88;2021-01-02;0;0;2;0;0.0;0.0
88;2021-01-03;0;0;2;0;0.0;0.0
88;2021-01-04;0;0;2;0;0.0;0.0
88;2021-01-05;1;0;3;0;0.0;0.0
88;2021-01-06;3;0;6;0;0.0;0.0
88;2021-01-07;70;1;76;1;0.0;0.0
88;2021-01-08;189;2;265;3;0.1;0.0
88;2021-01-09;190;0;455;3;0.1;0.0
88;2021-01-10;0;0;455;3;0.1;0.0
88;2021-01-11;226;0;681;3;0.2;0.0
88;2021-01-12;422;1;1103;4;0.3;0.0
88;2021-01-13;491;2;1594;6;0.4;0.0
88;2021-01-14;345;2;1939;8;0.5;0.0
88;2021-01-15;379;2;2318;10;0.6;0.0
88;2021-01-16;62;0;2380;10;0.7;0.0
88;2021-01-17;0;0;2380;10;0.7;0.0
88;2021-01-18;460;0;2840;10;0.8;0.0
88;2021-01-19;451;0;3291;10;0.9;0.0
88;2021-01-20;461;1;3752;11;1.0;0.0
88;2021-01-21;1543;1;5295;12;1.5;0.0
88;2021-01-22;1160;1;6455;13;1.8;0.0
88;2021-01-23;284;0;6739;13;1.9;0.0
88;2021-01-24;298;2;7037;15;2.0;0.0
88;2021-01-25;938;3;7975;18;2.2;0.0
88;2021-01-26;388;6;8363;24;2.3;0.0
88;2021-01-27;3;0;8366;24;2.3;0.0
88;2021-01-28;162;37;8528;61;2.4;0.0
88;2021-01-29;526;163;9054;224;2.5;0.1
88;2021-01-30;288;127;9342;351;2.6;0.1
88;2021-01-31;0;0;9342;351;2.6;0.1
88;2021-02-01;406;283;9748;634;2.7;0.2
88;2021-02-02;333;364;10081;998;2.8;0.3
88;2021-02-03;437;241;10518;1239;2.9;0.3
88;2021-02-04;316;230;10834;1469;3.0;0.4
88;2021-02-05;457;251;11291;1720;3.1;0.5
88;2021-02-06;108;56;11399;1776;3.2;0.5
88;2021-02-07;0;0;11399;1776;3.2;0.5
88;2021-02-08;359;206;11758;1982;3.3;0.6
88;2021-02-09;291;288;12049;2270;3.4;0.6
88;2021-02-10;414;347;12463;2617;3.5;0.7
88;2021-02-11;849;1093;13312;3710;3.7;1.0
88;2021-02-12;939;703;14251;4413;4.0;1.2
88;2021-02-13;162;212;14413;4625;4.0;1.3
88;2021-02-14;81;216;14494;4841;4.0;1.3
88;2021-02-15;641;1077;15135;5918;4.2;1.6
88;2021-02-16;472;726;15607;6644;4.3;1.8
88;2021-02-17;456;439;16063;7083;4.5;2.0
88;2021-02-18;516;385;16579;7468;4.6;2.1
88;2021-02-19;535;461;17114;7929;4.8;2.2
88;2021-02-20;156;101;17270;8030;4.8;2.2
88;2021-02-21;1;25;17271;8055;4.8;2.2
88;2021-02-22;425;344;17696;8399;4.9;2.3
88;2021-02-23;402;233;18098;8632;5.0;2.4
88;2021-02-24;506;210;18604;8842;5.2;2.5
88;2021-02-25;675;283;19279;9125;5.4;2.5
88;2021-02-26;860;276;20139;9401;5.6;2.6
88;2021-02-27;265;34;20404;9435;5.7;2.6
88;2021-02-28;30;1;20434;9436;5.7;2.6
88;2021-03-01;359;467;20793;9903;5.8;2.8
88;2021-03-02;432;499;21225;10402;5.9;2.9
88;2021-03-03;648;464;21873;10866;6.1;3.0
88;2021-03-04;1039;753;22912;11619;6.4;3.2
88;2021-03-05;935;694;23847;12313;6.6;3.4
88;2021-03-06;1871;115;25718;12428;7.2;3.5
88;2021-03-07;1058;77;26776;12505;7.4;3.5
88;2021-03-08;726;689;27502;13194;7.6;3.7
88;2021-03-09;1094;532;28596;13726;8.0;3.8
88;2021-03-10;1078;495;29674;14221;8.3;4.0
88;2021-03-11;1436;399;31110;14620;8.7;4.1
88;2021-03-12;1309;485;32419;15105;9.0;4.2
88;2021-03-13;1210;123;33629;15228;9.4;4.2
88;2021-03-14;166;5;33795;15233;9.4;4.2
88;2021-03-15;930;447;34725;15680;9.7;4.4
88;2021-03-16;1024;343;35749;16023;9.9;4.5
88;2021-03-17;901;423;36650;16446;10.2;4.6
88;2021-03-18;1301;395;37951;16841;10.6;4.7
88;2021-03-19;1463;498;39414;17339;11.0;4.8
88;2021-03-20;1316;47;40730;17386;11.3;4.8
88;2021-03-21;37;0;40767;17386;11.3;4.8
88;2021-03-22;1231;541;41998;17927;11.7;5.0
88;2021-03-23;1781;438;43779;18365;12.2;5.1
88;2021-03-24;1873;472;45652;18837;12.7;5.2
88;2021-03-25;2497;484;48149;19321;13.4;5.4
88;2021-03-26;2476;453;50625;19774;14.1;5.5
88;2021-03-27;879;292;51504;20066;14.3;5.6
88;2021-03-28;60;4;51564;20070;14.3;5.6
88;2021-03-29;1305;440;52869;20510;14.7;5.7
88;2021-03-30;2061;391;54930;20901;15.3;5.8
88;2021-03-31;1616;574;56546;21475;15.7;6.0
88;2021-04-01;2116;709;58662;22184;16.3;6.2
88;2021-04-02;2813;633;61475;22817;17.1;6.3
88;2021-04-03;742;207;62217;23024;17.3;6.4
88;2021-04-04;16;1;62233;23025;17.3;6.4
88;2021-04-05;23;2;62256;23027;17.3;6.4
88;2021-04-06;1135;676;63391;23703;17.6;6.6
88;2021-04-07;1600;711;64991;24414;18.1;6.8
88;2021-04-08;1859;782;66850;25196;18.6;7.0
88;2021-04-09;3080;734;69930;25930;19.5;7.2
88;2021-04-10;724;646;70654;26576;19.7;7.4
88;2021-04-11;33;1;70687;26577;19.7;7.4
88;2021-04-12;1538;981;72225;27558;20.1;7.7
88;2021-04-13;2037;1089;74262;28647;20.7;8.0
88;2021-04-14;1908;950;76170;29597;21.2;8.2
88;2021-04-15;1967;1240;78137;30837;21.7;8.6
88;2021-04-16;2108;1049;80245;31886;22.3;8.9
88;2021-04-17;1429;766;81674;32652;22.7;9.1
88;2021-04-18;268;22;81942;32674;22.8;9.1
88;2021-04-19;1175;1236;83117;33910;23.1;9.4
88;2021-04-20;1191;1396;84308;35306;23.5;9.8
88;2021-04-21;1503;1299;85811;36605;23.9;10.2
88;2021-04-22;1898;1626;87709;38231;24.4;10.6
88;2021-04-23;1823;2039;89532;40270;24.9;11.2
88;2021-04-24;1184;780;90716;41050;25.2;11.4
88;2021-04-25;33;2;90749;41052;25.2;11.4
88;2021-04-26;1180;1169;91929;42221;25.6;11.7
88;2021-04-27;1278;1733;93207;43954;25.9;12.2
88;2021-04-28;1633;1493;94840;45447;26.4;12.6
88;2021-04-29;2082;1460;96922;46907;27.0;13.0
88;2021-04-30;2449;1621;99371;48528;27.6;13.5
88;2021-05-01;2004;266;101375;48794;28.2;13.6
88;2021-05-02;1300;121;102675;48915;28.6;13.6
88;2021-05-03;1559;1219;104234;50134;29.0;13.9
88;2021-05-04;1444;1462;105678;51596;29.4;14.4
88;2021-05-05;2426;1596;108104;53192;30.1;14.8
88;2021-05-06;3208;1211;111312;54403;31.0;15.1
88;2021-05-07;2938;1355;114250;55758;31.8;15.5
88;2021-05-08;1531;466;115781;56224;32.2;15.6
88;2021-05-09;1733;151;117514;56375;32.7;15.7
88;2021-05-10;1764;1572;119278;57947;33.2;16.1
88;2021-05-11;2658;1909;121936;59856;33.9;16.6
88;2021-05-12;2531;1852;124467;61708;34.6;17.2
88;2021-05-13;3258;672;127725;62380;35.5;17.4
88;2021-05-14;2499;1534;130224;63914;36.2;17.8
88;2021-05-15;1625;734;131849;64648;36.7;18.0
88;2021-05-16;1333;102;133182;64750;37.0;18.0
88;2021-05-17;1987;940;135169;65690;37.6;18.3
88;2021-05-18;2255;1109;137424;66799;38.2;18.6
88;2021-05-19;2724;1146;140148;67945;39.0;18.9
88;2021-05-20;3345;1232;143493;69177;39.9;19.2
88;2021-05-21;2872;1143;146365;70320;40.7;19.6
88;2021-05-22;1432;710;147797;71030;41.1;19.8
88;2021-05-23;557;74;148354;71104;41.3;19.8
88;2021-05-24;1675;428;150029;71532;41.7;19.9
88;2021-05-25;1646;1171;151675;72703;42.2;20.2
88;2021-05-26;2369;1135;154044;73838;42.8;20.5
88;2021-05-27;2200;1360;156244;75198;43.5;20.9
88;2021-05-28;1892;1988;158136;77186;44.0;21.5
88;2021-05-29;1232;1754;159368;78940;44.3;22.0
88;2021-05-30;588;417;159956;79357;44.5;22.1
88;2021-05-31;1326;1853;161282;81210;44.9;22.6
88;2021-06-01;1718;1988;163000;83198;45.3;23.1
88;2021-06-02;2076;1866;165076;85064;45.9;23.7
88;2021-06-03;2736;1616;167812;86680;46.7;24.1
88;2021-06-04;2041;1936;169853;88616;47.2;24.6
88;2021-06-05;1529;1139;171382;89755;47.7;25.0
88;2021-06-06;692;155;172074;89910;47.9;25.0
88;2021-06-07;1290;1706;173364;91616;48.2;25.5
88;2021-06-08;1662;1931;175026;93547;48.7;26.0
88;2021-06-09;1617;1907;176643;95454;49.1;26.6
88;2021-06-10;1778;2047;178421;97501;49.6;27.1
88;2021-06-11;1548;2215;179969;99716;50.1;27.7
88;2021-06-12;669;1655;180638;101371;50.2;28.2
88;2021-06-13;464;377;181102;101748;50.4;28.3
88;2021-06-14;1029;2245;182131;103993;50.7;28.9
88;2021-06-15;1928;2451;184059;106444;51.2;29.6
88;2021-06-16;1483;2869;185542;109313;51.6;30.4
88;2021-06-17;1598;2729;187140;112042;52.1;31.2
88;2021-06-18;1358;2456;188498;114498;52.4;31.8
88;2021-06-19;701;1090;189199;115588;52.6;32.2
88;2021-06-20;77;79;189276;115667;52.6;32.2
88;2021-06-21;672;2579;189948;118246;52.8;32.9
88;2021-06-22;869;3431;190817;121677;53.1;33.8
88;2021-06-23;1141;2878;191958;124555;53.4;34.6
88;2021-06-24;702;2603;192660;127158;53.6;35.4
88;2021-06-25;1436;3181;194096;130339;54.0;36.3
88;2021-06-26;905;2074;195001;132413;54.2;36.8
88;2021-06-27;543;633;195544;133046;54.4;37.0
88;2021-06-28;758;2506;196302;135552;54.6;37.7
88;2021-06-29;956;3356;197258;138908;54.9;38.6
88;2021-06-30;1135;3110;198393;142018;55.2;39.5
88;2021-07-01;1056;2686;199449;144704;55.5;40.2
88;2021-07-02;987;3143;200436;147847;55.8;41.1
88;2021-07-03;693;1699;201129;149546;55.9;41.6
88;2021-07-04;258;816;201387;150362;56.0;41.8
88;2021-07-05;992;2022;202379;152384;56.3;42.4
88;2021-07-06;1018;2414;203397;154798;56.6;43.1
88;2021-07-07;1179;2581;204576;157379;56.9;43.8
88;2021-07-08;1077;2061;205653;159440;57.2;44.3
88;2021-07-09;1583;2703;207236;162143;57.6;45.1
88;2021-07-10;709;1818;207945;163961;57.8;45.6
88;2021-07-11;467;695;208412;164656;58.0;45.8
88;2021-07-12;1048;2516;209460;167172;58.3;46.5
88;2021-07-13;1309;2659;210769;169831;58.6;47.2
88;2021-07-14;1190;800;211959;170631;59.0;47.5
88;2021-07-15;1735;3315;213694;173946;59.4;48.4
88;2021-07-16;1467;2963;215161;176909;59.8;49.2
88;2021-07-17;798;1589;215959;178498;60.1;49.6
88;2021-07-18;180;680;216139;179178;60.1;49.8
88;2021-07-19;1556;2236;217695;181414;60.6;50.5
88;2021-07-20;2135;2392;219830;183806;61.1;51.1
88;2021-07-21;1932;2226;221762;186032;61.7;51.7
88;2021-07-22;1695;2106;223457;188138;62.2;52.3
88;2021-07-23;2497;2780;225954;190918;62.8;53.1
88;2021-07-24;1057;1183;227011;192101;63.1;53.4
88;2021-07-25;431;607;227442;192708;63.3;53.6
88;2021-07-26;1710;2063;229152;194771;63.7;54.2
88;2021-07-27;2340;2053;231492;196824;64.4;54.7
88;2021-07-28;2202;2246;233694;199070;65.0;55.4
88;2021-07-29;3008;1624;236702;200694;65.8;55.8
88;2021-07-30;2263;2280;238965;202974;66.5;56.5
88;2021-07-31;1095;1030;240060;204004;66.8;56.7
88;2021-08-01;442;460;240502;204464;66.9;56.9
88;2021-08-02;2362;1759;242864;206223;67.6;57.4
88;2021-08-03;2866;1564;245730;207787;68.3;57.8
88;2021-08-04;2509;1519;248239;209306;69.0;58.2
88;2021-08-05;1973;1364;250212;210670;69.6;58.6
89;2020-12-27;0;0;0;0;0.0;0.0
89;2020-12-28;0;0;0;0;0.0;0.0
89;2020-12-29;0;0;0;0;0.0;0.0
89;2020-12-30;0;0;0;0;0.0;0.0
89;2020-12-31;0;0;0;0;0.0;0.0
89;2021-01-01;0;0;0;0;0.0;0.0
89;2021-01-02;0;0;0;0;0.0;0.0
89;2021-01-03;0;0;0;0;0.0;0.0
89;2021-01-04;0;0;0;0;0.0;0.0
89;2021-01-05;0;0;0;0;0.0;0.0
89;2021-01-06;48;0;48;0;0.0;0.0
89;2021-01-07;201;0;249;0;0.1;0.0
89;2021-01-08;48;0;297;0;0.1;0.0
89;2021-01-09;1;0;298;0;0.1;0.0
89;2021-01-10;0;0;298;0;0.1;0.0
89;2021-01-11;220;0;518;0;0.2;0.0
89;2021-01-12;349;0;867;0;0.3;0.0
89;2021-01-13;533;3;1400;3;0.4;0.0
89;2021-01-14;707;7;2107;10;0.6;0.0
89;2021-01-15;275;2;2382;12;0.7;0.0
89;2021-01-16;90;3;2472;15;0.7;0.0
89;2021-01-17;0;0;2472;15;0.7;0.0
89;2021-01-18;503;1;2975;16;0.9;0.0
89;2021-01-19;839;3;3814;19;1.1;0.0
89;2021-01-20;760;1;4574;20;1.4;0.0
89;2021-01-21;939;4;5513;24;1.7;0.0
89;2021-01-22;1016;1;6529;25;2.0;0.0
89;2021-01-23;200;0;6729;25;2.0;0.0
89;2021-01-24;106;0;6835;25;2.1;0.0
89;2021-01-25;482;4;7317;29;2.2;0.0
89;2021-01-26;581;13;7898;42;2.4;0.0
89;2021-01-27;472;38;8370;80;2.5;0.0
89;2021-01-28;550;127;8920;207;2.7;0.1
89;2021-01-29;957;43;9877;250;3.0;0.1
89;2021-01-30;184;67;10061;317;3.0;0.1
89;2021-01-31;24;2;10085;319;3.0;0.1
89;2021-02-01;255;153;10340;472;3.1;0.1
89;2021-02-02;282;339;10622;811;3.2;0.2
89;2021-02-03;291;345;10913;1156;3.3;0.3
89;2021-02-04;433;595;11346;1751;3.4;0.5
89;2021-02-05;387;201;11733;1952;3.5;0.6
89;2021-02-06;77;66;11810;2018;3.6;0.6
89;2021-02-07;0;0;11810;2018;3.6;0.6
89;2021-02-08;288;189;12098;2207;3.6;0.7
89;2021-02-09;285;443;12383;2650;3.7;0.8
89;2021-02-10;396;313;12779;2963;3.8;0.9
89;2021-02-11;332;564;13111;3527;3.9;1.1
89;2021-02-12;427;597;13538;4124;4.1;1.2
89;2021-02-13;52;143;13590;4267;4.1;1.3
89;2021-02-14;20;116;13610;4383;4.1;1.3
89;2021-02-15;216;413;13826;4796;4.2;1.4
89;2021-02-16;134;536;13960;5332;4.2;1.6
89;2021-02-17;262;438;14222;5770;4.3;1.7
89;2021-02-18;225;558;14447;6328;4.4;1.9
89;2021-02-19;243;654;14690;6982;4.4;2.1
89;2021-02-20;33;140;14723;7122;4.4;2.1
89;2021-02-21;0;10;14723;7132;4.4;2.1
89;2021-02-22;233;451;14956;7583;4.5;2.3
89;2021-02-23;171;471;15127;8054;4.6;2.4
89;2021-02-24;340;390;15467;8444;4.7;2.5
89;2021-02-25;369;466;15836;8910;4.8;2.7
89;2021-02-26;382;336;16218;9246;4.9;2.8
89;2021-02-27;137;81;16355;9327;4.9;2.8
89;2021-02-28;6;13;16361;9340;4.9;2.8
89;2021-03-01;541;237;16902;9577;5.1;2.9
89;2021-03-02;751;342;17653;9919;5.3;3.0
89;2021-03-03;647;276;18300;10195;5.5;3.1
89;2021-03-04;632;380;18932;10575;5.7;3.2
89;2021-03-05;728;503;19660;11078;5.9;3.3
89;2021-03-06;545;129;20205;11207;6.1;3.4
89;2021-03-07;287;40;20492;11247;6.2;3.4
89;2021-03-08;557;326;21049;11573;6.3;3.5
89;2021-03-09;997;270;22046;11843;6.6;3.6
89;2021-03-10;978;251;23024;12094;6.9;3.6
89;2021-03-11;1073;300;24097;12394;7.3;3.7
89;2021-03-12;1281;333;25378;12727;7.6;3.8
89;2021-03-13;635;43;26013;12770;7.8;3.8
89;2021-03-14;1;0;26014;12770;7.8;3.8
89;2021-03-15;814;310;26828;13080;8.1;3.9
89;2021-03-16;947;221;27775;13301;8.4;4.0
89;2021-03-17;917;265;28692;13566;8.6;4.1
89;2021-03-18;881;253;29573;13819;8.9;4.2
89;2021-03-19;1147;191;30720;14010;9.3;4.2
89;2021-03-20;844;25;31564;14035;9.5;4.2
89;2021-03-21;173;5;31737;14040;9.6;4.2
89;2021-03-22;1042;222;32779;14262;9.9;4.3
89;2021-03-23;1739;254;34518;14516;10.4;4.4
89;2021-03-24;1961;324;36479;14840;11.0;4.5
89;2021-03-25;1815;166;38294;15006;11.5;4.5
89;2021-03-26;2625;180;40919;15186;12.3;4.6
89;2021-03-27;1774;48;42693;15234;12.9;4.6
89;2021-03-28;32;3;42725;15237;12.9;4.6
89;2021-03-29;963;580;43688;15817;13.2;4.8
89;2021-03-30;1153;566;44841;16383;13.5;4.9
89;2021-03-31;2005;469;46846;16852;14.1;5.1
89;2021-04-01;2117;455;48963;17307;14.7;5.2
89;2021-04-02;2138;444;51101;17751;15.4;5.3
89;2021-04-03;1002;241;52103;17992;15.7;5.4
89;2021-04-04;16;1;52119;17993;15.7;5.4
89;2021-04-05;92;2;52211;17995;15.7;5.4
89;2021-04-06;1032;754;53243;18749;16.0;5.6
89;2021-04-07;1033;803;54276;19552;16.3;5.9
89;2021-04-08;1730;721;56006;20273;16.9;6.1
89;2021-04-09;2162;730;58168;21003;17.5;6.3
89;2021-04-10;891;179;59059;21182;17.8;6.4
89;2021-04-11;37;50;59096;21232;17.8;6.4
89;2021-04-12;1014;792;60110;22024;18.1;6.6
89;2021-04-13;1358;1077;61468;23101;18.5;7.0
89;2021-04-14;1211;1037;62679;24138;18.9;7.3
89;2021-04-15;1415;944;64094;25082;19.3;7.6
89;2021-04-16;1331;939;65425;26021;19.7;7.8
89;2021-04-17;1066;453;66491;26474;20.0;8.0
89;2021-04-18;27;154;66518;26628;20.0;8.0
89;2021-04-19;750;1029;67268;27657;20.3;8.3
89;2021-04-20;1019;1533;68287;29190;20.6;8.8
89;2021-04-21;814;1103;69101;30293;20.8;9.1
89;2021-04-22;1107;1166;70208;31459;21.1;9.5
89;2021-04-23;1823;1964;72031;33423;21.7;10.1
89;2021-04-24;1172;1177;73203;34600;22.0;10.4
89;2021-04-25;139;6;73342;34606;22.1;10.4
89;2021-04-26;1500;770;74842;35376;22.5;10.7
89;2021-04-27;1731;1055;76573;36431;23.1;11.0
89;2021-04-28;1590;1851;78163;38282;23.5;11.5
89;2021-04-29;1970;1912;80133;40194;24.1;12.1
89;2021-04-30;1806;1760;81939;41954;24.7;12.6
89;2021-05-01;846;722;82785;42676;24.9;12.9
89;2021-05-02;133;31;82918;42707;25.0;12.9
89;2021-05-03;1605;759;84523;43466;25.5;13.1
89;2021-05-04;1621;1128;86144;44594;25.9;13.4
89;2021-05-05;2320;1262;88464;45856;26.6;13.8
89;2021-05-06;2414;1376;90878;47232;27.4;14.2
89;2021-05-07;2722;1314;93600;48546;28.2;14.6
89;2021-05-08;1784;533;95384;49079;28.7;14.8
89;2021-05-09;196;18;95580;49097;28.8;14.8
89;2021-05-10;1200;940;96780;50037;29.1;15.1
89;2021-05-11;2488;1445;99268;51482;29.9;15.5
89;2021-05-12;2060;1216;101328;52698;30.5;15.9
89;2021-05-13;414;333;101742;53031;30.6;16.0
89;2021-05-14;1877;1091;103619;54122;31.2;16.3
89;2021-05-15;2247;393;105866;54515;31.9;16.4
89;2021-05-16;10;35;105876;54550;31.9;16.4
89;2021-05-17;2089;636;107965;55186;32.5;16.6
89;2021-05-18;2323;828;110288;56014;33.2;16.9
89;2021-05-19;2860;879;113148;56893;34.1;17.1
89;2021-05-20;2927;886;116075;57779;35.0;17.4
89;2021-05-21;2481;876;118556;58655;35.7;17.7
89;2021-05-22;1428;570;119984;59225;36.1;17.8
89;2021-05-23;108;10;120092;59235;36.2;17.8
89;2021-05-24;286;223;120378;59458;36.2;17.9
89;2021-05-25;1557;983;121935;60441;36.7;18.2
89;2021-05-26;1816;1020;123751;61461;37.3;18.5
89;2021-05-27;2117;1353;125868;62814;37.9;18.9
89;2021-05-28;2143;1423;128011;64237;38.5;19.3
89;2021-05-29;540;658;128551;64895;38.7;19.5
89;2021-05-30;25;22;128576;64917;38.7;19.5
89;2021-05-31;1248;968;129824;65885;39.1;19.8
89;2021-06-01;1505;981;131329;66866;39.5;20.1
89;2021-06-02;1949;1277;133278;68143;40.1;20.5
89;2021-06-03;2425;1522;135703;69665;40.9;21.0
89;2021-06-04;2141;1886;137844;71551;41.5;21.5
89;2021-06-05;1183;1224;139027;72775;41.9;21.9
89;2021-06-06;22;37;139049;72812;41.9;21.9
89;2021-06-07;2109;1446;141158;74258;42.5;22.4
89;2021-06-08;2196;1453;143354;75711;43.2;22.8
89;2021-06-09;2321;1506;145675;77217;43.9;23.3
89;2021-06-10;2789;1600;148464;78817;44.7;23.7
89;2021-06-11;1947;1747;150411;80564;45.3;24.3
89;2021-06-12;1103;757;151514;81321;45.6;24.5
89;2021-06-13;155;424;151669;81745;45.7;24.6
89;2021-06-14;1310;1822;152979;83567;46.1;25.2
89;2021-06-15;1402;2012;154381;85579;46.5;25.8
89;2021-06-16;1137;2582;155518;88161;46.8;26.5
89;2021-06-17;1429;2337;156947;90498;47.3;27.3
89;2021-06-18;1622;2875;158569;93373;47.7;28.1
89;2021-06-19;686;1662;159255;95035;48.0;28.6
89;2021-06-20;54;127;159309;95162;48.0;28.7
89;2021-06-21;758;1527;160067;96689;48.2;29.1
89;2021-06-22;1049;2679;161116;99368;48.5;29.9
89;2021-06-23;1154;1796;162270;101164;48.9;30.5
89;2021-06-24;1077;1494;163347;102658;49.2;30.9
89;2021-06-25;1005;2428;164352;105086;49.5;31.6
89;2021-06-26;561;2484;164913;107570;49.7;32.4
89;2021-06-27;13;28;164926;107598;49.7;32.4
89;2021-06-28;1028;2493;165954;110091;50.0;33.2
89;2021-06-29;686;2403;166640;112494;50.2;33.9
89;2021-06-30;1084;3177;167724;115671;50.5;34.8
89;2021-07-01;1020;2984;168744;118655;50.8;35.7
89;2021-07-02;1104;2749;169848;121404;51.1;36.6
89;2021-07-03;554;1572;170402;122976;51.3;37.0
89;2021-07-04;11;36;170413;123012;51.3;37.0
89;2021-07-05;1292;1836;171705;124848;51.7;37.6
89;2021-07-06;1048;2309;172753;127157;52.0;38.3
89;2021-07-07;664;1788;173417;128945;52.2;38.8
89;2021-07-08;790;1874;174207;130819;52.5;39.4
89;2021-07-09;1130;2606;175337;133425;52.8;40.2
89;2021-07-10;715;817;176052;134242;53.0;40.4
89;2021-07-11;25;39;176077;134281;53.0;40.4
89;2021-07-12;1423;1901;177500;136182;53.4;41.0
89;2021-07-13;2128;2743;179628;138925;54.1;41.8
89;2021-07-14;312;324;179940;139249;54.2;41.9
89;2021-07-15;2226;3226;182166;142475;54.9;42.9
89;2021-07-16;2380;2856;184546;145331;55.6;43.8
89;2021-07-17;1232;1227;185778;146558;55.9;44.1
89;2021-07-18;276;96;186054;146654;56.0;44.2
89;2021-07-19;1562;2813;187616;149467;56.5;45.0
89;2021-07-20;1913;3280;189529;152747;57.1;46.0
89;2021-07-21;2072;2720;191601;155467;57.7;46.8
89;2021-07-22;2460;2989;194061;158456;58.4;47.7
89;2021-07-23;2462;3099;196523;161555;59.2;48.6
89;2021-07-24;1228;1246;197751;162801;59.5;49.0
89;2021-07-25;68;184;197819;162985;59.6;49.1
89;2021-07-26;1709;2318;199528;165303;60.1;49.8
89;2021-07-27;2316;1903;201844;167206;60.8;50.3
89;2021-07-28;2512;1331;204356;168537;61.5;50.7
89;2021-07-29;2506;1612;206862;170149;62.3;51.2
89;2021-07-30;2653;1608;209515;171757;63.1;51.7
89;2021-07-31;1113;1072;210628;172829;63.4;52.0
89;2021-08-01;69;33;210697;172862;63.4;52.1
89;2021-08-02;1766;1279;212463;174141;64.0;52.4
89;2021-08-03;2425;1222;214888;175363;64.7;52.8
89;2021-08-04;1515;1637;216403;177000;65.2;53.3
89;2021-08-05;1520;1680;217923;178680;65.6;53.8
90;2020-12-27;0;0;0;0;0.0;0.0
90;2020-12-28;0;0;0;0;0.0;0.0
90;2020-12-29;0;0;0;0;0.0;0.0
90;2020-12-30;1;0;1;0;0.0;0.0
90;2020-12-31;0;0;1;0;0.0;0.0
90;2021-01-01;0;0;1;0;0.0;0.0
90;2021-01-02;1;0;2;0;0.0;0.0
90;2021-01-03;0;0;2;0;0.0;0.0
90;2021-01-04;2;0;4;0;0.0;0.0
90;2021-01-05;0;0;4;0;0.0;0.0
90;2021-01-06;0;0;4;0;0.0;0.0
90;2021-01-07;1;0;5;0;0.0;0.0
90;2021-01-08;170;0;175;0;0.1;0.0
90;2021-01-09;46;0;221;0;0.2;0.0
90;2021-01-10;0;0;221;0;0.2;0.0
90;2021-01-11;200;0;421;0;0.3;0.0
90;2021-01-12;430;0;851;0;0.6;0.0
90;2021-01-13;468;2;1319;2;0.9;0.0
90;2021-01-14;414;1;1733;3;1.2;0.0
90;2021-01-15;405;9;2138;12;1.5;0.0
90;2021-01-16;111;2;2249;14;1.6;0.0
90;2021-01-17;1;0;2250;14;1.6;0.0
90;2021-01-18;364;2;2614;16;1.9;0.0
90;2021-01-19;461;5;3075;21;2.2;0.0
90;2021-01-20;391;2;3466;23;2.5;0.0
90;2021-01-21;349;1;3815;24;2.7;0.0
90;2021-01-22;346;2;4161;26;3.0;0.0
90;2021-01-23;98;0;4259;26;3.0;0.0
90;2021-01-24;0;0;4259;26;3.0;0.0
90;2021-01-25;322;3;4581;29;3.3;0.0
90;2021-01-26;224;0;4805;29;3.4;0.0
90;2021-01-27;254;0;5059;29;3.6;0.0
90;2021-01-28;328;33;5387;62;3.8;0.0
90;2021-01-29;291;163;5678;225;4.1;0.2
90;2021-01-30;176;45;5854;270;4.2;0.2
90;2021-01-31;118;0;5972;270;4.3;0.2
90;2021-02-01;275;112;6247;382;4.5;0.3
90;2021-02-02;290;163;6537;545;4.7;0.4
90;2021-02-03;256;368;6793;913;4.8;0.7
90;2021-02-04;256;302;7049;1215;5.0;0.9
90;2021-02-05;266;271;7315;1486;5.2;1.1
90;2021-02-06;89;68;7404;1554;5.3;1.1
90;2021-02-07;0;0;7404;1554;5.3;1.1
90;2021-02-08;170;218;7574;1772;5.4;1.3
90;2021-02-09;139;166;7713;1938;5.5;1.4
90;2021-02-10;182;30;7895;1968;5.6;1.4
90;2021-02-11;228;109;8123;2077;5.8;1.5
90;2021-02-12;126;239;8249;2316;5.9;1.7
90;2021-02-13;95;45;8344;2361;6.0;1.7
90;2021-02-14;0;0;8344;2361;6.0;1.7
90;2021-02-15;113;280;8457;2641;6.0;1.9
90;2021-02-16;92;277;8549;2918;6.1;2.1
90;2021-02-17;178;205;8727;3123;6.2;2.2
90;2021-02-18;130;242;8857;3365;6.3;2.4
90;2021-02-19;64;272;8921;3637;6.4;2.6
90;2021-02-20;40;72;8961;3709;6.4;2.6
90;2021-02-21;0;0;8961;3709;6.4;2.6
90;2021-02-22;77;333;9038;4042;6.4;2.9
90;2021-02-23;40;259;9078;4301;6.5;3.1
90;2021-02-24;109;289;9187;4590;6.6;3.3
90;2021-02-25;89;313;9276;4903;6.6;3.5
90;2021-02-26;89;396;9365;5299;6.7;3.8
90;2021-02-27;140;178;9505;5477;6.8;3.9
90;2021-02-28;8;113;9513;5590;6.8;4.0
90;2021-03-01;212;233;9725;5823;6.9;4.2
90;2021-03-02;178;285;9903;6108;7.1;4.4
90;2021-03-03;239;354;10142;6462;7.2;4.6
90;2021-03-04;259;277;10401;6739;7.4;4.8
90;2021-03-05;358;269;10759;7008;7.7;5.0
90;2021-03-06;291;104;11050;7112;7.9;5.1
90;2021-03-07;18;1;11068;7113;7.9;5.1
90;2021-03-08;246;245;11314;7358;8.1;5.3
90;2021-03-09;427;162;11741;7520;8.4;5.4
90;2021-03-10;348;196;12089;7716;8.6;5.5
90;2021-03-11;348;119;12437;7835;8.9;5.6
90;2021-03-12;519;128;12956;7963;9.2;5.7
90;2021-03-13;539;47;13495;8010;9.6;5.7
90;2021-03-14;21;0;13516;8010;9.6;5.7
90;2021-03-15;386;116;13902;8126;9.9;5.8
90;2021-03-16;401;98;14303;8224;10.2;5.9
90;2021-03-17;323;74;14626;8298;10.4;5.9
90;2021-03-18;348;77;14974;8375;10.7;6.0
90;2021-03-19;468;78;15442;8453;11.0;6.0
90;2021-03-20;426;48;15868;8501;11.3;6.1
90;2021-03-21;7;2;15875;8503;11.3;6.1
90;2021-03-22;399;29;16274;8532;11.6;6.1
90;2021-03-23;737;72;17011;8604;12.1;6.1
90;2021-03-24;816;45;17827;8649;12.7;6.2
90;2021-03-25;945;71;18772;8720;13.4;6.2
90;2021-03-26;1226;57;19998;8777;14.3;6.3
90;2021-03-27;437;32;20435;8809;14.6;6.3
90;2021-03-28;34;0;20469;8809;14.6;6.3
90;2021-03-29;712;140;21181;8949;15.1;6.4
90;2021-03-30;674;153;21855;9102;15.6;6.5
90;2021-03-31;728;81;22583;9183;16.1;6.6
90;2021-04-01;601;117;23184;9300;16.5;6.6
90;2021-04-02;657;95;23841;9395;17.0;6.7
90;2021-04-03;370;39;24211;9434;17.3;6.7
90;2021-04-04;1;0;24212;9434;17.3;6.7
90;2021-04-05;0;0;24212;9434;17.3;6.7
90;2021-04-06;528;248;24740;9682;17.7;6.9
90;2021-04-07;484;262;25224;9944;18.0;7.1
90;2021-04-08;510;244;25734;10188;18.4;7.3
90;2021-04-09;750;265;26484;10453;18.9;7.5
90;2021-04-10;223;8;26707;10461;19.1;7.5
90;2021-04-11;7;0;26714;10461;19.1;7.5
90;2021-04-12;551;479;27265;10940;19.5;7.8
90;2021-04-13;631;529;27896;11469;19.9;8.2
90;2021-04-14;527;349;28423;11818;20.3;8.4
90;2021-04-15;905;284;29328;12102;20.9;8.6
90;2021-04-16;370;404;29698;12506;21.2;8.9
90;2021-04-17;189;127;29887;12633;21.3;9.0
90;2021-04-18;21;0;29908;12633;21.3;9.0
90;2021-04-19;435;568;30343;13201;21.7;9.4
90;2021-04-20;494;620;30837;13821;22.0;9.9
90;2021-04-21;353;495;31190;14316;22.3;10.2
90;2021-04-22;568;601;31758;14917;22.7;10.6
90;2021-04-23;504;744;32262;15661;23.0;11.2
90;2021-04-24;305;202;32567;15863;23.2;11.3
90;2021-04-25;1;0;32568;15863;23.2;11.3
90;2021-04-26;508;751;33076;16614;23.6;11.9
90;2021-04-27;641;679;33717;17293;24.1;12.3
90;2021-04-28;765;445;34482;17738;24.6;12.7
90;2021-04-29;1003;449;35485;18187;25.3;13.0
90;2021-04-30;1120;457;36605;18644;26.1;13.3
90;2021-05-01;60;42;36665;18686;26.2;13.3
90;2021-05-02;4;0;36669;18686;26.2;13.3
90;2021-05-03;903;286;37572;18972;26.8;13.5
90;2021-05-04;784;638;38356;19610;27.4;14.0
90;2021-05-05;893;506;39249;20116;28.0;14.4
90;2021-05-06;853;627;40102;20743;28.6;14.8
90;2021-05-07;440;510;40542;21253;28.9;15.2
90;2021-05-08;26;26;40568;21279;28.9;15.2
90;2021-05-09;5;33;40573;21312;29.0;15.2
90;2021-05-10;505;584;41078;21896;29.3;15.6
90;2021-05-11;778;635;41856;22531;29.9;16.1
90;2021-05-12;530;597;42386;23128;30.2;16.5
90;2021-05-13;1113;263;43499;23391;31.0;16.7
90;2021-05-14;865;402;44364;23793;31.7;17.0
90;2021-05-15;14;125;44378;23918;31.7;17.1
90;2021-05-16;2;7;44380;23925;31.7;17.1
90;2021-05-17;793;289;45173;24214;32.2;17.3
90;2021-05-18;1023;470;46196;24684;33.0;17.6
90;2021-05-19;1265;383;47461;25067;33.9;17.9
90;2021-05-20;1200;267;48661;25334;34.7;18.1
90;2021-05-21;1265;431;49926;25765;35.6;18.4
90;2021-05-22;9;131;49935;25896;35.6;18.5
90;2021-05-23;4;0;49939;25896;35.6;18.5
90;2021-05-24;368;266;50307;26162;35.9;18.7
90;2021-05-25;637;792;50944;26954;36.4;19.2
90;2021-05-26;631;567;51575;27521;36.8;19.6
90;2021-05-27;963;381;52538;27902;37.5;19.9
90;2021-05-28;669;826;53207;28728;38.0;20.5
90;2021-05-29;93;296;53300;29024;38.0;20.7
90;2021-05-30;4;1;53304;29025;38.0;20.7
90;2021-05-31;809;714;54113;29739;38.6;21.2
90;2021-06-01;968;740;55081;30479;39.3;21.7
90;2021-06-02;760;675;55841;31154;39.8;22.2
90;2021-06-03;758;743;56599;31897;40.4;22.8
90;2021-06-04;833;973;57432;32870;41.0;23.5
90;2021-06-05;53;425;57485;33295;41.0;23.8
90;2021-06-06;1;16;57486;33311;41.0;23.8
90;2021-06-07;1265;1081;58751;34392;41.9;24.5
90;2021-06-08;1481;935;60232;35327;43.0;25.2
90;2021-06-09;964;658;61196;35985;43.7;25.7
90;2021-06-10;624;496;61820;36481;44.1;26.0
90;2021-06-11;787;1127;62607;37608;44.7;26.8
90;2021-06-12;806;298;63413;37906;45.2;27.0
90;2021-06-13;10;12;63423;37918;45.3;27.1
90;2021-06-14;260;973;63683;38891;45.4;27.8
90;2021-06-15;565;879;64248;39770;45.8;28.4
90;2021-06-16;505;546;64753;40316;46.2;28.8
90;2021-06-17;439;637;65192;40953;46.5;29.2
90;2021-06-18;609;995;65801;41948;47.0;29.9
90;2021-06-19;449;169;66250;42117;47.3;30.1
90;2021-06-20;0;28;66250;42145;47.3;30.1
90;2021-06-21;255;1178;66505;43323;47.5;30.9
90;2021-06-22;383;948;66888;44271;47.7;31.6
90;2021-06-23;413;633;67301;44904;48.0;32.0
90;2021-06-24;317;602;67618;45506;48.2;32.5
90;2021-06-25;425;1271;68043;46777;48.6;33.4
90;2021-06-26;420;561;68463;47338;48.9;33.8
90;2021-06-27;2;6;68465;47344;48.9;33.8
90;2021-06-28;376;1297;68841;48641;49.1;34.7
90;2021-06-29;304;1304;69145;49945;49.3;35.6
90;2021-06-30;485;1230;69630;51175;49.7;36.5
90;2021-07-01;345;920;69975;52095;49.9;37.2
90;2021-07-02;504;1206;70479;53301;50.3;38.0
90;2021-07-03;42;129;70521;53430;50.3;38.1
90;2021-07-04;0;21;70521;53451;50.3;38.1
90;2021-07-05;394;1016;70915;54467;50.6;38.9
90;2021-07-06;508;971;71423;55438;51.0;39.6
90;2021-07-07;374;996;71797;56434;51.2;40.3
90;2021-07-08;301;608;72098;57042;51.4;40.7
90;2021-07-09;434;950;72532;57992;51.8;41.4
90;2021-07-10;27;90;72559;58082;51.8;41.4
90;2021-07-11;5;17;72564;58099;51.8;41.5
90;2021-07-12;238;1076;72802;59175;51.9;42.2
90;2021-07-13;474;1160;73276;60335;52.3;43.1
90;2021-07-14;0;8;73276;60343;52.3;43.1
90;2021-07-15;787;1444;74063;61787;52.8;44.1
90;2021-07-16;815;1685;74878;63472;53.4;45.3
90;2021-07-17;480;955;75358;64427;53.8;46.0
90;2021-07-18;4;2;75362;64429;53.8;46.0
90;2021-07-19;1178;1461;76540;65890;54.6;47.0
90;2021-07-20;1333;1132;77873;67022;55.6;47.8
90;2021-07-21;1388;978;79261;68000;56.6;48.5
90;2021-07-22;1110;693;80371;68693;57.3;49.0
90;2021-07-23;960;1022;81331;69715;58.0;49.7
90;2021-07-24;116;64;81447;69779;58.1;49.8
90;2021-07-25;2;1;81449;69780;58.1;49.8
90;2021-07-26;1068;802;82517;70582;58.9;50.4
90;2021-07-27;1073;741;83590;71323;59.6;50.9
90;2021-07-28;808;708;84398;72031;60.2;51.4
90;2021-07-29;832;436;85230;72467;60.8;51.7
90;2021-07-30;776;493;86006;72960;61.4;52.1
90;2021-07-31;479;313;86485;73273;61.7;52.3
90;2021-08-01;0;3;86485;73276;61.7;52.3
90;2021-08-02;834;512;87319;73788;62.3;52.7
90;2021-08-03;907;491;88226;74279;63.0;53.0
90;2021-08-04;1061;455;89287;74734;63.7;53.3
90;2021-08-05;513;218;89800;74952;64.1;53.5
91;2020-12-27;0;0;0;0;0.0;0.0
91;2020-12-28;0;0;0;0;0.0;0.0
91;2020-12-29;1;0;1;0;0.0;0.0
91;2020-12-30;1;0;2;0;0.0;0.0
91;2020-12-31;0;0;2;0;0.0;0.0
91;2021-01-01;5;0;7;0;0.0;0.0
91;2021-01-02;0;0;7;0;0.0;0.0
91;2021-01-03;0;0;7;0;0.0;0.0
91;2021-01-04;1;0;8;0;0.0;0.0
91;2021-01-05;71;0;79;0;0.0;0.0
91;2021-01-06;188;2;267;2;0.0;0.0
91;2021-01-07;523;6;790;8;0.1;0.0
91;2021-01-08;393;0;1183;8;0.1;0.0
91;2021-01-09;89;3;1272;11;0.1;0.0
91;2021-01-10;0;0;1272;11;0.1;0.0
91;2021-01-11;595;3;1867;14;0.1;0.0
91;2021-01-12;899;8;2766;22;0.2;0.0
91;2021-01-13;702;6;3468;28;0.3;0.0
91;2021-01-14;721;10;4189;38;0.3;0.0
91;2021-01-15;567;3;4756;41;0.4;0.0
91;2021-01-16;316;8;5072;49;0.4;0.0
91;2021-01-17;116;1;5188;50;0.4;0.0
91;2021-01-18;991;3;6179;53;0.5;0.0
91;2021-01-19;1862;12;8041;65;0.6;0.0
91;2021-01-20;2368;19;10409;84;0.8;0.0
91;2021-01-21;2093;14;12502;98;0.9;0.0
91;2021-01-22;1821;8;14323;106;1.1;0.0
91;2021-01-23;413;1;14736;107;1.1;0.0
91;2021-01-24;53;0;14789;107;1.1;0.0
91;2021-01-25;1047;3;15836;110;1.2;0.0
91;2021-01-26;1576;41;17412;151;1.3;0.0
91;2021-01-27;2413;96;19825;247;1.5;0.0
91;2021-01-28;1978;223;21803;470;1.7;0.0
91;2021-01-29;1749;64;23552;534;1.8;0.0
91;2021-01-30;422;7;23974;541;1.8;0.0
91;2021-01-31;54;0;24028;541;1.8;0.0
91;2021-02-01;962;219;24990;760;1.9;0.1
91;2021-02-02;858;366;25848;1126;2.0;0.1
91;2021-02-03;936;571;26784;1697;2.0;0.1
91;2021-02-04;884;282;27668;1979;2.1;0.1
91;2021-02-05;1034;357;28702;2336;2.2;0.2
91;2021-02-06;337;91;29039;2427;2.2;0.2
91;2021-02-07;13;0;29052;2427;2.2;0.2
91;2021-02-08;904;605;29956;3032;2.3;0.2
91;2021-02-09;961;862;30917;3894;2.3;0.3
91;2021-02-10;1066;989;31983;4883;2.4;0.4
91;2021-02-11;1120;997;33103;5880;2.5;0.4
91;2021-02-12;1058;835;34161;6715;2.6;0.5
91;2021-02-13;331;360;34492;7075;2.6;0.5
91;2021-02-14;18;112;34510;7187;2.6;0.5
91;2021-02-15;367;1265;34877;8452;2.6;0.6
91;2021-02-16;553;1764;35430;10216;2.7;0.8
91;2021-02-17;810;2679;36240;12895;2.7;1.0
91;2021-02-18;940;2017;37180;14912;2.8;1.1
91;2021-02-19;865;1385;38045;16297;2.9;1.2
91;2021-02-20;165;361;38210;16658;2.9;1.3
91;2021-02-21;13;50;38223;16708;2.9;1.3
91;2021-02-22;335;1206;38558;17914;2.9;1.4
91;2021-02-23;397;1076;38955;18990;3.0;1.4
91;2021-02-24;473;1059;39428;20049;3.0;1.5
91;2021-02-25;731;1020;40159;21069;3.0;1.6
91;2021-02-26;1095;1059;41254;22128;3.1;1.7
91;2021-02-27;610;328;41864;22456;3.2;1.7
91;2021-02-28;65;66;41929;22522;3.2;1.7
91;2021-03-01;931;1069;42860;23591;3.2;1.8
91;2021-03-02;1258;1094;44118;24685;3.3;1.9
91;2021-03-03;1466;1279;45584;25964;3.5;2.0
91;2021-03-04;2418;1114;48002;27078;3.6;2.1
91;2021-03-05;3350;1162;51352;28240;3.9;2.1
91;2021-03-06;4902;453;56254;28693;4.3;2.2
91;2021-03-07;3208;111;59462;28804;4.5;2.2
91;2021-03-08;1473;1067;60935;29871;4.6;2.3
91;2021-03-09;2622;989;63557;30860;4.8;2.3
91;2021-03-10;2617;1035;66174;31895;5.0;2.4
91;2021-03-11;3785;1125;69959;33020;5.3;2.5
91;2021-03-12;4781;1039;74740;34059;5.7;2.6
91;2021-03-13;5255;322;79995;34381;6.1;2.6
91;2021-03-14;302;26;80297;34407;6.1;2.6
91;2021-03-15;2981;434;83278;34841;6.3;2.6
91;2021-03-16;2603;378;85881;35219;6.5;2.7
91;2021-03-17;2225;344;88106;35563;6.7;2.7
91;2021-03-18;2386;404;90492;35967;6.9;2.7
91;2021-03-19;4092;380;94584;36347;7.2;2.8
91;2021-03-20;3609;177;98193;36524;7.4;2.8
91;2021-03-21;138;30;98331;36554;7.5;2.8
91;2021-03-22;3148;604;101479;37158;7.7;2.8
91;2021-03-23;4135;697;105614;37855;8.0;2.9
91;2021-03-24;3935;493;109549;38348;8.3;2.9
91;2021-03-25;5055;521;114604;38869;8.7;2.9
91;2021-03-26;5549;541;120153;39410;9.1;3.0
91;2021-03-27;4989;330;125142;39740;9.5;3.0
91;2021-03-28;282;57;125424;39797;9.5;3.0
91;2021-03-29;3302;1036;128726;40833;9.8;3.1
91;2021-03-30;4422;1218;133148;42051;10.1;3.2
91;2021-03-31;3365;1335;136513;43386;10.3;3.3
91;2021-04-01;3736;1672;140249;45058;10.6;3.4
91;2021-04-02;3885;2310;144134;47368;10.9;3.6
91;2021-04-03;1870;2874;146004;50242;11.1;3.8
91;2021-04-04;648;1320;146652;51562;11.1;3.9
91;2021-04-05;562;130;147214;51692;11.2;3.9
91;2021-04-06;3402;1789;150616;53481;11.4;4.1
91;2021-04-07;3415;1932;154031;55413;11.7;4.2
91;2021-04-08;4658;2142;158689;57555;12.0;4.4
91;2021-04-09;5340;2142;164029;59697;12.4;4.5
91;2021-04-10;2728;2816;166757;62513;12.6;4.7
91;2021-04-11;191;141;166948;62654;12.7;4.7
91;2021-04-12;2854;2270;169802;64924;12.9;4.9
91;2021-04-13;3758;2642;173560;67566;13.2;5.1
91;2021-04-14;3707;2319;177267;69885;13.4;5.3
91;2021-04-15;4477;2506;181744;72391;13.8;5.5
91;2021-04-16;4551;2796;186295;75187;14.1;5.7
91;2021-04-17;2982;2077;189277;77264;14.3;5.9
91;2021-04-18;267;70;189544;77334;14.4;5.9
91;2021-04-19;2303;2728;191847;80062;14.5;6.1
91;2021-04-20;3179;2983;195026;83045;14.8;6.3
91;2021-04-21;2989;2895;198015;85940;15.0;6.5
91;2021-04-22;3161;3360;201176;89300;15.2;6.8
91;2021-04-23;3709;3353;204885;92653;15.5;7.0
91;2021-04-24;3480;3728;208365;96381;15.8;7.3
91;2021-04-25;2614;641;210979;97022;16.0;7.4
91;2021-04-26;3487;2799;214466;99821;16.3;7.6
91;2021-04-27;4486;2924;218952;102745;16.6;7.8
91;2021-04-28;4567;2702;223519;105447;16.9;8.0
91;2021-04-29;5742;3048;229261;108495;17.4;8.2
91;2021-04-30;5386;2847;234647;111342;17.8;8.4
91;2021-05-01;3513;520;238160;111862;18.1;8.5
91;2021-05-02;623;132;238783;111994;18.1;8.5
91;2021-05-03;5204;2286;243987;114280;18.5;8.7
91;2021-05-04;5589;3168;249576;117448;18.9;8.9
91;2021-05-05;4849;2866;254425;120314;19.3;9.1
91;2021-05-06;5242;3369;259667;123683;19.7;9.4
91;2021-05-07;6124;3744;265791;127427;20.1;9.7
91;2021-05-08;6515;961;272306;128388;20.6;9.7
91;2021-05-09;4804;561;277110;128949;21.0;9.8
91;2021-05-10;5897;3004;283007;131953;21.4;10.0
91;2021-05-11;6831;3829;289838;135782;22.0;10.3
91;2021-05-12;5883;3436;295721;139218;22.4;10.6
91;2021-05-13;4824;1079;300545;140297;22.8;10.6
91;2021-05-14;6548;2385;307093;142682;23.3;10.8
91;2021-05-15;7795;1921;314888;144603;23.9;11.0
91;2021-05-16;4583;369;319471;144972;24.2;11.0
91;2021-05-17;6952;1711;326423;146683;24.7;11.1
91;2021-05-18;8112;1738;334535;148421;25.4;11.2
91;2021-05-19;7098;1695;341633;150116;25.9;11.4
91;2021-05-20;8199;2141;349832;152257;26.5;11.5
91;2021-05-21;8139;2579;357971;154836;27.1;11.7
91;2021-05-22;7661;1541;365632;156377;27.7;11.9
91;2021-05-23;4799;522;370431;156899;28.1;11.9
91;2021-05-24;5015;600;375446;157499;28.5;11.9
91;2021-05-25;7627;2646;383073;160145;29.0;12.1
91;2021-05-26;6868;2941;389941;163086;29.6;12.4
91;2021-05-27;7967;3443;397908;166529;30.2;12.6
91;2021-05-28;7532;4317;405440;170846;30.7;12.9
91;2021-05-29;9299;3501;414739;174347;31.4;13.2
91;2021-05-30;5954;963;420693;175310;31.9;13.3
91;2021-05-31;6741;3700;427434;179010;32.4;13.6
91;2021-06-01;7784;4776;435218;183786;33.0;13.9
91;2021-06-02;7446;3956;442664;187742;33.6;14.2
91;2021-06-03;7858;4779;450522;192521;34.1;14.6
91;2021-06-04;7179;5718;457701;198239;34.7;15.0
91;2021-06-05;6387;5808;464088;204047;35.2;15.5
91;2021-06-06;4087;2507;468175;206554;35.5;15.7
91;2021-06-07;5879;5476;474054;212030;35.9;16.1
91;2021-06-08;7041;5794;481095;217824;36.5;16.5
91;2021-06-09;6466;5136;487561;222960;37.0;16.9
91;2021-06-10;7173;5772;494734;228732;37.5;17.3
91;2021-06-11;6538;7109;501272;235841;38.0;17.9
91;2021-06-12;6222;7359;507494;243200;38.5;18.4
91;2021-06-13;2851;2314;510345;245514;38.7;18.6
91;2021-06-14;4228;7197;514573;252711;39.0;19.2
91;2021-06-15;5572;7251;520145;259962;39.4;19.7
91;2021-06-16;5300;6440;525445;266402;39.8;20.2
91;2021-06-17;6236;7129;531681;273531;40.3;20.7
91;2021-06-18;4632;8732;536313;282263;40.6;21.4
91;2021-06-19;4184;7154;540497;289417;41.0;21.9
91;2021-06-20;1006;4212;541503;293629;41.0;22.3
91;2021-06-21;3225;7233;544728;300862;41.3;22.8
91;2021-06-22;4160;9224;548888;310086;41.6;23.5
91;2021-06-23;4311;7958;553199;318044;41.9;24.1
91;2021-06-24;4902;8476;558101;326520;42.3;24.7
91;2021-06-25;3467;9166;561568;335686;42.6;25.4
91;2021-06-26;2982;8036;564550;343722;42.8;26.1
91;2021-06-27;549;2998;565099;346720;42.8;26.3
91;2021-06-28;3119;8227;568218;354947;43.1;26.9
91;2021-06-29;3569;9637;571787;364584;43.3;27.6
91;2021-06-30;3945;8689;575732;373273;43.6;28.3
91;2021-07-01;4071;8862;579803;382135;43.9;29.0
91;2021-07-02;3750;9311;583553;391446;44.2;29.7
91;2021-07-03;2871;9786;586424;401232;44.4;30.4
91;2021-07-04;847;4722;587271;405954;44.5;30.8
91;2021-07-05;2647;7254;589918;413208;44.7;31.3
91;2021-07-06;3677;9421;593595;422629;45.0;32.0
91;2021-07-07;3778;8577;597373;431206;45.3;32.7
91;2021-07-08;4331;8983;601704;440189;45.6;33.4
91;2021-07-09;3931;9956;605635;450145;45.9;34.1
91;2021-07-10;3323;10225;608958;460370;46.2;34.9
91;2021-07-11;982;4796;609940;465166;46.2;35.3
91;2021-07-12;2788;8890;612728;474056;46.4;35.9
91;2021-07-13;4438;10377;617166;484433;46.8;36.7
91;2021-07-14;2278;3577;619444;488010;46.9;37.0
91;2021-07-15;4512;9812;623956;497822;47.3;37.7
91;2021-07-16;6242;9734;630198;507556;47.8;38.5
91;2021-07-17;5641;9047;635839;516603;48.2;39.2
91;2021-07-18;3381;3649;639220;520252;48.4;39.4
91;2021-07-19;3741;7528;642961;527780;48.7;40.0
91;2021-07-20;6034;9289;648995;537069;49.2;40.7
91;2021-07-21;6194;7702;655189;544771;49.7;41.3
91;2021-07-22;6418;8361;661607;553132;50.1;41.9
91;2021-07-23;6894;8256;668501;561388;50.7;42.5
91;2021-07-24;4933;6457;673434;567845;51.0;43.0
91;2021-07-25;3233;1360;676667;569205;51.3;43.1
91;2021-07-26;4902;6571;681569;575776;51.7;43.6
91;2021-07-27;7502;7026;689071;582802;52.2;44.2
91;2021-07-28;7231;5871;696302;588673;52.8;44.6
91;2021-07-29;7315;5871;703617;594544;53.3;45.1
91;2021-07-30;6868;5733;710485;600277;53.8;45.5
91;2021-07-31;4815;4755;715300;605032;54.2;45.9
91;2021-08-01;2589;1309;717889;606341;54.4;46.0
91;2021-08-02;4641;4191;722530;610532;54.8;46.3
91;2021-08-03;5741;4656;728271;615188;55.2;46.6
91;2021-08-04;5649;4079;733920;619267;55.6;46.9
91;2021-08-05;5445;4211;739365;623478;56.0;47.3
92;2020-12-27;12;0;12;0;0.0;0.0
92;2020-12-28;10;0;22;0;0.0;0.0
92;2020-12-29;53;0;75;0;0.0;0.0
92;2020-12-30;27;0;102;0;0.0;0.0
92;2020-12-31;3;0;105;0;0.0;0.0
92;2021-01-01;14;0;119;0;0.0;0.0
92;2021-01-02;2;0;121;0;0.0;0.0
92;2021-01-03;5;0;126;0;0.0;0.0
92;2021-01-04;59;1;185;1;0.0;0.0
92;2021-01-05;222;1;407;2;0.0;0.0
92;2021-01-06;407;3;814;5;0.1;0.0
92;2021-01-07;656;5;1470;10;0.1;0.0
92;2021-01-08;836;4;2306;14;0.1;0.0
92;2021-01-09;118;1;2424;15;0.2;0.0
92;2021-01-10;41;0;2465;15;0.2;0.0
92;2021-01-11;836;5;3301;20;0.2;0.0
92;2021-01-12;1286;10;4587;30;0.3;0.0
92;2021-01-13;1228;15;5815;45;0.4;0.0
92;2021-01-14;1195;17;7010;62;0.4;0.0
92;2021-01-15;963;6;7973;68;0.5;0.0
92;2021-01-16;175;1;8148;69;0.5;0.0
92;2021-01-17;14;0;8162;69;0.5;0.0
92;2021-01-18;1532;23;9694;92;0.6;0.0
92;2021-01-19;1546;20;11240;112;0.7;0.0
92;2021-01-20;1802;14;13042;126;0.8;0.0
92;2021-01-21;3397;21;16439;147;1.0;0.0
92;2021-01-22;2603;42;19042;189;1.2;0.0
92;2021-01-23;134;0;19176;189;1.2;0.0
92;2021-01-24;15;0;19191;189;1.2;0.0
92;2021-01-25;834;13;20025;202;1.2;0.0
92;2021-01-26;1209;12;21234;214;1.3;0.0
92;2021-01-27;2206;95;23440;309;1.5;0.0
92;2021-01-28;4114;185;27554;494;1.7;0.0
92;2021-01-29;2705;266;30259;760;1.9;0.0
92;2021-01-30;322;13;30581;773;1.9;0.0
92;2021-01-31;17;2;30598;775;1.9;0.0
92;2021-02-01;853;324;31451;1099;1.9;0.1
92;2021-02-02;1045;355;32496;1454;2.0;0.1
92;2021-02-03;993;449;33489;1903;2.1;0.1
92;2021-02-04;1035;548;34524;2451;2.1;0.2
92;2021-02-05;1324;502;35848;2953;2.2;0.2
92;2021-02-06;109;17;35957;2970;2.2;0.2
92;2021-02-07;9;14;35966;2984;2.2;0.2
92;2021-02-08;568;735;36534;3719;2.3;0.2
92;2021-02-09;1058;1304;37592;5023;2.3;0.3
92;2021-02-10;1057;1307;38649;6330;2.4;0.4
92;2021-02-11;1489;1926;40138;8256;2.5;0.5
92;2021-02-12;1406;1483;41544;9739;2.6;0.6
92;2021-02-13;66;61;41610;9800;2.6;0.6
92;2021-02-14;14;0;41624;9800;2.6;0.6
92;2021-02-15;565;1666;42189;11466;2.6;0.7
92;2021-02-16;779;2061;42968;13527;2.7;0.8
92;2021-02-17;607;1756;43575;15283;2.7;0.9
92;2021-02-18;1561;3670;45136;18953;2.8;1.2
92;2021-02-19;1716;2655;46852;21608;2.9;1.3
92;2021-02-20;138;401;46990;22009;2.9;1.4
92;2021-02-21;27;53;47017;22062;2.9;1.4
92;2021-02-22;488;1222;47505;23284;2.9;1.4
92;2021-02-23;722;1366;48227;24650;3.0;1.5
92;2021-02-24;606;1302;48833;25952;3.0;1.6
92;2021-02-25;910;1816;49743;27768;3.1;1.7
92;2021-02-26;1445;1368;51188;29136;3.2;1.8
92;2021-02-27;493;189;51681;29325;3.2;1.8
92;2021-02-28;59;55;51740;29380;3.2;1.8
92;2021-03-01;1089;1045;52829;30425;3.3;1.9
92;2021-03-02;1960;1366;54789;31791;3.4;2.0
92;2021-03-03;2782;1096;57571;32887;3.6;2.0
92;2021-03-04;3581;1522;61152;34409;3.8;2.1
92;2021-03-05;4969;1716;66121;36125;4.1;2.2
92;2021-03-06;5710;323;71831;36448;4.5;2.3
92;2021-03-07;2894;231;74725;36679;4.6;2.3
92;2021-03-08;2405;815;77130;37494;4.8;2.3
92;2021-03-09;3432;1023;80562;38517;5.0;2.4
92;2021-03-10;3925;937;84487;39454;5.2;2.4
92;2021-03-11;5003;1385;89490;40839;5.5;2.5
92;2021-03-12;6757;1545;96247;42384;6.0;2.6
92;2021-03-13;5148;219;101395;42603;6.3;2.6
92;2021-03-14;1734;71;103129;42674;6.4;2.6
92;2021-03-15;3783;588;106912;43262;6.6;2.7
92;2021-03-16;3684;584;110596;43846;6.9;2.7
92;2021-03-17;3865;412;114461;44258;7.1;2.7
92;2021-03-18;4116;740;118577;44998;7.3;2.8
92;2021-03-19;5909;706;124486;45704;7.7;2.8
92;2021-03-20;2533;72;127019;45776;7.9;2.8
92;2021-03-21;140;30;127159;45806;7.9;2.8
92;2021-03-22;4110;478;131269;46284;8.1;2.9
92;2021-03-23;6088;869;137357;47153;8.5;2.9
92;2021-03-24;6366;640;143723;47793;8.9;3.0
92;2021-03-25;8426;627;152149;48420;9.4;3.0
92;2021-03-26;8349;893;160498;49313;9.9;3.1
92;2021-03-27;2826;266;163324;49579;10.1;3.1
92;2021-03-28;536;38;163860;49617;10.2;3.1
92;2021-03-29;4655;1056;168515;50673;10.4;3.1
92;2021-03-30;6380;1544;174895;52217;10.8;3.2
92;2021-03-31;5527;2252;180422;54469;11.2;3.4
92;2021-04-01;6252;3678;186674;58147;11.6;3.6
92;2021-04-02;5625;3412;192299;61559;11.9;3.8
92;2021-04-03;870;1417;193169;62976;12.0;3.9
92;2021-04-04;481;1062;193650;64038;12.0;4.0
92;2021-04-05;808;156;194458;64194;12.0;4.0
92;2021-04-06;3637;1954;198095;66148;12.3;4.1
92;2021-04-07;4986;2883;203081;69031;12.6;4.3
92;2021-04-08;5962;3174;209043;72205;13.0;4.5
92;2021-04-09;8026;3035;217069;75240;13.5;4.7
92;2021-04-10;2627;1292;219696;76532;13.6;4.7
92;2021-04-11;150;806;219846;77338;13.6;4.8
92;2021-04-12;3669;2519;223515;79857;13.9;4.9
92;2021-04-13;4375;4429;227890;84286;14.1;5.2
92;2021-04-14;4862;4037;232752;88323;14.4;5.5
92;2021-04-15;5293;3954;238045;92277;14.8;5.7
92;2021-04-16;5039;3855;243084;96132;15.1;6.0
92;2021-04-17;1796;1191;244880;97323;15.2;6.0
92;2021-04-18;340;94;245220;97417;15.2;6.0
92;2021-04-19;2800;2840;248020;100257;15.4;6.2
92;2021-04-20;4187;3754;252207;104011;15.6;6.4
92;2021-04-21;4607;4515;256814;108526;15.9;6.7
92;2021-04-22;4656;5121;261470;113647;16.2;7.0
92;2021-04-23;5220;4677;266690;118324;16.5;7.3
92;2021-04-24;4936;1907;271626;120231;16.8;7.5
92;2021-04-25;1788;150;273414;120381;16.9;7.5
92;2021-04-26;3991;3622;277405;124003;17.2;7.7
92;2021-04-27;6040;5260;283445;129263;17.6;8.0
92;2021-04-28;7376;4499;290821;133762;18.0;8.3
92;2021-04-29;7983;4781;298804;138543;18.5;8.6
92;2021-04-30;8837;4836;307641;143379;19.1;8.9
92;2021-05-01;1199;407;308840;143786;19.1;8.9
92;2021-05-02;661;138;309501;143924;19.2;8.9
92;2021-05-03;6774;3891;316275;147815;19.6;9.2
92;2021-05-04;10408;4367;326683;152182;20.2;9.4
92;2021-05-05;10070;5260;336753;157442;20.9;9.8
92;2021-05-06;11422;4908;348175;162350;21.6;10.1
92;2021-05-07;9854;5288;358029;167638;22.2;10.4
92;2021-05-08;7209;1928;365238;169566;22.6;10.5
92;2021-05-09;3786;601;369024;170167;22.9;10.5
92;2021-05-10;9527;3998;378551;174165;23.5;10.8
92;2021-05-11;13974;5692;392525;179857;24.3;11.1
92;2021-05-12;14267;4584;406792;184441;25.2;11.4
92;2021-05-13;9159;911;415951;185352;25.8;11.5
92;2021-05-14;12021;2313;427972;187665;26.5;11.6
92;2021-05-15;8384;1229;436356;188894;27.0;11.7
92;2021-05-16;4133;448;440489;189342;27.3;11.7
92;2021-05-17;10642;2218;451131;191560;28.0;11.9
92;2021-05-18;16379;3126;467510;194686;29.0;12.1
92;2021-05-19;16019;3720;483529;198406;30.0;12.3
92;2021-05-20;16823;3980;500352;202386;31.0;12.5
92;2021-05-21;14074;3638;514426;206024;31.9;12.8
92;2021-05-22;8312;1520;522738;207544;32.4;12.9
92;2021-05-23;4082;454;526820;207998;32.6;12.9
92;2021-05-24;6116;854;532936;208852;33.0;12.9
92;2021-05-25;13102;4555;546038;213407;33.8;13.2
92;2021-05-26;11920;5042;557958;218449;34.6;13.5
92;2021-05-27;12728;6325;570686;224774;35.4;13.9
92;2021-05-28;11222;6279;581908;231053;36.1;14.3
92;2021-05-29;5444;2300;587352;233353;36.4;14.5
92;2021-05-30;2248;387;589600;233740;36.5;14.5
92;2021-05-31;12049;5305;601649;239045;37.3;14.8
92;2021-06-01;12582;7641;614231;246686;38.1;15.3
92;2021-06-02;14363;7213;628594;253899;39.0;15.7
92;2021-06-03;14578;8020;643172;261919;39.9;16.2
92;2021-06-04;12220;8227;655392;270146;40.6;16.7
92;2021-06-05;7383;6256;662775;276402;41.1;17.1
92;2021-06-06;3588;1677;666363;278079;41.3;17.2
92;2021-06-07;11436;7629;677799;285708;42.0;17.7
92;2021-06-08;12753;9595;690552;295303;42.8;18.3
92;2021-06-09;11637;9472;702189;304775;43.5;18.9
92;2021-06-10;11943;10560;714132;315335;44.3;19.5
92;2021-06-11;8144;11035;722276;326370;44.8;20.2
92;2021-06-12;6358;5096;728634;331466;45.2;20.5
92;2021-06-13;3963;2719;732597;334185;45.4;20.7
92;2021-06-14;5126;11166;737723;345351;45.7;21.4
92;2021-06-15;6479;13128;744202;358479;46.1;22.2
92;2021-06-16;6940;12991;751142;371470;46.5;23.0
92;2021-06-17;7411;14012;758553;385482;47.0;23.9
92;2021-06-18;6895;14389;765448;399871;47.4;24.8
92;2021-06-19;3958;9109;769406;408980;47.7;25.3
92;2021-06-20;1960;5611;771366;414591;47.8;25.7
92;2021-06-21;4816;12272;776182;426863;48.1;26.5
92;2021-06-22;5864;17552;782046;444415;48.5;27.5
92;2021-06-23;5473;16000;787519;460415;48.8;28.5
92;2021-06-24;6190;15123;793709;475538;49.2;29.5
92;2021-06-25;5103;16098;798812;491636;49.5;30.5
92;2021-06-26;4066;10456;802878;502092;49.8;31.1
92;2021-06-27;1859;6051;804737;508143;49.9;31.5
92;2021-06-28;3666;12049;808403;520192;50.1;32.2
92;2021-06-29;4671;18155;813074;538347;50.4;33.4
92;2021-06-30;4407;16211;817481;554558;50.7;34.4
92;2021-07-01;5442;16299;822923;570857;51.0;35.4
92;2021-07-02;4796;15276;827719;586133;51.3;36.3
92;2021-07-03;3296;10183;831015;596316;51.5;37.0
92;2021-07-04;1114;4205;832129;600521;51.6;37.2
92;2021-07-05;4768;12323;836897;612844;51.9;38.0
92;2021-07-06;5210;15794;842107;628638;52.2;39.0
92;2021-07-07;4232;11446;846339;640084;52.4;39.7
92;2021-07-08;5393;14633;851732;654717;52.8;40.6
92;2021-07-09;5850;14192;857582;668909;53.1;41.5
92;2021-07-10;4201;8431;861783;677340;53.4;42.0
92;2021-07-11;1464;2618;863247;679958;53.5;42.1
92;2021-07-12;4342;14621;867589;694579;53.8;43.0
92;2021-07-13;7818;17437;875407;712016;54.2;44.1
92;2021-07-14;5056;5728;880463;717744;54.6;44.5
92;2021-07-15;9511;16237;889974;733981;55.1;45.5
92;2021-07-16;8983;14151;898957;748132;55.7;46.4
92;2021-07-17;6496;7589;905453;755721;56.1;46.8
92;2021-07-18;1812;2478;907265;758199;56.2;47.0
92;2021-07-19;6420;13179;913685;771378;56.6;47.8
92;2021-07-20;9951;14059;923636;785437;57.2;48.7
92;2021-07-21;10349;12064;933985;797501;57.9;49.4
92;2021-07-22;11881;12922;945866;810423;58.6;50.2
92;2021-07-23;11491;11302;957357;821725;59.3;50.9
92;2021-07-24;6581;6207;963938;827932;59.7;51.3
92;2021-07-25;2755;2301;966693;830233;59.9;51.4
92;2021-07-26;9409;9130;976102;839363;60.5;52.0
92;2021-07-27;11393;9549;987495;848912;61.2;52.6
92;2021-07-28;11266;8082;998761;856994;61.9;53.1
92;2021-07-29;10344;8558;1009105;865552;62.5;53.6
92;2021-07-30;8961;8275;1018066;873827;63.1;54.1
92;2021-07-31;5664;4778;1023730;878605;63.4;54.4
92;2021-08-01;2173;1276;1025903;879881;63.6;54.5
92;2021-08-02;4594;4880;1030497;884761;63.9;54.8
92;2021-08-03;5034;6103;1035531;890864;64.2;55.2
92;2021-08-04;4611;4816;1040142;895680;64.5;55.5
92;2021-08-05;4312;5588;1044454;901268;64.7;55.8
93;2020-12-27;10;3;10;3;0.0;0.0
93;2020-12-28;3;0;13;3;0.0;0.0
93;2020-12-29;0;0;13;3;0.0;0.0
93;2020-12-30;43;0;56;3;0.0;0.0
93;2020-12-31;9;0;65;3;0.0;0.0
93;2021-01-01;5;0;70;3;0.0;0.0
93;2021-01-02;0;0;70;3;0.0;0.0
93;2021-01-03;3;0;73;3;0.0;0.0
93;2021-01-04;0;0;73;3;0.0;0.0
93;2021-01-05;59;0;132;3;0.0;0.0
93;2021-01-06;179;0;311;3;0.0;0.0
93;2021-01-07;378;3;689;6;0.0;0.0
93;2021-01-08;631;1;1320;7;0.1;0.0
93;2021-01-09;21;0;1341;7;0.1;0.0
93;2021-01-10;2;0;1343;7;0.1;0.0
93;2021-01-11;501;4;1844;11;0.1;0.0
93;2021-01-12;752;7;2596;18;0.2;0.0
93;2021-01-13;750;4;3346;22;0.2;0.0
93;2021-01-14;682;18;4028;40;0.2;0.0
93;2021-01-15;514;3;4542;43;0.3;0.0
93;2021-01-16;139;3;4681;46;0.3;0.0
93;2021-01-17;6;1;4687;47;0.3;0.0
93;2021-01-18;1196;8;5883;55;0.4;0.0
93;2021-01-19;1612;16;7495;71;0.4;0.0
93;2021-01-20;1555;11;9050;82;0.5;0.0
93;2021-01-21;1916;17;10966;99;0.7;0.0
93;2021-01-22;1384;14;12350;113;0.7;0.0
93;2021-01-23;711;8;13061;121;0.8;0.0
93;2021-01-24;0;0;13061;121;0.8;0.0
93;2021-01-25;1203;15;14264;136;0.9;0.0
93;2021-01-26;1290;36;15554;172;0.9;0.0
93;2021-01-27;2154;57;17708;229;1.1;0.0
93;2021-01-28;2261;203;19969;432;1.2;0.0
93;2021-01-29;1619;228;21588;660;1.3;0.0
93;2021-01-30;926;46;22514;706;1.3;0.0
93;2021-01-31;5;7;22519;713;1.3;0.0
93;2021-02-01;1178;171;23697;884;1.4;0.1
93;2021-02-02;1165;312;24862;1196;1.5;0.1
93;2021-02-03;1229;399;26091;1595;1.6;0.1
93;2021-02-04;922;566;27013;2161;1.6;0.1
93;2021-02-05;797;433;27810;2594;1.7;0.2
93;2021-02-06;693;70;28503;2664;1.7;0.2
93;2021-02-07;3;0;28506;2664;1.7;0.2
93;2021-02-08;910;647;29416;3311;1.8;0.2
93;2021-02-09;851;600;30267;3911;1.8;0.2
93;2021-02-10;879;678;31146;4589;1.9;0.3
93;2021-02-11;1240;831;32386;5420;1.9;0.3
93;2021-02-12;1041;639;33427;6059;2.0;0.4
93;2021-02-13;393;263;33820;6322;2.0;0.4
93;2021-02-14;13;59;33833;6381;2.0;0.4
93;2021-02-15;411;1280;34244;7661;2.1;0.5
93;2021-02-16;547;1239;34791;8900;2.1;0.5
93;2021-02-17;544;1771;35335;10671;2.1;0.6
93;2021-02-18;1132;1877;36467;12548;2.2;0.8
93;2021-02-19;992;1542;37459;14090;2.2;0.8
93;2021-02-20;304;667;37763;14757;2.3;0.9
93;2021-02-21;8;23;37771;14780;2.3;0.9
93;2021-02-22;601;1298;38372;16078;2.3;1.0
93;2021-02-23;563;1128;38935;17206;2.3;1.0
93;2021-02-24;642;1228;39577;18434;2.4;1.1
93;2021-02-25;900;1079;40477;19513;2.4;1.2
93;2021-02-26;1120;983;41597;20496;2.5;1.2
93;2021-02-27;543;624;42140;21120;2.5;1.3
93;2021-02-28;88;57;42228;21177;2.5;1.3
93;2021-03-01;1083;1074;43311;22251;2.6;1.3
93;2021-03-02;1443;1147;44754;23398;2.7;1.4
93;2021-03-03;1737;1189;46491;24587;2.8;1.5
93;2021-03-04;2712;1115;49203;25702;2.9;1.5
93;2021-03-05;3813;887;53016;26589;3.2;1.6
93;2021-03-06;5047;559;58063;27148;3.5;1.6
93;2021-03-07;4299;194;62362;27342;3.7;1.6
93;2021-03-08;2033;1253;64395;28595;3.9;1.7
93;2021-03-09;2914;957;67309;29552;4.0;1.8
93;2021-03-10;2856;1099;70165;30651;4.2;1.8
93;2021-03-11;3548;1230;73713;31881;4.4;1.9
93;2021-03-12;4127;1275;77840;33156;4.7;2.0
93;2021-03-13;4289;620;82129;33776;4.9;2.0
93;2021-03-14;876;63;83005;33839;5.0;2.0
93;2021-03-15;3551;678;86556;34517;5.2;2.1
93;2021-03-16;3156;615;89712;35132;5.4;2.1
93;2021-03-17;2648;596;92360;35728;5.5;2.1
93;2021-03-18;3310;719;95670;36447;5.7;2.2
93;2021-03-19;3762;636;99432;37083;6.0;2.2
93;2021-03-20;3461;281;102893;37364;6.2;2.2
93;2021-03-21;813;269;103706;37633;6.2;2.3
93;2021-03-22;3846;607;107552;38240;6.4;2.3
93;2021-03-23;4751;793;112303;39033;6.7;2.3
93;2021-03-24;4110;675;116413;39708;7.0;2.4
93;2021-03-25;5573;836;121986;40544;7.3;2.4
93;2021-03-26;5547;881;127533;41425;7.6;2.5
93;2021-03-27;4280;301;131813;41726;7.9;2.5
93;2021-03-28;611;40;132424;41766;7.9;2.5
93;2021-03-29;3855;955;136279;42721;8.2;2.6
93;2021-03-30;4725;1258;141004;43979;8.4;2.6
93;2021-03-31;3909;1234;144913;45213;8.7;2.7
93;2021-04-01;4052;3136;148965;48349;8.9;2.9
93;2021-04-02;3218;3551;152183;51900;9.1;3.1
93;2021-04-03;2520;2250;154703;54150;9.3;3.2
93;2021-04-04;762;156;155465;54306;9.3;3.3
93;2021-04-05;707;88;156172;54394;9.4;3.3
93;2021-04-06;4559;2335;160731;56729;9.6;3.4
93;2021-04-07;4901;2085;165632;58814;9.9;3.5
93;2021-04-08;5809;2678;171441;61492;10.3;3.7
93;2021-04-09;6089;3165;177530;64657;10.6;3.9
93;2021-04-10;4196;2479;181726;67136;10.9;4.0
93;2021-04-11;576;427;182302;67563;10.9;4.0
93;2021-04-12;4096;2926;186398;70489;11.2;4.2
93;2021-04-13;4602;3654;191000;74143;11.4;4.4
93;2021-04-14;4360;2474;195360;76617;11.7;4.6
93;2021-04-15;4559;3024;199919;79641;12.0;4.8
93;2021-04-16;4435;2986;204354;82627;12.2;4.9
93;2021-04-17;3514;2507;207868;85134;12.4;5.1
93;2021-04-18;289;435;208157;85569;12.5;5.1
93;2021-04-19;3772;2855;211929;88424;12.7;5.3
93;2021-04-20;4304;3272;216233;91696;12.9;5.5
93;2021-04-21;4140;2764;220373;94460;13.2;5.7
93;2021-04-22;4510;4012;224883;98472;13.5;5.9
93;2021-04-23;5621;3226;230504;101698;13.8;6.1
93;2021-04-24;5925;3321;236429;105019;14.2;6.3
93;2021-04-25;1732;589;238161;105608;14.3;6.3
93;2021-04-26;4856;3078;243017;108686;14.6;6.5
93;2021-04-27;6453;3630;249470;112316;14.9;6.7
93;2021-04-28;6074;3424;255544;115740;15.3;6.9
93;2021-04-29;7300;3237;262844;118977;15.7;7.1
93;2021-04-30;8259;3108;271103;122085;16.2;7.3
93;2021-05-01;4945;1185;276048;123270;16.5;7.4
93;2021-05-02;417;647;276465;123917;16.6;7.4
93;2021-05-03;8161;5109;284626;129026;17.0;7.7
93;2021-05-04;7826;5404;292452;134430;17.5;8.0
93;2021-05-05;7573;4799;300025;139229;18.0;8.3
93;2021-05-06;8237;4769;308262;143998;18.5;8.6
93;2021-05-07;7002;5420;315264;149418;18.9;8.9
93;2021-05-08;8353;2386;323617;151804;19.4;9.1
93;2021-05-09;6120;1366;329737;153170;19.7;9.2
93;2021-05-10;8247;4064;337984;157234;20.2;9.4
93;2021-05-11;9298;4806;347282;162040;20.8;9.7
93;2021-05-12;9177;3654;356459;165694;21.3;9.9
93;2021-05-13;8289;1654;364748;167348;21.8;10.0
93;2021-05-14;10420;3533;375168;170881;22.5;10.2
93;2021-05-15;11128;2998;386296;173879;23.1;10.4
93;2021-05-16;5556;727;391852;174606;23.5;10.5
93;2021-05-17;11898;2254;403750;176860;24.2;10.6
93;2021-05-18;14097;2388;417847;179248;25.0;10.7
93;2021-05-19;11433;2941;429280;182189;25.7;10.9
93;2021-05-20;12617;3476;441897;185665;26.5;11.1
93;2021-05-21;13007;2881;454904;188546;27.2;11.3
93;2021-05-22;12383;2204;467287;190750;28.0;11.4
93;2021-05-23;8481;1104;475768;191854;28.5;11.5
93;2021-05-24;11194;1942;486962;193796;29.2;11.6
93;2021-05-25;12285;4310;499247;198106;29.9;11.9
93;2021-05-26;11061;3740;510308;201846;30.6;12.1
93;2021-05-27;12695;3873;523003;205719;31.3;12.3
93;2021-05-28;12650;5253;535653;210972;32.1;12.6
93;2021-05-29;11390;4256;547043;215228;32.8;12.9
93;2021-05-30;8213;1371;555256;216599;33.2;13.0
93;2021-05-31;9174;5169;564430;221768;33.8;13.3
93;2021-06-01;11350;6269;575780;228037;34.5;13.7
93;2021-06-02;10648;5188;586428;233225;35.1;14.0
93;2021-06-03;10774;5509;597202;238734;35.8;14.3
93;2021-06-04;10567;7798;607769;246532;36.4;14.8
93;2021-06-05;8997;7345;616766;253877;36.9;15.2
93;2021-06-06;8391;1739;625157;255616;37.4;15.3
93;2021-06-07;10028;7511;635185;263127;38.0;15.8
93;2021-06-08;10349;7375;645534;270502;38.7;16.2
93;2021-06-09;10212;7283;655746;277785;39.3;16.6
93;2021-06-10;8897;8169;664643;285954;39.8;17.1
93;2021-06-11;8801;8808;673444;294762;40.3;17.6
93;2021-06-12;9855;6639;683299;301401;40.9;18.0
93;2021-06-13;7160;2116;690459;303517;41.3;18.2
93;2021-06-14;5366;9723;695825;313240;41.7;18.8
93;2021-06-15;6214;9651;702039;322891;42.0;19.3
93;2021-06-16;6629;9052;708668;331943;42.4;19.9
93;2021-06-17;5722;8460;714390;340403;42.8;20.4
93;2021-06-18;7189;11127;721579;351530;43.2;21.0
93;2021-06-19;7066;11088;728645;362618;43.6;21.7
93;2021-06-20;4947;6867;733592;369485;43.9;22.1
93;2021-06-21;4063;10723;737655;380208;44.2;22.8
93;2021-06-22;4658;11301;742313;391509;44.4;23.4
93;2021-06-23;4523;10593;746836;402102;44.7;24.1
93;2021-06-24;4178;10297;751014;412399;45.0;24.7
93;2021-06-25;5146;13054;756160;425453;45.3;25.5
93;2021-06-26;5290;13917;761450;439370;45.6;26.3
93;2021-06-27;3280;7111;764730;446481;45.8;26.7
93;2021-06-28;3678;12501;768408;458982;46.0;27.5
93;2021-06-29;3992;12337;772400;471319;46.2;28.2
93;2021-06-30;4097;11292;776497;482611;46.5;28.9
93;2021-07-01;5240;11123;781737;493734;46.8;29.6
93;2021-07-02;4768;12341;786505;506075;47.1;30.3
93;2021-07-03;5300;13432;791805;519507;47.4;31.1
93;2021-07-04;3077;7883;794882;527390;47.6;31.6
93;2021-07-05;4407;10831;799289;538221;47.9;32.2
93;2021-07-06;4591;11753;803880;549974;48.1;32.9
93;2021-07-07;4897;11400;808777;561374;48.4;33.6
93;2021-07-08;4854;10260;813631;571634;48.7;34.2
93;2021-07-09;5459;13012;819090;584646;49.0;35.0
93;2021-07-10;5831;14270;824921;598916;49.4;35.9
93;2021-07-11;3675;9085;828596;608001;49.6;36.4
93;2021-07-12;5356;12060;833952;620061;49.9;37.1
93;2021-07-13;10915;13255;844867;633316;50.6;37.9
93;2021-07-14;10524;6750;855391;640066;51.2;38.3
93;2021-07-15;12159;14080;867550;654146;51.9;39.2
93;2021-07-16;12902;13634;880452;667780;52.7;40.0
93;2021-07-17;11180;13859;891632;681639;53.4;40.8
93;2021-07-18;7307;8915;898939;690554;53.8;41.3
93;2021-07-19;9476;10875;908415;701429;54.4;42.0
93;2021-07-20;12438;10627;920853;712056;55.1;42.6
93;2021-07-21;14021;10859;934874;722915;56.0;43.3
93;2021-07-22;13927;9368;948801;732283;56.8;43.8
93;2021-07-23;14285;10577;963086;742860;57.7;44.5
93;2021-07-24;13747;10563;976833;753423;58.5;45.1
93;2021-07-25;8866;6273;985699;759696;59.0;45.5
93;2021-07-26;12334;7693;998033;767389;59.8;45.9
93;2021-07-27;14462;7290;1012495;774679;60.6;46.4
93;2021-07-28;14623;8125;1027118;782804;61.5;46.9
93;2021-07-29;13174;6943;1040292;789747;62.3;47.3
93;2021-07-30;13557;7731;1053849;797478;63.1;47.7
93;2021-07-31;11955;7603;1065804;805081;63.8;48.2
93;2021-08-01;7117;4521;1072921;809602;64.2;48.5
93;2021-08-02;7499;5635;1080420;815237;64.7;48.8
93;2021-08-03;6966;6777;1087386;822014;65.1;49.2
93;2021-08-04;7289;7896;1094675;829910;65.5;49.7
93;2021-08-05;5505;6741;1100180;836651;65.9;50.1
94;2020-12-27;5;0;5;0;0.0;0.0
94;2020-12-28;10;0;15;0;0.0;0.0
94;2020-12-29;0;0;15;0;0.0;0.0
94;2020-12-30;1;0;16;0;0.0;0.0
94;2020-12-31;4;0;20;0;0.0;0.0
94;2021-01-01;4;0;24;0;0.0;0.0
94;2021-01-02;0;0;24;0;0.0;0.0
94;2021-01-03;2;0;26;0;0.0;0.0
94;2021-01-04;35;2;61;2;0.0;0.0
94;2021-01-05;231;2;292;4;0.0;0.0
94;2021-01-06;330;4;622;8;0.0;0.0
94;2021-01-07;690;9;1312;17;0.1;0.0
94;2021-01-08;921;10;2233;27;0.2;0.0
94;2021-01-09;47;0;2280;27;0.2;0.0
94;2021-01-10;18;0;2298;27;0.2;0.0
94;2021-01-11;1013;10;3311;37;0.2;0.0
94;2021-01-12;1342;27;4653;64;0.3;0.0
94;2021-01-13;1408;24;6061;88;0.4;0.0
94;2021-01-14;1536;26;7597;114;0.5;0.0
94;2021-01-15;1219;22;8816;136;0.6;0.0
94;2021-01-16;197;2;9013;138;0.6;0.0
94;2021-01-17;94;1;9107;139;0.6;0.0
94;2021-01-18;1488;28;10595;167;0.8;0.0
94;2021-01-19;1949;26;12544;193;0.9;0.0
94;2021-01-20;2179;19;14723;212;1.0;0.0
94;2021-01-21;2999;16;17722;228;1.3;0.0
94;2021-01-22;2173;19;19895;247;1.4;0.0
94;2021-01-23;729;3;20624;250;1.5;0.0
94;2021-01-24;284;0;20908;250;1.5;0.0
94;2021-01-25;1467;18;22375;268;1.6;0.0
94;2021-01-26;1558;18;23933;286;1.7;0.0
94;2021-01-27;1802;25;25735;311;1.8;0.0
94;2021-01-28;1533;134;27268;445;1.9;0.0
94;2021-01-29;1380;150;28648;595;2.0;0.0
94;2021-01-30;579;4;29227;599;2.1;0.0
94;2021-01-31;119;8;29346;607;2.1;0.0
94;2021-02-01;925;154;30271;761;2.2;0.1
94;2021-02-02;852;252;31123;1013;2.2;0.1
94;2021-02-03;759;371;31882;1384;2.3;0.1
94;2021-02-04;901;434;32783;1818;2.3;0.1
94;2021-02-05;873;575;33656;2393;2.4;0.2
94;2021-02-06;405;76;34061;2469;2.4;0.2
94;2021-02-07;120;0;34181;2469;2.4;0.2
94;2021-02-08;634;551;34815;3020;2.5;0.2
94;2021-02-09;1035;990;35850;4010;2.5;0.3
94;2021-02-10;1098;1373;36948;5383;2.6;0.4
94;2021-02-11;1426;1559;38374;6942;2.7;0.5
94;2021-02-12;1387;1659;39761;8601;2.8;0.6
94;2021-02-13;300;263;40061;8864;2.8;0.6
94;2021-02-14;29;72;40090;8936;2.9;0.6
94;2021-02-15;751;1778;40841;10714;2.9;0.8
94;2021-02-16;702;2761;41543;13475;3.0;1.0
94;2021-02-17;713;1591;42256;15066;3.0;1.1
94;2021-02-18;786;1719;43042;16785;3.1;1.2
94;2021-02-19;960;1471;44002;18256;3.1;1.3
94;2021-02-20;134;923;44136;19179;3.1;1.4
94;2021-02-21;20;185;44156;19364;3.1;1.4
94;2021-02-22;520;1354;44676;20718;3.2;1.5
94;2021-02-23;627;1286;45303;22004;3.2;1.6
94;2021-02-24;692;926;45995;22930;3.3;1.6
94;2021-02-25;1068;1572;47063;24502;3.3;1.7
94;2021-02-26;1320;1076;48383;25578;3.4;1.8
94;2021-02-27;516;554;48899;26132;3.5;1.9
94;2021-02-28;91;84;48990;26216;3.5;1.9
94;2021-03-01;880;947;49870;27163;3.5;1.9
94;2021-03-02;1567;996;51437;28159;3.7;2.0
94;2021-03-03;1945;1023;53382;29182;3.8;2.1
94;2021-03-04;2855;1188;56237;30370;4.0;2.2
94;2021-03-05;3829;1346;60066;31716;4.3;2.3
94;2021-03-06;4812;578;64878;32294;4.6;2.3
94;2021-03-07;3686;559;68564;32853;4.9;2.3
94;2021-03-08;1913;804;70477;33657;5.0;2.4
94;2021-03-09;2547;930;73024;34587;5.2;2.5
94;2021-03-10;3193;1038;76217;35625;5.4;2.5
94;2021-03-11;3833;938;80050;36563;5.7;2.6
94;2021-03-12;4570;816;84620;37379;6.0;2.7
94;2021-03-13;4126;390;88746;37769;6.3;2.7
94;2021-03-14;2113;149;90859;37918;6.5;2.7
94;2021-03-15;3166;786;94025;38704;6.7;2.8
94;2021-03-16;2772;447;96797;39151;6.9;2.8
94;2021-03-17;2857;455;99654;39606;7.1;2.8
94;2021-03-18;3259;435;102913;40041;7.3;2.8
94;2021-03-19;4269;708;107182;40749;7.6;2.9
94;2021-03-20;3692;292;110874;41041;7.9;2.9
94;2021-03-21;1461;388;112335;41429;8.0;2.9
94;2021-03-22;3217;675;115552;42104;8.2;3.0
94;2021-03-23;4511;734;120063;42838;8.5;3.0
94;2021-03-24;4624;620;124687;43458;8.9;3.1
94;2021-03-25;6320;663;131007;44121;9.3;3.1
94;2021-03-26;6085;838;137092;44959;9.8;3.2
94;2021-03-27;4472;269;141564;45228;10.1;3.2
94;2021-03-28;1887;109;143451;45337;10.2;3.2
94;2021-03-29;4123;1224;147574;46561;10.5;3.3
94;2021-03-30;5297;1352;152871;47913;10.9;3.4
94;2021-03-31;4900;1811;157771;49724;11.2;3.5
94;2021-04-01;5816;2316;163587;52040;11.6;3.7
94;2021-04-02;5243;2330;168830;54370;12.0;3.9
94;2021-04-03;3088;2521;171918;56891;12.2;4.0
94;2021-04-04;1052;780;172970;57671;12.3;4.1
94;2021-04-05;833;158;173803;57829;12.4;4.1
94;2021-04-06;3573;2606;177376;60435;12.6;4.3
94;2021-04-07;3854;2262;181230;62697;12.9;4.5
94;2021-04-08;4620;2055;185850;64752;13.2;4.6
94;2021-04-09;5358;2478;191208;67230;13.6;4.8
94;2021-04-10;2958;3006;194166;70236;13.8;5.0
94;2021-04-11;1265;1765;195431;72001;13.9;5.1
94;2021-04-12;3439;2279;198870;74280;14.1;5.3
94;2021-04-13;4308;3427;203178;77707;14.5;5.5
94;2021-04-14;3897;2691;207075;80398;14.7;5.7
94;2021-04-15;4439;2985;211514;83383;15.0;5.9
94;2021-04-16;4700;2840;216214;86223;15.4;6.1
94;2021-04-17;2460;2767;218674;88990;15.6;6.3
94;2021-04-18;918;1250;219592;90240;15.6;6.4
94;2021-04-19;2974;2437;222566;92677;15.8;6.6
94;2021-04-20;3270;2711;225836;95388;16.1;6.8
94;2021-04-21;3217;3155;229053;98543;16.3;7.0
94;2021-04-22;3907;3644;232960;102187;16.6;7.3
94;2021-04-23;4112;3987;237072;106174;16.9;7.6
94;2021-04-24;4264;3399;241336;109573;17.2;7.8
94;2021-04-25;2409;1500;243745;111073;17.3;7.9
94;2021-04-26;4007;3273;247752;114346;17.6;8.1
94;2021-04-27;5091;3365;252843;117711;18.0;8.4
94;2021-04-28;4828;3628;257671;121339;18.3;8.6
94;2021-04-29;6411;3812;264082;125151;18.8;8.9
94;2021-04-30;6480;3929;270562;129080;19.2;9.2
94;2021-05-01;4057;1059;274619;130139;19.5;9.3
94;2021-05-02;3054;1473;277673;131612;19.7;9.4
94;2021-05-03;5734;5348;283407;136960;20.2;9.7
94;2021-05-04;6100;3569;289507;140529;20.6;10.0
94;2021-05-05;6178;3421;295685;143950;21.0;10.2
94;2021-05-06;7151;3525;302836;147475;21.5;10.5
94;2021-05-07;6667;4120;309503;151595;22.0;10.8
94;2021-05-08;4894;2547;314397;154142;22.4;11.0
94;2021-05-09;4224;2242;318621;156384;22.7;11.1
94;2021-05-10;7715;3127;326336;159511;23.2;11.3
94;2021-05-11;8972;3931;335308;163442;23.8;11.6
94;2021-05-12;9569;3604;344877;167046;24.5;11.9
94;2021-05-13;8675;1371;353552;168417;25.1;12.0
94;2021-05-14;9867;3321;363419;171738;25.8;12.2
94;2021-05-15;8942;2165;372361;173903;26.5;12.4
94;2021-05-16;5069;907;377430;174810;26.8;12.4
94;2021-05-17;10836;2246;388266;177056;27.6;12.6
94;2021-05-18;11294;2449;399560;179505;28.4;12.8
94;2021-05-19;11669;3594;411229;183099;29.2;13.0
94;2021-05-20;12145;4363;423374;187462;30.1;13.3
94;2021-05-21;11866;3152;435240;190614;31.0;13.6
94;2021-05-22;10293;1970;445533;192584;31.7;13.7
94;2021-05-23;5000;710;450533;193294;32.0;13.7
94;2021-05-24;9658;1346;460191;194640;32.7;13.8
94;2021-05-25;9995;4259;470186;198899;33.4;14.1
94;2021-05-26;10272;3304;480458;202203;34.2;14.4
94;2021-05-27;10859;4582;491317;206785;34.9;14.7
94;2021-05-28;10446;4954;501763;211739;35.7;15.1
94;2021-05-29;9872;3451;511635;215190;36.4;15.3
94;2021-05-30;4786;926;516421;216116;36.7;15.4
94;2021-05-31;9978;4237;526399;220353;37.4;15.7
94;2021-06-01;10249;5104;536648;225457;38.2;16.0
94;2021-06-02;9314;4583;545962;230040;38.8;16.4
94;2021-06-03;9533;5595;555495;235635;39.5;16.8
94;2021-06-04;10373;6527;565868;242162;40.2;17.2
94;2021-06-05;9199;6257;575067;248419;40.9;17.7
94;2021-06-06;3978;1849;579045;250268;41.2;17.8
94;2021-06-07;8659;5970;587704;256238;41.8;18.2
94;2021-06-08;8989;7523;596693;263761;42.4;18.8
94;2021-06-09;8920;8157;605613;271918;43.1;19.3
94;2021-06-10;8779;10980;614392;282898;43.7;20.1
94;2021-06-11;7821;8384;622213;291282;44.3;20.7
94;2021-06-12;10253;6831;632466;298113;45.0;21.2
94;2021-06-13;3468;3255;635934;301368;45.2;21.4
94;2021-06-14;6928;8214;642862;309582;45.7;22.0
94;2021-06-15;7713;8812;650575;318394;46.3;22.6
94;2021-06-16;7227;8269;657802;326663;46.8;23.2
94;2021-06-17;6685;9064;664487;335727;47.3;23.9
94;2021-06-18;6461;11953;670948;347680;47.7;24.7
94;2021-06-19;6009;9576;676957;357256;48.1;25.4
94;2021-06-20;1889;4008;678846;361264;48.3;25.7
94;2021-06-21;4472;11187;683318;372451;48.6;26.5
94;2021-06-22;4822;10815;688140;383266;48.9;27.3
94;2021-06-23;4161;11152;692301;394418;49.2;28.1
94;2021-06-24;4953;10326;697254;404744;49.6;28.8
94;2021-06-25;4261;13732;701515;418476;49.9;29.8
94;2021-06-26;3133;11985;704648;430461;50.1;30.6
94;2021-06-27;1057;5000;705705;435461;50.2;31.0
94;2021-06-28;3467;12076;709172;447537;50.4;31.8
94;2021-06-29;4023;12175;713195;459712;50.7;32.7
94;2021-06-30;3976;11621;717171;471333;51.0;33.5
94;2021-07-01;4419;11091;721590;482424;51.3;34.3
94;2021-07-02;4385;12170;725975;494594;51.6;35.2
94;2021-07-03;3595;11797;729570;506391;51.9;36.0
94;2021-07-04;1510;5080;731080;511471;52.0;36.4
94;2021-07-05;3729;11414;734809;522885;52.3;37.2
94;2021-07-06;3812;10881;738621;533766;52.5;38.0
94;2021-07-07;4134;11061;742755;544827;52.8;38.7
94;2021-07-08;4524;10017;747279;554844;53.1;39.5
94;2021-07-09;4260;11833;751539;566677;53.5;40.3
94;2021-07-10;3730;11354;755269;578031;53.7;41.1
94;2021-07-11;1522;4716;756791;582747;53.8;41.4
94;2021-07-12;3564;11956;760355;594703;54.1;42.3
94;2021-07-13;5724;11990;766079;606693;54.5;43.1
94;2021-07-14;4005;5272;770084;611965;54.8;43.5
94;2021-07-15;6263;12337;776347;624302;55.2;44.4
94;2021-07-16;6729;11271;783076;635573;55.7;45.2
94;2021-07-17;5593;11308;788669;646881;56.1;46.0
94;2021-07-18;2585;4014;791254;650895;56.3;46.3
94;2021-07-19;5824;10415;797078;661310;56.7;47.0
94;2021-07-20;7782;10333;804860;671643;57.2;47.8
94;2021-07-21;8349;9510;813209;681153;57.8;48.4
94;2021-07-22;9269;9358;822478;690511;58.5;49.1
94;2021-07-23;8639;9353;831117;699864;59.1;49.8
94;2021-07-24;7104;8839;838221;708703;59.6;50.4
94;2021-07-25;2179;2734;840400;711437;59.8;50.6
94;2021-07-26;7616;8020;848016;719457;60.3;51.2
94;2021-07-27;8597;7069;856613;726526;60.9;51.7
94;2021-07-28;8761;6495;865374;733021;61.5;52.1
94;2021-07-29;8844;6281;874218;739302;62.2;52.6
94;2021-07-30;7678;6485;881896;745787;62.7;53.0
94;2021-07-31;7092;6245;888988;752032;63.2;53.5
94;2021-08-01;3143;1751;892131;753783;63.4;53.6
94;2021-08-02;6012;5332;898143;759115;63.9;54.0
94;2021-08-03;6048;5086;904191;764201;64.3;54.4
94;2021-08-04;5923;5039;910114;769240;64.7;54.7
94;2021-08-05;5532;5334;915646;774574;65.1;55.1
95;2020-12-27;3;0;3;0;0.0;0.0
95;2020-12-28;4;0;7;0;0.0;0.0
95;2020-12-29;0;0;7;0;0.0;0.0
95;2020-12-30;0;0;7;0;0.0;0.0
95;2020-12-31;2;0;9;0;0.0;0.0
95;2021-01-01;0;0;9;0;0.0;0.0
95;2021-01-02;13;0;22;0;0.0;0.0
95;2021-01-03;1;0;23;0;0.0;0.0
95;2021-01-04;48;0;71;0;0.0;0.0
95;2021-01-05;299;0;370;0;0.0;0.0
95;2021-01-06;188;0;558;0;0.0;0.0
95;2021-01-07;130;0;688;0;0.1;0.0
95;2021-01-08;273;1;961;1;0.1;0.0
95;2021-01-09;251;0;1212;1;0.1;0.0
95;2021-01-10;382;1;1594;2;0.1;0.0
95;2021-01-11;483;1;2077;3;0.2;0.0
95;2021-01-12;862;1;2939;4;0.2;0.0
95;2021-01-13;781;13;3720;17;0.3;0.0
95;2021-01-14;883;13;4603;30;0.4;0.0
95;2021-01-15;756;4;5359;34;0.4;0.0
95;2021-01-16;297;3;5656;37;0.5;0.0
95;2021-01-17;218;1;5874;38;0.5;0.0
95;2021-01-18;1336;5;7210;43;0.6;0.0
95;2021-01-19;1571;6;8781;49;0.7;0.0
95;2021-01-20;2035;5;10816;54;0.9;0.0
95;2021-01-21;1852;3;12668;57;1.0;0.0
95;2021-01-22;1320;5;13988;62;1.1;0.0
95;2021-01-23;647;0;14635;62;1.2;0.0
95;2021-01-24;181;0;14816;62;1.2;0.0
95;2021-01-25;796;37;15612;99;1.3;0.0
95;2021-01-26;985;160;16597;259;1.3;0.0
95;2021-01-27;1249;191;17846;450;1.4;0.0
95;2021-01-28;1719;36;19565;486;1.6;0.0
95;2021-01-29;1247;210;20812;696;1.7;0.1
95;2021-01-30;477;5;21289;701;1.7;0.1
95;2021-01-31;212;2;21501;703;1.7;0.1
95;2021-02-01;565;276;22066;979;1.8;0.1
95;2021-02-02;528;268;22594;1247;1.8;0.1
95;2021-02-03;612;520;23206;1767;1.9;0.1
95;2021-02-04;1065;368;24271;2135;1.9;0.2
95;2021-02-05;732;308;25003;2443;2.0;0.2
95;2021-02-06;335;257;25338;2700;2.0;0.2
95;2021-02-07;140;419;25478;3119;2.0;0.2
95;2021-02-08;762;345;26240;3464;2.1;0.3
95;2021-02-09;1130;1092;27370;4556;2.2;0.4
95;2021-02-10;1254;1410;28624;5966;2.3;0.5
95;2021-02-11;1384;1148;30008;7114;2.4;0.6
95;2021-02-12;1032;993;31040;8107;2.5;0.6
95;2021-02-13;329;318;31369;8425;2.5;0.7
95;2021-02-14;38;194;31407;8619;2.5;0.7
95;2021-02-15;425;1073;31832;9692;2.5;0.8
95;2021-02-16;493;926;32325;10618;2.6;0.9
95;2021-02-17;652;1141;32977;11759;2.6;0.9
95;2021-02-18;721;1693;33698;13452;2.7;1.1
95;2021-02-19;782;1311;34480;14763;2.8;1.2
95;2021-02-20;305;493;34785;15256;2.8;1.2
95;2021-02-21;165;318;34950;15574;2.8;1.2
95;2021-02-22;327;1027;35277;16601;2.8;1.3
95;2021-02-23;368;732;35645;17333;2.9;1.4
95;2021-02-24;308;884;35953;18217;2.9;1.5
95;2021-02-25;721;1133;36674;19350;2.9;1.6
95;2021-02-26;988;889;37662;20239;3.0;1.6
95;2021-02-27;365;433;38027;20672;3.0;1.7
95;2021-02-28;61;236;38088;20908;3.1;1.7
95;2021-03-01;770;593;38858;21501;3.1;1.7
95;2021-03-02;1319;857;40177;22358;3.2;1.8
95;2021-03-03;1595;982;41772;23340;3.3;1.9
95;2021-03-04;3188;1198;44960;24538;3.6;2.0
95;2021-03-05;3652;1096;48612;25634;3.9;2.1
95;2021-03-06;4002;496;52614;26130;4.2;2.1
95;2021-03-07;4218;308;56832;26438;4.6;2.1
95;2021-03-08;1541;868;58373;27306;4.7;2.2
95;2021-03-09;2621;498;60994;27804;4.9;2.2
95;2021-03-10;2342;850;63336;28654;5.1;2.3
95;2021-03-11;3136;1142;66472;29796;5.3;2.4
95;2021-03-12;3516;793;69988;30589;5.6;2.5
95;2021-03-13;3517;411;73505;31000;5.9;2.5
95;2021-03-14;1982;290;75487;31290;6.0;2.5
95;2021-03-15;2372;320;77859;31610;6.2;2.5
95;2021-03-16;1572;415;79431;32025;6.4;2.6
95;2021-03-17;2102;411;81533;32436;6.5;2.6
95;2021-03-18;2796;364;84329;32800;6.8;2.6
95;2021-03-19;3469;349;87798;33149;7.0;2.7
95;2021-03-20;2589;201;90387;33350;7.2;2.7
95;2021-03-21;1198;238;91585;33588;7.3;2.7
95;2021-03-22;2935;363;94520;33951;7.6;2.7
95;2021-03-23;3432;454;97952;34405;7.8;2.8
95;2021-03-24;3936;501;101888;34906;8.2;2.8
95;2021-03-25;5851;643;107739;35549;8.6;2.8
95;2021-03-26;5427;673;113166;36222;9.1;2.9
95;2021-03-27;3745;205;116911;36427;9.4;2.9
95;2021-03-28;1531;112;118442;36539;9.5;2.9
95;2021-03-29;2893;573;121335;37112;9.7;3.0
95;2021-03-30;3881;1226;125216;38338;10.0;3.1
95;2021-03-31;3655;1664;128871;40002;10.3;3.2
95;2021-04-01;5475;2258;134346;42260;10.8;3.4
95;2021-04-02;3544;2750;137890;45010;11.0;3.6
95;2021-04-03;2092;2484;139982;47494;11.2;3.8
95;2021-04-04;1244;1190;141226;48684;11.3;3.9
95;2021-04-05;593;64;141819;48748;11.4;3.9
95;2021-04-06;1856;1535;143675;50283;11.5;4.0
95;2021-04-07;4948;2169;148623;52452;11.9;4.2
95;2021-04-08;4892;2454;153515;54906;12.3;4.4
95;2021-04-09;5430;2327;158945;57233;12.7;4.6
95;2021-04-10;3705;1430;162650;58663;13.0;4.7
95;2021-04-11;1566;1032;164216;59695;13.2;4.8
95;2021-04-12;3245;1609;167461;61304;13.4;4.9
95;2021-04-13;3139;1673;170600;62977;13.7;5.0
95;2021-04-14;2744;1992;173344;64969;13.9;5.2
95;2021-04-15;3898;3326;177242;68295;14.2;5.5
95;2021-04-16;4063;3022;181305;71317;14.5;5.7
95;2021-04-17;2374;1754;183679;73071;14.7;5.9
95;2021-04-18;1509;1021;185188;74092;14.8;5.9
95;2021-04-19;2566;2369;187754;76461;15.0;6.1
95;2021-04-20;2118;2451;189872;78912;15.2;6.3
95;2021-04-21;3929;2629;193801;81541;15.5;6.5
95;2021-04-22;3411;4623;197212;86164;15.8;6.9
95;2021-04-23;2766;3556;199978;89720;16.0;7.2
95;2021-04-24;3569;2580;203547;92300;16.3;7.4
95;2021-04-25;1961;1548;205508;93848;16.5;7.5
95;2021-04-26;2748;2702;208256;96550;16.7;7.7
95;2021-04-27;3848;2166;212104;98716;17.0;7.9
95;2021-04-28;3887;2666;215991;101382;17.3;8.1
95;2021-04-29;6137;4539;222128;105921;17.8;8.5
95;2021-04-30;6903;2932;229031;108853;18.3;8.7
95;2021-05-01;2366;918;231397;109771;18.5;8.8
95;2021-05-02;2447;1497;233844;111268;18.7;8.9
95;2021-05-03;5121;1913;238965;113181;19.1;9.1
95;2021-05-04;6353;2719;245318;115900;19.7;9.3
95;2021-05-05;5147;3810;250465;119710;20.1;9.6
95;2021-05-06;8202;4929;258667;124639;20.7;10.0
95;2021-05-07;5775;4749;264442;129388;21.2;10.4
95;2021-05-08;5739;1527;270181;130915;21.6;10.5
95;2021-05-09;2827;1573;273008;132488;21.9;10.6
95;2021-05-10;9952;3174;282960;135662;22.7;10.9
95;2021-05-11;8444;3454;291404;139116;23.3;11.1
95;2021-05-12;9460;3213;300864;142329;24.1;11.4
95;2021-05-13;7953;1203;308817;143532;24.7;11.5
95;2021-05-14;7010;1903;315827;145435;25.3;11.7
95;2021-05-15;4512;1068;320339;146503;25.7;11.7
95;2021-05-16;4820;821;325159;147324;26.0;11.8
95;2021-05-17;7735;1348;332894;148672;26.7;11.9
95;2021-05-18;9460;1857;342354;150529;27.4;12.1
95;2021-05-19;9243;2511;351597;153040;28.2;12.3
95;2021-05-20;12579;2441;364176;155481;29.2;12.5
95;2021-05-21;10177;2534;374353;158015;30.0;12.7
95;2021-05-22;9401;1556;383754;159571;30.7;12.8
95;2021-05-23;4140;941;387894;160512;31.1;12.9
95;2021-05-24;2395;539;390289;161051;31.3;12.9
95;2021-05-25;7206;2078;397495;163129;31.8;13.1
95;2021-05-26;8847;3118;406342;166247;32.6;13.3
95;2021-05-27;10358;4429;416700;170676;33.4;13.7
95;2021-05-28;7681;4421;424381;175097;34.0;14.0
95;2021-05-29;5263;2761;429644;177858;34.4;14.2
95;2021-05-30;3729;1692;433373;179550;34.7;14.4
95;2021-05-31;6425;3325;439798;182875;35.2;14.6
95;2021-06-01;8779;3804;448577;186679;35.9;15.0
95;2021-06-02;8712;4735;457289;191414;36.6;15.3
95;2021-06-03;8520;6549;465809;197963;37.3;15.9
95;2021-06-04;8871;4402;474680;202365;38.0;16.2
95;2021-06-05;8332;3737;483012;206102;38.7;16.5
95;2021-06-06;4828;1596;487840;207698;39.1;16.6
95;2021-06-07;6031;4538;493871;212236;39.6;17.0
95;2021-06-08;6534;5513;500405;217749;40.1;17.4
95;2021-06-09;6068;6462;506473;224211;40.6;18.0
95;2021-06-10;6372;6807;512845;231018;41.1;18.5
95;2021-06-11;7157;6434;520002;237452;41.7;19.0
95;2021-06-12;6004;4372;526006;241824;42.1;19.4
95;2021-06-13;2079;3284;528085;245108;42.3;19.6
95;2021-06-14;4965;5978;533050;251086;42.7;20.1
95;2021-06-15;4528;8047;537578;259133;43.1;20.8
95;2021-06-16;5268;7529;542846;266662;43.5;21.4
95;2021-06-17;6455;8153;549301;274815;44.0;22.0
95;2021-06-18;5385;7848;554686;282663;44.4;22.6
95;2021-06-19;4962;8921;559648;291584;44.8;23.4
95;2021-06-20;1416;3306;561064;294890;44.9;23.6
95;2021-06-21;3219;7706;564283;302596;45.2;24.2
95;2021-06-22;4949;9036;569232;311632;45.6;25.0
95;2021-06-23;4726;10871;573958;322503;46.0;25.8
95;2021-06-24;4893;10706;578851;333209;46.4;26.7
95;2021-06-25;4777;10348;583628;343557;46.8;27.5
95;2021-06-26;4315;8477;587943;352034;47.1;28.2
95;2021-06-27;1029;3987;588972;356021;47.2;28.5
95;2021-06-28;2693;9484;591665;365505;47.4;29.3
95;2021-06-29;2520;8781;594185;374286;47.6;30.0
95;2021-06-30;3898;9985;598083;384271;47.9;30.8
95;2021-07-01;4323;11150;602406;395421;48.3;31.7
95;2021-07-02;4059;10536;606465;405957;48.6;32.5
95;2021-07-03;3524;9150;609989;415107;48.9;33.3
95;2021-07-04;1265;3398;611254;418505;49.0;33.5
95;2021-07-05;2302;4375;613556;422880;49.1;33.9
95;2021-07-06;2607;7747;616163;430627;49.4;34.5
95;2021-07-07;3928;9613;620091;440240;49.7;35.3
95;2021-07-08;5272;9802;625363;450042;50.1;36.1
95;2021-07-09;4473;10059;629836;460101;50.5;36.9
95;2021-07-10;3388;7387;633224;467488;50.7;37.4
95;2021-07-11;1501;3599;634725;471087;50.8;37.7
95;2021-07-12;2949;9680;637674;480767;51.1;38.5
95;2021-07-13;5026;10047;642700;490814;51.5;39.3
95;2021-07-14;4350;5706;647050;496520;51.8;39.8
95;2021-07-15;7232;12296;654282;508816;52.4;40.8
95;2021-07-16;7865;11965;662147;520781;53.0;41.7
95;2021-07-17;5022;7812;667169;528593;53.4;42.3
95;2021-07-18;3321;2879;670490;531472;53.7;42.6
95;2021-07-19;4733;6848;675223;538320;54.1;43.1
95;2021-07-20;6807;8352;682030;546672;54.6;43.8
95;2021-07-21;9150;9409;691180;556081;55.4;44.5
95;2021-07-22;9886;9669;701066;565750;56.2;45.3
95;2021-07-23;10777;10167;711843;575917;57.0;46.1
95;2021-07-24;5238;6222;717081;582139;57.4;46.6
95;2021-07-25;2149;2268;719230;584407;57.6;46.8
95;2021-07-26;4470;4004;723700;588411;58.0;47.1
95;2021-07-27;8374;7014;732074;595425;58.6;47.7
95;2021-07-28;9620;7515;741694;602940;59.4;48.3
95;2021-07-29;8336;5447;750030;608387;60.1;48.7
95;2021-07-30;8385;7735;758415;616122;60.8;49.4
95;2021-07-31;4196;4093;762611;620215;61.1;49.7
95;2021-08-01;2184;1346;764795;621561;61.3;49.8
95;2021-08-02;4043;3873;768838;625434;61.6;50.1
95;2021-08-03;6052;5482;774890;630916;62.1;50.5
95;2021-08-04;6395;6021;781285;636937;62.6;51.0
95;2021-08-05;6730;5677;788015;642614;63.1;51.5
971;2020-12-27;0;0;0;0;0.0;0.0
971;2020-12-28;0;0;0;0;0.0;0.0
971;2020-12-29;0;0;0;0;0.0;0.0
971;2020-12-30;0;0;0;0;0.0;0.0
971;2020-12-31;0;0;0;0;0.0;0.0
971;2021-01-01;1;0;1;0;0.0;0.0
971;2021-01-02;0;0;1;0;0.0;0.0
971;2021-01-03;0;0;1;0;0.0;0.0
971;2021-01-04;1;0;2;0;0.0;0.0
971;2021-01-05;0;0;2;0;0.0;0.0
971;2021-01-06;1;0;3;0;0.0;0.0
971;2021-01-07;0;0;3;0;0.0;0.0
971;2021-01-08;56;1;59;1;0.0;0.0
971;2021-01-09;20;0;79;1;0.0;0.0
971;2021-01-10;0;0;79;1;0.0;0.0
971;2021-01-11;60;0;139;1;0.0;0.0
971;2021-01-12;45;0;184;1;0.0;0.0
971;2021-01-13;47;1;231;2;0.1;0.0
971;2021-01-14;63;0;294;2;0.1;0.0
971;2021-01-15;77;0;371;2;0.1;0.0
971;2021-01-16;0;0;371;2;0.1;0.0
971;2021-01-17;0;0;371;2;0.1;0.0
971;2021-01-18;80;1;451;3;0.1;0.0
971;2021-01-19;145;0;596;3;0.2;0.0
971;2021-01-20;135;0;731;3;0.2;0.0
971;2021-01-21;151;1;882;4;0.2;0.0
971;2021-01-22;134;0;1016;4;0.3;0.0
971;2021-01-23;1;0;1017;4;0.3;0.0
971;2021-01-24;0;0;1017;4;0.3;0.0
971;2021-01-25;202;1;1219;5;0.3;0.0
971;2021-01-26;214;1;1433;6;0.4;0.0
971;2021-01-27;234;0;1667;6;0.4;0.0
971;2021-01-28;239;3;1906;9;0.5;0.0
971;2021-01-29;197;2;2103;11;0.6;0.0
971;2021-01-30;23;0;2126;11;0.6;0.0
971;2021-01-31;1;0;2127;11;0.6;0.0
971;2021-02-01;227;4;2354;15;0.6;0.0
971;2021-02-02;243;26;2597;41;0.7;0.0
971;2021-02-03;221;3;2818;44;0.7;0.0
971;2021-02-04;300;21;3118;65;0.8;0.0
971;2021-02-05;273;32;3391;97;0.9;0.0
971;2021-02-06;49;1;3440;98;0.9;0.0
971;2021-02-07;0;0;3440;98;0.9;0.0
971;2021-02-08;247;22;3687;120;1.0;0.0
971;2021-02-09;316;29;4003;149;1.1;0.0
971;2021-02-10;238;29;4241;178;1.1;0.0
971;2021-02-11;296;112;4537;290;1.2;0.1
971;2021-02-12;285;26;4822;316;1.3;0.1
971;2021-02-13;50;7;4872;323;1.3;0.1
971;2021-02-14;19;36;4891;359;1.3;0.1
971;2021-02-15;83;46;4974;405;1.3;0.1
971;2021-02-16;16;1;4990;406;1.3;0.1
971;2021-02-17;17;1;5007;407;1.3;0.1
971;2021-02-18;241;17;5248;424;1.4;0.1
971;2021-02-19;243;21;5491;445;1.5;0.1
971;2021-02-20;48;0;5539;445;1.5;0.1
971;2021-02-21;1;0;5540;445;1.5;0.1
971;2021-02-22;178;65;5718;510;1.5;0.1
971;2021-02-23;196;74;5914;584;1.6;0.2
971;2021-02-24;330;125;6244;709;1.7;0.2
971;2021-02-25;376;80;6620;789;1.8;0.2
971;2021-02-26;221;84;6841;873;1.8;0.2
971;2021-02-27;65;0;6906;873;1.8;0.2
971;2021-02-28;1;0;6907;873;1.8;0.2
971;2021-03-01;170;82;7077;955;1.9;0.3
971;2021-03-02;269;133;7346;1088;1.9;0.3
971;2021-03-03;238;121;7584;1209;2.0;0.3
971;2021-03-04;328;86;7912;1295;2.1;0.3
971;2021-03-05;364;152;8276;1447;2.2;0.4
971;2021-03-06;597;8;8873;1455;2.4;0.4
971;2021-03-07;1;0;8874;1455;2.4;0.4
971;2021-03-08;301;141;9175;1596;2.4;0.4
971;2021-03-09;369;155;9544;1751;2.5;0.5
971;2021-03-10;419;164;9963;1915;2.6;0.5
971;2021-03-11;123;46;10086;1961;2.7;0.5
971;2021-03-12;496;227;10582;2188;2.8;0.6
971;2021-03-13;135;3;10717;2191;2.8;0.6
971;2021-03-14;14;24;10731;2215;2.8;0.6
971;2021-03-15;419;46;11150;2261;3.0;0.6
971;2021-03-16;474;84;11624;2345;3.1;0.6
971;2021-03-17;452;89;12076;2434;3.2;0.6
971;2021-03-18;559;106;12635;2540;3.4;0.7
971;2021-03-19;568;100;13203;2640;3.5;0.7
971;2021-03-20;177;44;13380;2684;3.6;0.7
971;2021-03-21;8;0;13388;2684;3.6;0.7
971;2021-03-22;355;87;13743;2771;3.6;0.7
971;2021-03-23;534;157;14277;2928;3.8;0.8
971;2021-03-24;469;108;14746;3036;3.9;0.8
971;2021-03-25;757;181;15503;3217;4.1;0.9
971;2021-03-26;641;121;16144;3338;4.3;0.9
971;2021-03-27;284;47;16428;3385;4.4;0.9
971;2021-03-28;21;1;16449;3386;4.4;0.9
971;2021-03-29;381;84;16830;3470;4.5;0.9
971;2021-03-30;621;164;17451;3634;4.6;1.0
971;2021-03-31;546;133;17997;3767;4.8;1.0
971;2021-04-01;655;198;18652;3965;4.9;1.1
971;2021-04-02;38;35;18690;4000;5.0;1.1
971;2021-04-03;53;2;18743;4002;5.0;1.1
971;2021-04-04;4;18;18747;4020;5.0;1.1
971;2021-04-05;12;0;18759;4020;5.0;1.1
971;2021-04-06;480;193;19239;4213;5.1;1.1
971;2021-04-07;580;117;19819;4330;5.3;1.1
971;2021-04-08;504;162;20323;4492;5.4;1.2
971;2021-04-09;485;210;20808;4702;5.5;1.2
971;2021-04-10;100;4;20908;4706;5.5;1.2
971;2021-04-11;6;23;20914;4729;5.5;1.3
971;2021-04-12;299;262;21213;4991;5.6;1.3
971;2021-04-13;555;325;21768;5316;5.8;1.4
971;2021-04-14;436;224;22204;5540;5.9;1.5
971;2021-04-15;551;312;22755;5852;6.0;1.6
971;2021-04-16;564;273;23319;6125;6.2;1.6
971;2021-04-17;208;4;23527;6129;6.2;1.6
971;2021-04-18;6;14;23533;6143;6.2;1.6
971;2021-04-19;399;243;23932;6386;6.4;1.7
971;2021-04-20;724;344;24656;6730;6.5;1.8
971;2021-04-21;625;312;25281;7042;6.7;1.9
971;2021-04-22;810;335;26091;7377;6.9;2.0
971;2021-04-23;846;250;26937;7627;7.1;2.0
971;2021-04-24;388;75;27325;7702;7.3;2.0
971;2021-04-25;598;63;27923;7765;7.4;2.1
971;2021-04-26;960;217;28883;7982;7.7;2.1
971;2021-04-27;697;235;29580;8217;7.8;2.2
971;2021-04-28;860;266;30440;8483;8.1;2.3
971;2021-04-29;1197;204;31637;8687;8.4;2.3
971;2021-04-30;1265;189;32902;8876;8.7;2.4
971;2021-05-01;603;44;33505;8920;8.9;2.4
971;2021-05-02;352;18;33857;8938;9.0;2.4
971;2021-05-03;918;180;34775;9118;9.2;2.4
971;2021-05-04;957;206;35732;9324;9.5;2.5
971;2021-05-05;1012;252;36744;9576;9.7;2.5
971;2021-05-06;1147;174;37891;9750;10.1;2.6
971;2021-05-07;1252;269;39143;10019;10.4;2.7
971;2021-05-08;321;36;39464;10055;10.5;2.7
971;2021-05-09;182;10;39646;10065;10.5;2.7
971;2021-05-10;838;216;40484;10281;10.7;2.7
971;2021-05-11;964;316;41448;10597;11.0;2.8
971;2021-05-12;905;325;42353;10922;11.2;2.9
971;2021-05-13;211;79;42564;11001;11.3;2.9
971;2021-05-14;861;275;43425;11276;11.5;3.0
971;2021-05-15;486;15;43911;11291;11.7;3.0
971;2021-05-16;181;36;44092;11327;11.7;3.0
971;2021-05-17;717;276;44809;11603;11.9;3.1
971;2021-05-18;742;389;45551;11992;12.1;3.2
971;2021-05-19;701;529;46252;12521;12.3;3.3
971;2021-05-20;803;377;47055;12898;12.5;3.4
971;2021-05-21;822;407;47877;13305;12.7;3.5
971;2021-05-22;501;215;48378;13520;12.8;3.6
971;2021-05-23;203;114;48581;13634;12.9;3.6
971;2021-05-24;201;176;48782;13810;12.9;3.7
971;2021-05-25;544;661;49326;14471;13.1;3.8
971;2021-05-26;595;492;49921;14963;13.2;4.0
971;2021-05-27;131;185;50052;15148;13.3;4.0
971;2021-05-28;517;527;50569;15675;13.4;4.2
971;2021-05-29;236;138;50805;15813;13.5;4.2
971;2021-05-30;76;113;50881;15926;13.5;4.2
971;2021-05-31;453;535;51334;16461;13.6;4.4
971;2021-06-01;589;709;51923;17170;13.8;4.6
971;2021-06-02;577;707;52500;17877;13.9;4.7
971;2021-06-03;506;564;53006;18441;14.1;4.9
971;2021-06-04;793;806;53799;19247;14.3;5.1
971;2021-06-05;315;645;54114;19892;14.4;5.3
971;2021-06-06;136;530;54250;20422;14.4;5.4
971;2021-06-07;425;783;54675;21205;14.5;5.6
971;2021-06-08;508;892;55183;22097;14.6;5.9
971;2021-06-09;500;860;55683;22957;14.8;6.1
971;2021-06-10;531;845;56214;23802;14.9;6.3
971;2021-06-11;466;1242;56680;25044;15.0;6.6
971;2021-06-12;298;664;56978;25708;15.1;6.8
971;2021-06-13;128;314;57106;26022;15.2;6.9
971;2021-06-14;368;3794;57474;29816;15.2;7.9
971;2021-06-15;485;2007;57959;31823;15.4;8.4
971;2021-06-16;478;1482;58437;33305;15.5;8.8
971;2021-06-17;430;1013;58867;34318;15.6;9.1
971;2021-06-18;476;1019;59343;35337;15.7;9.4
971;2021-06-19;314;508;59657;35845;15.8;9.5
971;2021-06-20;111;231;59768;36076;15.9;9.6
971;2021-06-21;333;679;60101;36755;15.9;9.8
971;2021-06-22;328;873;60429;37628;16.0;10.0
971;2021-06-23;368;891;60797;38519;16.1;10.2
971;2021-06-24;410;733;61207;39252;16.2;10.4
971;2021-06-25;450;763;61657;40015;16.4;10.6
971;2021-06-26;298;514;61955;40529;16.4;10.8
971;2021-06-27;116;148;62071;40677;16.5;10.8
971;2021-06-28;303;689;62374;41366;16.6;11.0
971;2021-06-29;374;780;62748;42146;16.6;11.2
971;2021-06-30;433;921;63181;43067;16.8;11.4
971;2021-07-01;351;651;63532;43718;16.9;11.6
971;2021-07-02;420;692;63952;44410;17.0;11.8
971;2021-07-03;270;463;64222;44873;17.0;11.9
971;2021-07-04;112;239;64334;45112;17.1;12.0
971;2021-07-05;325;509;64659;45621;17.2;12.1
971;2021-07-06;378;765;65037;46386;17.3;12.3
971;2021-07-07;375;845;65412;47231;17.4;12.5
971;2021-07-08;405;790;65817;48021;17.5;12.7
971;2021-07-09;428;797;66245;48818;17.6;13.0
971;2021-07-10;242;294;66487;49112;17.6;13.0
971;2021-07-11;169;135;66656;49247;17.7;13.1
971;2021-07-12;475;610;67131;49857;17.8;13.2
971;2021-07-13;853;1008;67984;50865;18.0;13.5
971;2021-07-14;457;280;68441;51145;18.2;13.6
971;2021-07-15;847;836;69288;51981;18.4;13.8
971;2021-07-16;1065;1035;70353;53016;18.7;14.1
971;2021-07-17;641;441;70994;53457;18.8;14.2
971;2021-07-18;398;215;71392;53672;18.9;14.2
971;2021-07-19;571;576;71963;54248;19.1;14.4
971;2021-07-20;776;724;72739;54972;19.3;14.6
971;2021-07-21;754;493;73493;55465;19.5;14.7
971;2021-07-22;937;860;74430;56325;19.7;14.9
971;2021-07-23;940;745;75370;57070;20.0;15.1
971;2021-07-24;409;377;75779;57447;20.1;15.2
971;2021-07-25;248;259;76027;57706;20.2;15.3
971;2021-07-26;564;556;76591;58262;20.3;15.5
971;2021-07-27;726;567;77317;58829;20.5;15.6
971;2021-07-28;714;639;78031;59468;20.7;15.8
971;2021-07-29;822;655;78853;60123;20.9;16.0
971;2021-07-30;1238;741;80091;60864;21.3;16.1
971;2021-07-31;550;408;80641;61272;21.4;16.3
971;2021-08-01;304;244;80945;61516;21.5;16.3
971;2021-08-02;747;418;81692;61934;21.7;16.4
971;2021-08-03;705;662;82397;62596;21.9;16.6
971;2021-08-04;646;657;83043;63253;22.0;16.8
971;2021-08-05;538;566;83581;63819;22.2;16.9
972;2020-12-27;0;0;0;0;0.0;0.0
972;2020-12-28;0;0;0;0;0.0;0.0
972;2020-12-29;0;0;0;0;0.0;0.0
972;2020-12-30;0;0;0;0;0.0;0.0
972;2020-12-31;0;0;0;0;0.0;0.0
972;2021-01-01;0;0;0;0;0.0;0.0
972;2021-01-02;0;0;0;0;0.0;0.0
972;2021-01-03;0;0;0;0;0.0;0.0
972;2021-01-04;0;0;0;0;0.0;0.0
972;2021-01-05;0;0;0;0;0.0;0.0
972;2021-01-06;5;0;5;0;0.0;0.0
972;2021-01-07;31;0;36;0;0.0;0.0
972;2021-01-08;90;1;126;1;0.0;0.0
972;2021-01-09;20;0;146;1;0.0;0.0
972;2021-01-10;0;0;146;1;0.0;0.0
972;2021-01-11;122;0;268;1;0.1;0.0
972;2021-01-12;79;0;347;1;0.1;0.0
972;2021-01-13;64;0;411;1;0.1;0.0
972;2021-01-14;88;1;499;2;0.1;0.0
972;2021-01-15;164;0;663;2;0.2;0.0
972;2021-01-16;51;0;714;2;0.2;0.0
972;2021-01-17;0;0;714;2;0.2;0.0
972;2021-01-18;158;0;872;2;0.2;0.0
972;2021-01-19;168;1;1040;3;0.3;0.0
972;2021-01-20;165;0;1205;3;0.3;0.0
972;2021-01-21;181;2;1386;5;0.4;0.0
972;2021-01-22;173;0;1559;5;0.4;0.0
972;2021-01-23;58;0;1617;5;0.5;0.0
972;2021-01-24;0;0;1617;5;0.5;0.0
972;2021-01-25;161;0;1778;5;0.5;0.0
972;2021-01-26;137;1;1915;6;0.5;0.0
972;2021-01-27;163;5;2078;11;0.6;0.0
972;2021-01-28;152;12;2230;23;0.6;0.0
972;2021-01-29;143;41;2373;64;0.7;0.0
972;2021-01-30;96;16;2469;80;0.7;0.0
972;2021-01-31;0;0;2469;80;0.7;0.0
972;2021-02-01;119;74;2588;154;0.7;0.0
972;2021-02-02;184;96;2772;250;0.8;0.1
972;2021-02-03;132;80;2904;330;0.8;0.1
972;2021-02-04;158;73;3062;403;0.9;0.1
972;2021-02-05;124;96;3186;499;0.9;0.1
972;2021-02-06;62;26;3248;525;0.9;0.1
972;2021-02-07;1;0;3249;525;0.9;0.1
972;2021-02-08;137;80;3386;605;0.9;0.2
972;2021-02-09;176;78;3562;683;1.0;0.2
972;2021-02-10;153;90;3715;773;1.0;0.2
972;2021-02-11;150;103;3865;876;1.1;0.2
972;2021-02-12;146;131;4011;1007;1.1;0.3
972;2021-02-13;47;37;4058;1044;1.1;0.3
972;2021-02-14;0;0;4058;1044;1.1;0.3
972;2021-02-15;51;67;4109;1111;1.1;0.3
972;2021-02-16;0;1;4109;1112;1.1;0.3
972;2021-02-17;1;3;4110;1115;1.1;0.3
972;2021-02-18;69;127;4179;1242;1.2;0.3
972;2021-02-19;69;131;4248;1373;1.2;0.4
972;2021-02-20;48;68;4296;1441;1.2;0.4
972;2021-02-21;0;0;4296;1441;1.2;0.4
972;2021-02-22;102;60;4398;1501;1.2;0.4
972;2021-02-23;113;237;4511;1738;1.3;0.5
972;2021-02-24;106;223;4617;1961;1.3;0.5
972;2021-02-25;89;150;4706;2111;1.3;0.6
972;2021-02-26;132;169;4838;2280;1.3;0.6
972;2021-02-27;69;52;4907;2332;1.4;0.7
972;2021-02-28;0;0;4907;2332;1.4;0.7
972;2021-03-01;137;144;5044;2476;1.4;0.7
972;2021-03-02;157;79;5201;2555;1.4;0.7
972;2021-03-03;179;145;5380;2700;1.5;0.8
972;2021-03-04;151;135;5531;2835;1.5;0.8
972;2021-03-05;238;128;5769;2963;1.6;0.8
972;2021-03-06;119;58;5888;3021;1.6;0.8
972;2021-03-07;100;1;5988;3022;1.7;0.8
972;2021-03-08;196;133;6184;3155;1.7;0.9
972;2021-03-09;283;101;6467;3256;1.8;0.9
972;2021-03-10;322;134;6789;3390;1.9;0.9
972;2021-03-11;336;82;7125;3472;2.0;1.0
972;2021-03-12;413;55;7538;3527;2.1;1.0
972;2021-03-13;155;21;7693;3548;2.1;1.0
972;2021-03-14;4;1;7697;3549;2.1;1.0
972;2021-03-15;276;90;7973;3639;2.2;1.0
972;2021-03-16;305;55;8278;3694;2.3;1.0
972;2021-03-17;388;49;8666;3743;2.4;1.0
972;2021-03-18;434;44;9100;3787;2.5;1.1
972;2021-03-19;401;63;9501;3850;2.6;1.1
972;2021-03-20;149;48;9650;3898;2.7;1.1
972;2021-03-21;25;1;9675;3899;2.7;1.1
972;2021-03-22;362;118;10037;4017;2.8;1.1
972;2021-03-23;403;123;10440;4140;2.9;1.2
972;2021-03-24;429;107;10869;4247;3.0;1.2
972;2021-03-25;483;100;11352;4347;3.2;1.2
972;2021-03-26;634;103;11986;4450;3.3;1.2
972;2021-03-27;153;71;12139;4521;3.4;1.3
972;2021-03-28;81;2;12220;4523;3.4;1.3
972;2021-03-29;422;165;12642;4688;3.5;1.3
972;2021-03-30;469;244;13111;4932;3.7;1.4
972;2021-03-31;1151;192;14262;5124;4.0;1.4
972;2021-04-01;955;171;15217;5295;4.2;1.5
972;2021-04-02;895;13;16112;5308;4.5;1.5
972;2021-04-03;788;53;16900;5361;4.7;1.5
972;2021-04-04;751;12;17651;5373;4.9;1.5
972;2021-04-05;829;44;18480;5417;5.2;1.5
972;2021-04-06;883;136;19363;5553;5.4;1.5
972;2021-04-07;1436;326;20799;5879;5.8;1.6
972;2021-04-08;1306;271;22105;6150;6.2;1.7
972;2021-04-09;1240;316;23345;6466;6.5;1.8
972;2021-04-10;838;165;24183;6631;6.7;1.8
972;2021-04-11;621;14;24804;6645;6.9;1.9
972;2021-04-12;867;317;25671;6962;7.2;1.9
972;2021-04-13;881;327;26552;7289;7.4;2.0
972;2021-04-14;960;322;27512;7611;7.7;2.1
972;2021-04-15;959;298;28471;7909;7.9;2.2
972;2021-04-16;994;300;29465;8209;8.2;2.3
972;2021-04-17;530;161;29995;8370;8.4;2.3
972;2021-04-18;339;56;30334;8426;8.5;2.3
972;2021-04-19;668;344;31002;8770;8.6;2.4
972;2021-04-20;868;309;31870;9079;8.9;2.5
972;2021-04-21;1002;354;32872;9433;9.2;2.6
972;2021-04-22;605;313;33477;9746;9.3;2.7
972;2021-04-23;607;465;34084;10211;9.5;2.8
972;2021-04-24;362;197;34446;10408;9.6;2.9
972;2021-04-25;168;199;34614;10607;9.6;3.0
972;2021-04-26;516;541;35130;11148;9.8;3.1
972;2021-04-27;568;609;35698;11757;10.0;3.3
972;2021-04-28;449;691;36147;12448;10.1;3.5
972;2021-04-29;653;641;36800;13089;10.3;3.6
972;2021-04-30;771;687;37571;13776;10.5;3.8
972;2021-05-01;244;246;37815;14022;10.5;3.9
972;2021-05-02;227;513;38042;14535;10.6;4.1
972;2021-05-03;569;772;38611;15307;10.8;4.3
972;2021-05-04;525;678;39136;15985;10.9;4.5
972;2021-05-05;547;896;39683;16881;11.1;4.7
972;2021-05-06;546;785;40229;17666;11.2;4.9
972;2021-05-07;629;1014;40858;18680;11.4;5.2
972;2021-05-08;226;526;41084;19206;11.5;5.4
972;2021-05-09;172;506;41256;19712;11.5;5.5
972;2021-05-10;520;857;41776;20569;11.6;5.7
972;2021-05-11;477;872;42253;21441;11.8;6.0
972;2021-05-12;559;910;42812;22351;11.9;6.2
972;2021-05-13;274;533;43086;22884;12.0;6.4
972;2021-05-14;389;752;43475;23636;12.1;6.6
972;2021-05-15;233;578;43708;24214;12.2;6.7
972;2021-05-16;155;442;43863;24656;12.2;6.9
972;2021-05-17;474;753;44337;25409;12.4;7.1
972;2021-05-18;446;680;44783;26089;12.5;7.3
972;2021-05-19;453;744;45236;26833;12.6;7.5
972;2021-05-20;594;500;45830;27333;12.8;7.6
972;2021-05-21;545;705;46375;28038;12.9;7.8
972;2021-05-22;186;364;46561;28402;13.0;7.9
972;2021-05-23;111;182;46672;28584;13.0;8.0
972;2021-05-24;135;241;46807;28825;13.0;8.0
972;2021-05-25;351;698;47158;29523;13.1;8.2
972;2021-05-26;382;714;47540;30237;13.3;8.4
972;2021-05-27;270;647;47810;30884;13.3;8.6
972;2021-05-28;279;816;48089;31700;13.4;8.8
972;2021-05-29;154;513;48243;32213;13.4;9.0
972;2021-05-30;17;33;48260;32246;13.5;9.0
972;2021-05-31;345;682;48605;32928;13.5;9.2
972;2021-06-01;300;547;48905;33475;13.6;9.3
972;2021-06-02;326;575;49231;34050;13.7;9.5
972;2021-06-03;247;425;49478;34475;13.8;9.6
972;2021-06-04;350;644;49828;35119;13.9;9.8
972;2021-06-05;261;373;50089;35492;14.0;9.9
972;2021-06-06;24;31;50113;35523;14.0;9.9
972;2021-06-07;259;737;50372;36260;14.0;10.1
972;2021-06-08;255;589;50627;36849;14.1;10.3
972;2021-06-09;303;699;50930;37548;14.2;10.5
972;2021-06-10;307;453;51237;38001;14.3;10.6
972;2021-06-11;361;534;51598;38535;14.4;10.7
972;2021-06-12;246;322;51844;38857;14.5;10.8
972;2021-06-13;32;29;51876;38886;14.5;10.8
972;2021-06-14;367;551;52243;39437;14.6;11.0
972;2021-06-15;410;488;52653;39925;14.7;11.1
972;2021-06-16;436;436;53089;40361;14.8;11.3
972;2021-06-17;355;576;53444;40937;14.9;11.4
972;2021-06-18;458;539;53902;41476;15.0;11.6
972;2021-06-19;225;196;54127;41672;15.1;11.6
972;2021-06-20;25;17;54152;41689;15.1;11.6
972;2021-06-21;332;580;54484;42269;15.2;11.8
972;2021-06-22;296;464;54780;42733;15.3;11.9
972;2021-06-23;425;563;55205;43296;15.4;12.1
972;2021-06-24;327;437;55532;43733;15.5;12.2
972;2021-06-25;313;387;55845;44120;15.6;12.3
972;2021-06-26;221;200;56066;44320;15.6;12.4
972;2021-06-27;16;23;56082;44343;15.6;12.4
972;2021-06-28;336;425;56418;44768;15.7;12.5
972;2021-06-29;329;431;56747;45199;15.8;12.6
972;2021-06-30;439;421;57186;45620;15.9;12.7
972;2021-07-01;348;392;57534;46012;16.0;12.8
972;2021-07-02;123;201;57657;46213;16.1;12.9
972;2021-07-03;100;118;57757;46331;16.1;12.9
972;2021-07-04;24;35;57781;46366;16.1;12.9
972;2021-07-05;492;579;58273;46945;16.2;13.1
972;2021-07-06;485;430;58758;47375;16.4;13.2
972;2021-07-07;603;493;59361;47868;16.5;13.3
972;2021-07-08;494;420;59855;48288;16.7;13.5
972;2021-07-09;624;584;60479;48872;16.9;13.6
972;2021-07-10;403;306;60882;49178;17.0;13.7
972;2021-07-11;48;37;60930;49215;17.0;13.7
972;2021-07-12;841;696;61771;49911;17.2;13.9
972;2021-07-13;1467;711;63238;50622;17.6;14.1
972;2021-07-14;132;63;63370;50685;17.7;14.1
972;2021-07-15;1592;679;64962;51364;18.1;14.3
972;2021-07-16;1629;651;66591;52015;18.6;14.5
972;2021-07-17;1066;366;67657;52381;18.9;14.6
972;2021-07-18;56;39;67713;52420;18.9;14.6
972;2021-07-19;1138;651;68851;53071;19.2;14.8
972;2021-07-20;1107;576;69958;53647;19.5;15.0
972;2021-07-21;1075;595;71033;54242;19.8;15.1
972;2021-07-22;891;514;71924;54756;20.0;15.3
972;2021-07-23;930;479;72854;55235;20.3;15.4
972;2021-07-24;496;222;73350;55457;20.4;15.5
972;2021-07-25;50;63;73400;55520;20.5;15.5
972;2021-07-26;682;514;74082;56034;20.7;15.6
972;2021-07-27;1024;509;75106;56543;20.9;15.8
972;2021-07-28;628;562;75734;57105;21.1;15.9
972;2021-07-29;818;536;76552;57641;21.3;16.1
972;2021-07-30;860;614;77412;58255;21.6;16.2
972;2021-07-31;544;268;77956;58523;21.7;16.3
972;2021-08-01;77;33;78033;58556;21.8;16.3
972;2021-08-02;802;810;78835;59366;22.0;16.5
972;2021-08-03;691;739;79526;60105;22.2;16.8
972;2021-08-04;754;566;80280;60671;22.4;16.9
972;2021-08-05;805;588;81085;61259;22.6;17.1
973;2020-12-27;0;0;0;0;0.0;0.0
973;2020-12-28;0;0;0;0;0.0;0.0
973;2020-12-29;0;0;0;0;0.0;0.0
973;2020-12-30;0;0;0;0;0.0;0.0
973;2020-12-31;0;0;0;0;0.0;0.0
973;2021-01-01;0;0;0;0;0.0;0.0
973;2021-01-02;2;2;2;2;0.0;0.0
973;2021-01-03;0;0;2;2;0.0;0.0
973;2021-01-04;0;0;2;2;0.0;0.0
973;2021-01-05;0;0;2;2;0.0;0.0
973;2021-01-06;0;0;2;2;0.0;0.0
973;2021-01-07;0;0;2;2;0.0;0.0
973;2021-01-08;0;0;2;2;0.0;0.0
973;2021-01-09;0;0;2;2;0.0;0.0
973;2021-01-10;0;0;2;2;0.0;0.0
973;2021-01-11;0;0;2;2;0.0;0.0
973;2021-01-12;0;0;2;2;0.0;0.0
973;2021-01-13;30;0;32;2;0.0;0.0
973;2021-01-14;46;0;78;2;0.0;0.0
973;2021-01-15;35;0;113;2;0.0;0.0
973;2021-01-16;18;1;131;3;0.0;0.0
973;2021-01-17;0;0;131;3;0.0;0.0
973;2021-01-18;63;0;194;3;0.1;0.0
973;2021-01-19;150;1;344;4;0.1;0.0
973;2021-01-20;134;0;478;4;0.2;0.0
973;2021-01-21;118;0;596;4;0.2;0.0
973;2021-01-22;76;0;672;4;0.2;0.0
973;2021-01-23;0;0;672;4;0.2;0.0
973;2021-01-24;0;0;672;4;0.2;0.0
973;2021-01-25;56;0;728;4;0.3;0.0
973;2021-01-26;100;2;828;6;0.3;0.0
973;2021-01-27;109;1;937;7;0.3;0.0
973;2021-01-28;96;3;1033;10;0.4;0.0
973;2021-01-29;104;3;1137;13;0.4;0.0
973;2021-01-30;0;0;1137;13;0.4;0.0
973;2021-01-31;0;0;1137;13;0.4;0.0
973;2021-02-01;54;0;1191;13;0.4;0.0
973;2021-02-02;122;4;1313;17;0.5;0.0
973;2021-02-03;118;7;1431;24;0.5;0.0
973;2021-02-04;79;26;1510;50;0.5;0.0
973;2021-02-05;65;8;1575;58;0.5;0.0
973;2021-02-06;0;0;1575;58;0.5;0.0
973;2021-02-07;0;0;1575;58;0.5;0.0
973;2021-02-08;52;12;1627;70;0.6;0.0
973;2021-02-09;92;39;1719;109;0.6;0.0
973;2021-02-10;101;41;1820;150;0.6;0.1
973;2021-02-11;105;92;1925;242;0.7;0.1
973;2021-02-12;88;64;2013;306;0.7;0.1
973;2021-02-13;0;0;2013;306;0.7;0.1
973;2021-02-14;0;0;2013;306;0.7;0.1
973;2021-02-15;27;65;2040;371;0.7;0.1
973;2021-02-16;123;55;2163;426;0.7;0.1
973;2021-02-17;145;120;2308;546;0.8;0.2
973;2021-02-18;103;142;2411;688;0.8;0.2
973;2021-02-19;122;74;2533;762;0.9;0.3
973;2021-02-20;0;0;2533;762;0.9;0.3
973;2021-02-21;0;0;2533;762;0.9;0.3
973;2021-02-22;78;49;2611;811;0.9;0.3
973;2021-02-23;158;102;2769;913;1.0;0.3
973;2021-02-24;190;122;2959;1035;1.0;0.4
973;2021-02-25;259;90;3218;1125;1.1;0.4
973;2021-02-26;264;70;3482;1195;1.2;0.4
973;2021-02-27;120;1;3602;1196;1.2;0.4
973;2021-02-28;0;0;3602;1196;1.2;0.4
973;2021-03-01;180;86;3782;1282;1.3;0.4
973;2021-03-02;255;108;4037;1390;1.4;0.5
973;2021-03-03;255;132;4292;1522;1.5;0.5
973;2021-03-04;281;83;4573;1605;1.6;0.6
973;2021-03-05;274;48;4847;1653;1.7;0.6
973;2021-03-06;118;2;4965;1655;1.7;0.6
973;2021-03-07;0;0;4965;1655;1.7;0.6
973;2021-03-08;187;40;5152;1695;1.8;0.6
973;2021-03-09;350;93;5502;1788;1.9;0.6
973;2021-03-10;358;103;5860;1891;2.0;0.7
973;2021-03-11;270;114;6130;2005;2.1;0.7
973;2021-03-12;287;89;6417;2094;2.2;0.7
973;2021-03-13;111;4;6528;2098;2.2;0.7
973;2021-03-14;0;0;6528;2098;2.2;0.7
973;2021-03-15;181;27;6709;2125;2.3;0.7
973;2021-03-16;242;139;6951;2264;2.4;0.8
973;2021-03-17;273;129;7224;2393;2.5;0.8
973;2021-03-18;249;154;7473;2547;2.6;0.9
973;2021-03-19;283;125;7756;2672;2.7;0.9
973;2021-03-20;255;14;8011;2686;2.8;0.9
973;2021-03-21;119;2;8130;2688;2.8;0.9
973;2021-03-22;219;110;8349;2798;2.9;1.0
973;2021-03-23;274;195;8623;2993;3.0;1.0
973;2021-03-24;235;214;8858;3207;3.0;1.1
973;2021-03-25;168;179;9026;3386;3.1;1.2
973;2021-03-26;189;307;9215;3693;3.2;1.3
973;2021-03-27;58;94;9273;3787;3.2;1.3
973;2021-03-28;0;0;9273;3787;3.2;1.3
973;2021-03-29;175;246;9448;4033;3.3;1.4
973;2021-03-30;445;238;9893;4271;3.4;1.5
973;2021-03-31;320;291;10213;4562;3.5;1.6
973;2021-04-01;444;261;10657;4823;3.7;1.7
973;2021-04-02;306;279;10963;5102;3.8;1.8
973;2021-04-03;153;121;11116;5223;3.8;1.8
973;2021-04-04;1;0;11117;5223;3.8;1.8
973;2021-04-05;118;14;11235;5237;3.9;1.8
973;2021-04-06;438;335;11673;5572;4.0;1.9
973;2021-04-07;503;344;12176;5916;4.2;2.0
973;2021-04-08;514;268;12690;6184;4.4;2.1
973;2021-04-09;497;226;13187;6410;4.5;2.2
973;2021-04-10;147;91;13334;6501;4.6;2.2
973;2021-04-11;2;0;13336;6501;4.6;2.2
973;2021-04-12;551;267;13887;6768;4.8;2.3
973;2021-04-13;674;244;14561;7012;5.0;2.4
973;2021-04-14;721;313;15282;7325;5.3;2.5
973;2021-04-15;777;246;16059;7571;5.5;2.6
973;2021-04-16;758;299;16817;7870;5.8;2.7
973;2021-04-17;499;131;17316;8001;6.0;2.8
973;2021-04-18;499;40;17815;8041;6.1;2.8
973;2021-04-19;714;251;18529;8292;6.4;2.9
973;2021-04-20;606;278;19135;8570;6.6;2.9
973;2021-04-21;874;249;20009;8819;6.9;3.0
973;2021-04-22;722;230;20731;9049;7.1;3.1
973;2021-04-23;705;228;21436;9277;7.4;3.2
973;2021-04-24;524;96;21960;9373;7.6;3.2
973;2021-04-25;611;50;22571;9423;7.8;3.2
973;2021-04-26;780;231;23351;9654;8.0;3.3
973;2021-04-27;820;344;24171;9998;8.3;3.4
973;2021-04-28;745;330;24916;10328;8.6;3.6
973;2021-04-29;664;284;25580;10612;8.8;3.7
973;2021-04-30;712;260;26292;10872;9.0;3.7
973;2021-05-01;210;27;26502;10899;9.1;3.7
973;2021-05-02;602;85;27104;10984;9.3;3.8
973;2021-05-03;554;391;27658;11375;9.5;3.9
973;2021-05-04;665;324;28323;11699;9.7;4.0
973;2021-05-05;700;449;29023;12148;10.0;4.2
973;2021-05-06;691;472;29714;12620;10.2;4.3
973;2021-05-07;592;471;30306;13091;10.4;4.5
973;2021-05-08;342;58;30648;13149;10.5;4.5
973;2021-05-09;262;72;30910;13221;10.6;4.5
973;2021-05-10;438;611;31348;13832;10.8;4.8
973;2021-05-11;395;494;31743;14326;10.9;4.9
973;2021-05-12;509;644;32252;14970;11.1;5.1
973;2021-05-13;334;98;32586;15068;11.2;5.2
973;2021-05-14;481;549;33067;15617;11.4;5.4
973;2021-05-15;258;348;33325;15965;11.5;5.5
973;2021-05-16;208;210;33533;16175;11.5;5.6
973;2021-05-17;447;600;33980;16775;11.7;5.8
973;2021-05-18;561;565;34541;17340;11.9;6.0
973;2021-05-19;535;553;35076;17893;12.1;6.2
973;2021-05-20;642;452;35718;18345;12.3;6.3
973;2021-05-21;500;606;36218;18951;12.5;6.5
973;2021-05-22;167;502;36385;19453;12.5;6.7
973;2021-05-23;270;474;36655;19927;12.6;6.9
973;2021-05-24;561;248;37216;20175;12.8;6.9
973;2021-05-25;498;742;37714;20917;13.0;7.2
973;2021-05-26;447;683;38161;21600;13.1;7.4
973;2021-05-27;706;524;38867;22124;13.4;7.6
973;2021-05-28;579;553;39446;22677;13.6;7.8
973;2021-05-29;255;360;39701;23037;13.7;7.9
973;2021-05-30;151;399;39852;23436;13.7;8.1
973;2021-05-31;356;574;40208;24010;13.8;8.3
973;2021-06-01;419;463;40627;24473;14.0;8.4
973;2021-06-02;562;554;41189;25027;14.2;8.6
973;2021-06-03;520;469;41709;25496;14.3;8.8
973;2021-06-04;599;495;42308;25991;14.6;8.9
973;2021-06-05;273;293;42581;26284;14.6;9.0
973;2021-06-06;211;299;42792;26583;14.7;9.1
973;2021-06-07;488;452;43280;27035;14.9;9.3
973;2021-06-08;547;313;43827;27348;15.1;9.4
973;2021-06-09;520;389;44347;27737;15.3;9.5
973;2021-06-10;356;289;44703;28026;15.4;9.6
973;2021-06-11;434;467;45137;28493;15.5;9.8
973;2021-06-12;170;284;45307;28777;15.6;9.9
973;2021-06-13;214;268;45521;29045;15.7;10.0
973;2021-06-14;377;549;45898;29594;15.8;10.2
973;2021-06-15;376;444;46274;30038;15.9;10.3
973;2021-06-16;461;459;46735;30497;16.1;10.5
973;2021-06-17;404;577;47139;31074;16.2;10.7
973;2021-06-18;363;564;47502;31638;16.3;10.9
973;2021-06-19;234;260;47736;31898;16.4;11.0
973;2021-06-20;126;270;47862;32168;16.5;11.1
973;2021-06-21;286;603;48148;32771;16.6;11.3
973;2021-06-22;329;459;48477;33230;16.7;11.4
973;2021-06-23;298;538;48775;33768;16.8;11.6
973;2021-06-24;404;501;49179;34269;16.9;11.8
973;2021-06-25;403;555;49582;34824;17.1;12.0
973;2021-06-26;172;320;49754;35144;17.1;12.1
973;2021-06-27;121;170;49875;35314;17.2;12.1
973;2021-06-28;285;592;50160;35906;17.3;12.4
973;2021-06-29;342;507;50502;36413;17.4;12.5
973;2021-06-30;372;677;50874;37090;17.5;12.8
973;2021-07-01;374;400;51248;37490;17.6;12.9
973;2021-07-02;411;521;51659;38011;17.8;13.1
973;2021-07-03;207;274;51866;38285;17.8;13.2
973;2021-07-04;86;243;51952;38528;17.9;13.3
973;2021-07-05;322;547;52274;39075;18.0;13.4
973;2021-07-06;314;474;52588;39549;18.1;13.6
973;2021-07-07;315;412;52903;39961;18.2;13.7
973;2021-07-08;267;329;53170;40290;18.3;13.9
973;2021-07-09;358;436;53528;40726;18.4;14.0
973;2021-07-10;164;277;53692;41003;18.5;14.1
973;2021-07-11;102;164;53794;41167;18.5;14.2
973;2021-07-12;365;496;54159;41663;18.6;14.3
973;2021-07-13;653;556;54812;42219;18.9;14.5
973;2021-07-14;375;157;55187;42376;19.0;14.6
973;2021-07-15;617;525;55804;42901;19.2;14.8
973;2021-07-16;570;484;56374;43385;19.4;14.9
973;2021-07-17;336;283;56710;43668;19.5;15.0
973;2021-07-18;249;120;56959;43788;19.6;15.1
973;2021-07-19;494;454;57453;44242;19.8;15.2
973;2021-07-20;521;488;57974;44730;19.9;15.4
973;2021-07-21;507;386;58481;45116;20.1;15.5
973;2021-07-22;617;448;59098;45564;20.3;15.7
973;2021-07-23;573;364;59671;45928;20.5;15.8
973;2021-07-24;321;237;59992;46165;20.6;15.9
973;2021-07-25;161;110;60153;46275;20.7;15.9
973;2021-07-26;417;344;60570;46619;20.8;16.0
973;2021-07-27;468;355;61038;46974;21.0;16.2
973;2021-07-28;384;370;61422;47344;21.1;16.3
973;2021-07-29;468;427;61890;47771;21.3;16.4
973;2021-07-30;433;399;62323;48170;21.4;16.6
973;2021-07-31;204;163;62527;48333;21.5;16.6
973;2021-08-01;139;131;62666;48464;21.6;16.7
973;2021-08-02;376;425;63042;48889;21.7;16.8
973;2021-08-03;387;393;63429;49282;21.8;17.0
973;2021-08-04;276;370;63705;49652;21.9;17.1
973;2021-08-05;302;347;64007;49999;22.0;17.2
974;2020-12-27;0;0;0;0;0.0;0.0
974;2020-12-28;0;0;0;0;0.0;0.0
974;2020-12-29;0;0;0;0;0.0;0.0
974;2020-12-30;0;0;0;0;0.0;0.0
974;2020-12-31;0;0;0;0;0.0;0.0
974;2021-01-01;1;0;1;0;0.0;0.0
974;2021-01-02;0;0;1;0;0.0;0.0
974;2021-01-03;0;0;1;0;0.0;0.0
974;2021-01-04;0;0;1;0;0.0;0.0
974;2021-01-05;2;0;3;0;0.0;0.0
974;2021-01-06;0;0;3;0;0.0;0.0
974;2021-01-07;0;0;3;0;0.0;0.0
974;2021-01-08;0;0;3;0;0.0;0.0
974;2021-01-09;1;0;4;0;0.0;0.0
974;2021-01-10;0;0;4;0;0.0;0.0
974;2021-01-11;0;0;4;0;0.0;0.0
974;2021-01-12;0;0;4;0;0.0;0.0
974;2021-01-13;0;0;4;0;0.0;0.0
974;2021-01-14;0;0;4;0;0.0;0.0
974;2021-01-15;332;0;336;0;0.0;0.0
974;2021-01-16;27;0;363;0;0.0;0.0
974;2021-01-17;0;0;363;0;0.0;0.0
974;2021-01-18;49;1;412;1;0.0;0.0
974;2021-01-19;393;0;805;1;0.1;0.0
974;2021-01-20;481;1;1286;2;0.1;0.0
974;2021-01-21;614;2;1900;4;0.2;0.0
974;2021-01-22;412;1;2312;5;0.3;0.0
974;2021-01-23;75;0;2387;5;0.3;0.0
974;2021-01-24;0;0;2387;5;0.3;0.0
974;2021-01-25;273;2;2660;7;0.3;0.0
974;2021-01-26;429;0;3089;7;0.4;0.0
974;2021-01-27;317;0;3406;7;0.4;0.0
974;2021-01-28;408;0;3814;7;0.4;0.0
974;2021-01-29;422;3;4236;10;0.5;0.0
974;2021-01-30;421;1;4657;11;0.5;0.0
974;2021-01-31;0;0;4657;11;0.5;0.0
974;2021-02-01;372;3;5029;14;0.6;0.0
974;2021-02-02;500;4;5529;18;0.6;0.0
974;2021-02-03;602;14;6131;32;0.7;0.0
974;2021-02-04;627;21;6758;53;0.8;0.0
974;2021-02-05;564;97;7322;150;0.9;0.0
974;2021-02-06;501;5;7823;155;0.9;0.0
974;2021-02-07;0;8;7823;163;0.9;0.0
974;2021-02-08;472;34;8295;197;1.0;0.0
974;2021-02-09;786;92;9081;289;1.1;0.0
974;2021-02-10;820;87;9901;376;1.2;0.0
974;2021-02-11;796;88;10697;464;1.2;0.1
974;2021-02-12;637;93;11334;557;1.3;0.1
974;2021-02-13;653;75;11987;632;1.4;0.1
974;2021-02-14;1;0;11988;632;1.4;0.1
974;2021-02-15;524;126;12512;758;1.5;0.1
974;2021-02-16;651;535;13163;1293;1.5;0.2
974;2021-02-17;592;327;13755;1620;1.6;0.2
974;2021-02-18;494;411;14249;2031;1.7;0.2
974;2021-02-19;497;319;14746;2350;1.7;0.3
974;2021-02-20;577;117;15323;2467;1.8;0.3
974;2021-02-21;0;0;15323;2467;1.8;0.3
974;2021-02-22;402;237;15725;2704;1.8;0.3
974;2021-02-23;607;239;16332;2943;1.9;0.3
974;2021-02-24;584;252;16916;3195;2.0;0.4
974;2021-02-25;647;296;17563;3491;2.0;0.4
974;2021-02-26;485;471;18048;3962;2.1;0.5
974;2021-02-27;384;468;18432;4430;2.1;0.5
974;2021-02-28;0;0;18432;4430;2.1;0.5
974;2021-03-01;293;385;18725;4815;2.2;0.6
974;2021-03-02;485;503;19210;5318;2.2;0.6
974;2021-03-03;757;539;19967;5857;2.3;0.7
974;2021-03-04;777;493;20744;6350;2.4;0.7
974;2021-03-05;727;523;21471;6873;2.5;0.8
974;2021-03-06;812;526;22283;7399;2.6;0.9
974;2021-03-07;0;0;22283;7399;2.6;0.9
974;2021-03-08;436;558;22719;7957;2.6;0.9
974;2021-03-09;671;770;23390;8727;2.7;1.0
974;2021-03-10;643;838;24033;9565;2.8;1.1
974;2021-03-11;701;638;24734;10203;2.9;1.2
974;2021-03-12;730;653;25464;10856;3.0;1.3
974;2021-03-13;668;603;26132;11459;3.0;1.3
974;2021-03-14;2;0;26134;11459;3.0;1.3
974;2021-03-15;506;502;26640;11961;3.1;1.4
974;2021-03-16;681;690;27321;12651;3.2;1.5
974;2021-03-17;848;532;28169;13183;3.3;1.5
974;2021-03-18;1022;539;29191;13722;3.4;1.6
974;2021-03-19;785;534;29976;14256;3.5;1.7
974;2021-03-20;578;596;30554;14852;3.6;1.7
974;2021-03-21;0;0;30554;14852;3.6;1.7
974;2021-03-22;566;468;31120;15320;3.6;1.8
974;2021-03-23;780;640;31900;15960;3.7;1.9
974;2021-03-24;792;644;32692;16604;3.8;1.9
974;2021-03-25;932;537;33624;17141;3.9;2.0
974;2021-03-26;922;451;34546;17592;4.0;2.0
974;2021-03-27;782;337;35328;17929;4.1;2.1
974;2021-03-28;1;0;35329;17929;4.1;2.1
974;2021-03-29;961;270;36290;18199;4.2;2.1
974;2021-03-30;884;497;37174;18696;4.3;2.2
974;2021-03-31;740;661;37914;19357;4.4;2.3
974;2021-04-01;716;708;38630;20065;4.5;2.3
974;2021-04-02;688;758;39318;20823;4.6;2.4
974;2021-04-03;699;701;40017;21524;4.7;2.5
974;2021-04-04;0;0;40017;21524;4.7;2.5
974;2021-04-05;0;0;40017;21524;4.7;2.5
974;2021-04-06;795;634;40812;22158;4.7;2.6
974;2021-04-07;1368;789;42180;22947;4.9;2.7
974;2021-04-08;1792;769;43972;23716;5.1;2.8
974;2021-04-09;1509;780;45481;24496;5.3;2.8
974;2021-04-10;1138;647;46619;25143;5.4;2.9
974;2021-04-11;2;0;46621;25143;5.4;2.9
974;2021-04-12;1238;544;47859;25687;5.6;3.0
974;2021-04-13;1439;751;49298;26438;5.7;3.1
974;2021-04-14;2070;763;51368;27201;6.0;3.2
974;2021-04-15;2506;954;53874;28155;6.3;3.3
974;2021-04-16;1933;784;55807;28939;6.5;3.4
974;2021-04-17;1290;603;57097;29542;6.6;3.4
974;2021-04-18;0;0;57097;29542;6.6;3.4
974;2021-04-19;1374;564;58471;30106;6.8;3.5
974;2021-04-20;1651;805;60122;30911;7.0;3.6
974;2021-04-21;2126;626;62248;31537;7.2;3.7
974;2021-04-22;2949;817;65197;32354;7.6;3.8
974;2021-04-23;2312;817;67509;33171;7.9;3.9
974;2021-04-24;1109;800;68618;33971;8.0;4.0
974;2021-04-25;3;0;68621;33971;8.0;4.0
974;2021-04-26;1172;915;69793;34886;8.1;4.1
974;2021-04-27;1685;1028;71478;35914;8.3;4.2
974;2021-04-28;2897;749;74375;36663;8.6;4.3
974;2021-04-29;3947;810;78322;37473;9.1;4.4
974;2021-04-30;3442;905;81764;38378;9.5;4.5
974;2021-05-01;2106;225;83870;38603;9.8;4.5
974;2021-05-02;1;0;83871;38603;9.8;4.5
974;2021-05-03;1865;574;85736;39177;10.0;4.6
974;2021-05-04;2128;1095;87864;40272;10.2;4.7
974;2021-05-05;3118;1638;90982;41910;10.6;4.9
974;2021-05-06;4004;1587;94986;43497;11.0;5.1
974;2021-05-07;3228;1525;98214;45022;11.4;5.2
974;2021-05-08;1572;503;99786;45525;11.6;5.3
974;2021-05-09;2;1;99788;45526;11.6;5.3
974;2021-05-10;2412;998;102200;46524;11.9;5.4
974;2021-05-11;3652;1639;105852;48163;12.3;5.6
974;2021-05-12;4722;2398;110574;50561;12.9;5.9
974;2021-05-13;3554;595;114128;51156;13.3;5.9
974;2021-05-14;5269;2509;119397;53665;13.9;6.2
974;2021-05-15;3161;1540;122558;55205;14.3;6.4
974;2021-05-16;15;18;122573;55223;14.3;6.4
974;2021-05-17;2998;1496;125571;56719;14.6;6.6
974;2021-05-18;3760;1795;129331;58514;15.0;6.8
974;2021-05-19;4689;2405;134020;60919;15.6;7.1
974;2021-05-20;5139;2850;139159;63769;16.2;7.4
974;2021-05-21;4992;2633;144151;66402;16.8;7.7
974;2021-05-22;3369;1256;147520;67658;17.2;7.9
974;2021-05-23;5;3;147525;67661;17.2;7.9
974;2021-05-24;3643;1076;151168;68737;17.6;8.0
974;2021-05-25;4247;1909;155415;70646;18.1;8.2
974;2021-05-26;4993;2980;160408;73626;18.7;8.6
974;2021-05-27;4615;4088;165023;77714;19.2;9.0
974;2021-05-28;4381;3829;169404;81543;19.7;9.5
974;2021-05-29;2556;2454;171960;83997;20.0;9.8
974;2021-05-30;8;14;171968;84011;20.0;9.8
974;2021-05-31;2348;2252;174316;86263;20.3;10.0
974;2021-06-01;3301;2745;177617;89008;20.7;10.4
974;2021-06-02;3975;3352;181592;92360;21.1;10.7
974;2021-06-03;4046;3651;185638;96011;21.6;11.2
974;2021-06-04;3847;3755;189485;99766;22.0;11.6
974;2021-06-05;2213;1924;191698;101690;22.3;11.8
974;2021-06-06;1072;132;192770;101822;22.4;11.8
974;2021-06-07;2013;2527;194783;104349;22.7;12.1
974;2021-06-08;2556;3336;197339;107685;22.9;12.5
974;2021-06-09;2982;4835;200321;112520;23.3;13.1
974;2021-06-10;3413;4456;203734;116976;23.7;13.6
974;2021-06-11;2841;4622;206575;121598;24.0;14.1
974;2021-06-12;1726;3378;208301;124976;24.2;14.5
974;2021-06-13;1323;244;209624;125220;24.4;14.6
974;2021-06-14;1491;3183;211115;128403;24.5;14.9
974;2021-06-15;2058;3617;213173;132020;24.8;15.4
974;2021-06-16;2751;4651;215924;136671;25.1;15.9
974;2021-06-17;2518;4898;218442;141569;25.4;16.5
974;2021-06-18;2592;4892;221034;146461;25.7;17.0
974;2021-06-19;1305;3517;222339;149978;25.9;17.4
974;2021-06-20;632;288;222971;150266;25.9;17.5
974;2021-06-21;1265;3231;224236;153497;26.1;17.8
974;2021-06-22;1622;3765;225858;157262;26.3;18.3
974;2021-06-23;2252;4991;228110;162253;26.5;18.9
974;2021-06-24;2284;4071;230394;166324;26.8;19.3
974;2021-06-25;2190;4107;232584;170431;27.0;19.8
974;2021-06-26;1400;2709;233984;173140;27.2;20.1
974;2021-06-27;665;265;234649;173405;27.3;20.2
974;2021-06-28;1307;2479;235956;175884;27.4;20.5
974;2021-06-29;1758;2844;237714;178728;27.6;20.8
974;2021-06-30;2558;3846;240272;182574;27.9;21.2
974;2021-07-01;2690;3826;242962;186400;28.3;21.7
974;2021-07-02;2504;3710;245466;190110;28.5;22.1
974;2021-07-03;1611;2458;247077;192568;28.7;22.4
974;2021-07-04;881;1034;247958;193602;28.8;22.5
974;2021-07-05;1689;2220;249647;195822;29.0;22.8
974;2021-07-06;2566;2533;252213;198355;29.3;23.1
974;2021-07-07;2657;3138;254870;201493;29.6;23.4
974;2021-07-08;2400;3172;257270;204665;29.9;23.8
974;2021-07-09;2751;3429;260021;208094;30.2;24.2
974;2021-07-10;1612;2187;261633;210281;30.4;24.5
974;2021-07-11;729;1017;262362;211298;30.5;24.6
974;2021-07-12;1737;2607;264099;213905;30.7;24.9
974;2021-07-13;4410;3329;268509;217234;31.2;25.3
974;2021-07-14;3283;597;271792;217831;31.6;25.3
974;2021-07-15;5529;4009;277321;221840;32.2;25.8
974;2021-07-16;6184;3293;283505;225133;33.0;26.2
974;2021-07-17;4299;1904;287804;227037;33.5;26.4
974;2021-07-18;2659;754;290463;227791;33.8;26.5
974;2021-07-19;4606;2018;295069;229809;34.3;26.7
974;2021-07-20;6196;2408;301265;232217;35.0;27.0
974;2021-07-21;6685;2847;307950;235064;35.8;27.3
974;2021-07-22;7045;2812;314995;237876;36.6;27.7
974;2021-07-23;6582;2976;321577;240852;37.4;28.0
974;2021-07-24;3773;2056;325350;242908;37.8;28.2
974;2021-07-25;2513;758;327863;243666;38.1;28.3
974;2021-07-26;4314;2083;332177;245749;38.6;28.6
974;2021-07-27;5355;2544;337532;248293;39.2;28.9
974;2021-07-28;5312;2882;342844;251175;39.9;29.2
974;2021-07-29;5692;2796;348536;253971;40.5;29.5
974;2021-07-30;5819;2573;354355;256544;41.2;29.8
974;2021-07-31;3896;1635;358251;258179;41.7;30.0
974;2021-08-01;1882;711;360133;258890;41.9;30.1
974;2021-08-02;3369;1856;363502;260746;42.3;30.3
974;2021-08-03;4232;4061;367734;264807;42.8;30.8
974;2021-08-04;4777;4208;372511;269015;43.3;31.3
974;2021-08-05;4309;4644;376820;273659;43.8;31.8
975;2020-12-27;0;0;0;0;0.0;0.0
975;2020-12-28;0;0;0;0;0.0;0.0
975;2020-12-29;0;0;0;0;0.0;0.0
975;2020-12-30;0;0;0;0;0.0;0.0
975;2020-12-31;0;0;0;0;0.0;0.0
975;2021-01-01;0;0;0;0;0.0;0.0
975;2021-01-02;0;0;0;0;0.0;0.0
975;2021-01-03;0;0;0;0;0.0;0.0
975;2021-01-04;0;0;0;0;0.0;0.0
975;2021-01-05;0;0;0;0;0.0;0.0
975;2021-01-06;0;0;0;0;0.0;0.0
975;2021-01-07;0;0;0;0;0.0;0.0
975;2021-01-08;0;0;0;0;0.0;0.0
975;2021-01-09;0;0;0;0;0.0;0.0
975;2021-01-10;0;0;0;0;0.0;0.0
975;2021-01-11;0;0;0;0;0.0;0.0
975;2021-01-12;0;0;0;0;0.0;0.0
975;2021-01-13;0;0;0;0;0.0;0.0
975;2021-01-14;0;0;0;0;0.0;0.0
975;2021-01-15;0;0;0;0;0.0;0.0
975;2021-01-16;0;0;0;0;0.0;0.0
975;2021-01-17;0;0;0;0;0.0;0.0
975;2021-01-18;0;0;0;0;0.0;0.0
975;2021-01-19;0;0;0;0;0.0;0.0
975;2021-01-20;0;0;0;0;0.0;0.0
975;2021-01-21;0;0;0;0;0.0;0.0
975;2021-01-22;0;0;0;0;0.0;0.0
975;2021-01-23;0;0;0;0;0.0;0.0
975;2021-01-24;0;0;0;0;0.0;0.0
975;2021-01-25;0;0;0;0;0.0;0.0
975;2021-01-26;0;0;0;0;0.0;0.0
975;2021-01-27;0;0;0;0;0.0;0.0
975;2021-01-28;0;0;0;0;0.0;0.0
975;2021-01-29;0;0;0;0;0.0;0.0
975;2021-01-30;0;0;0;0;0.0;0.0
975;2021-01-31;0;0;0;0;0.0;0.0
975;2021-02-01;0;0;0;0;0.0;0.0
975;2021-02-02;0;0;0;0;0.0;0.0
975;2021-02-03;0;0;0;0;0.0;0.0
975;2021-02-04;0;0;0;0;0.0;0.0
975;2021-02-05;0;0;0;0;0.0;0.0
975;2021-02-06;0;0;0;0;0.0;0.0
975;2021-02-07;0;0;0;0;0.0;0.0
975;2021-02-08;0;0;0;0;0.0;0.0
975;2021-02-09;0;0;0;0;0.0;0.0
975;2021-02-10;0;0;0;0;0.0;0.0
975;2021-02-11;0;0;0;0;0.0;0.0
975;2021-02-12;0;0;0;0;0.0;0.0
975;2021-02-13;0;0;0;0;0.0;0.0
975;2021-02-14;0;0;0;0;0.0;0.0
975;2021-02-15;0;0;0;0;0.0;0.0
975;2021-02-16;0;0;0;0;0.0;0.0
975;2021-02-17;0;0;0;0;0.0;0.0
975;2021-02-18;0;0;0;0;0.0;0.0
975;2021-02-19;0;0;0;0;0.0;0.0
975;2021-02-20;0;0;0;0;0.0;0.0
975;2021-02-21;0;0;0;0;0.0;0.0
975;2021-02-22;0;0;0;0;0.0;0.0
975;2021-02-23;0;0;0;0;0.0;0.0
975;2021-02-24;0;0;0;0;0.0;0.0
975;2021-02-25;0;0;0;0;0.0;0.0
975;2021-02-26;0;0;0;0;0.0;0.0
975;2021-02-27;0;0;0;0;0.0;0.0
975;2021-02-28;0;0;0;0;0.0;0.0
975;2021-03-01;0;0;0;0;0.0;0.0
975;2021-03-02;0;0;0;0;0.0;0.0
975;2021-03-03;0;0;0;0;0.0;0.0
975;2021-03-04;0;0;0;0;0.0;0.0
975;2021-03-05;0;0;0;0;0.0;0.0
975;2021-03-06;0;0;0;0;0.0;0.0
975;2021-03-07;0;0;0;0;0.0;0.0
975;2021-03-08;0;0;0;0;0.0;0.0
975;2021-03-09;0;0;0;0;0.0;0.0
975;2021-03-10;0;0;0;0;0.0;0.0
975;2021-03-11;0;0;0;0;0.0;0.0
975;2021-03-12;0;0;0;0;0.0;0.0
975;2021-03-13;0;0;0;0;0.0;0.0
975;2021-03-14;0;0;0;0;0.0;0.0
975;2021-03-15;0;0;0;0;0.0;0.0
975;2021-03-16;0;0;0;0;0.0;0.0
975;2021-03-17;0;0;0;0;0.0;0.0
975;2021-03-18;0;0;0;0;0.0;0.0
975;2021-03-19;0;0;0;0;0.0;0.0
975;2021-03-20;0;0;0;0;0.0;0.0
975;2021-03-21;0;0;0;0;0.0;0.0
975;2021-03-22;0;0;0;0;0.0;0.0
975;2021-03-23;0;0;0;0;0.0;0.0
975;2021-03-24;0;0;0;0;0.0;0.0
975;2021-03-25;0;0;0;0;0.0;0.0
975;2021-03-26;0;0;0;0;0.0;0.0
975;2021-03-27;0;0;0;0;0.0;0.0
975;2021-03-28;0;0;0;0;0.0;0.0
975;2021-03-29;2;0;2;0;0.0;0.0
975;2021-03-30;0;0;2;0;0.0;0.0
975;2021-03-31;0;0;2;0;0.0;0.0
975;2021-04-01;0;0;2;0;0.0;0.0
975;2021-04-02;0;0;2;0;0.0;0.0
975;2021-04-03;0;0;2;0;0.0;0.0
975;2021-04-04;0;0;2;0;0.0;0.0
975;2021-04-05;0;0;2;0;0.0;0.0
975;2021-04-06;0;0;2;0;0.0;0.0
975;2021-04-07;0;0;2;0;0.0;0.0
975;2021-04-08;1;0;3;0;0.1;0.0
975;2021-04-09;0;0;3;0;0.1;0.0
975;2021-04-10;0;0;3;0;0.1;0.0
975;2021-04-11;0;0;3;0;0.1;0.0
975;2021-04-12;0;0;3;0;0.1;0.0
975;2021-04-13;0;0;3;0;0.1;0.0
975;2021-04-14;0;0;3;0;0.1;0.0
975;2021-04-15;0;0;3;0;0.1;0.0
975;2021-04-16;0;0;3;0;0.1;0.0
975;2021-04-17;0;0;3;0;0.1;0.0
975;2021-04-18;0;0;3;0;0.1;0.0
975;2021-04-19;0;0;3;0;0.1;0.0
975;2021-04-20;0;0;3;0;0.1;0.0
975;2021-04-21;0;0;3;0;0.1;0.0
975;2021-04-22;0;0;3;0;0.1;0.0
975;2021-04-23;0;0;3;0;0.1;0.0
975;2021-04-24;0;0;3;0;0.1;0.0
975;2021-04-25;0;0;3;0;0.1;0.0
975;2021-04-26;0;0;3;0;0.1;0.0
975;2021-04-27;0;0;3;0;0.1;0.0
975;2021-04-28;0;0;3;0;0.1;0.0
975;2021-04-29;0;0;3;0;0.1;0.0
975;2021-04-30;0;0;3;0;0.1;0.0
975;2021-05-01;0;0;3;0;0.1;0.0
975;2021-05-02;0;0;3;0;0.1;0.0
975;2021-05-03;0;0;3;0;0.1;0.0
975;2021-05-04;0;0;3;0;0.1;0.0
975;2021-05-05;0;0;3;0;0.1;0.0
975;2021-05-06;0;0;3;0;0.1;0.0
975;2021-05-07;0;0;3;0;0.1;0.0
975;2021-05-08;0;0;3;0;0.1;0.0
975;2021-05-09;0;0;3;0;0.1;0.0
975;2021-05-10;0;0;3;0;0.1;0.0
975;2021-05-11;0;0;3;0;0.1;0.0
975;2021-05-12;0;0;3;0;0.1;0.0
975;2021-05-13;0;0;3;0;0.1;0.0
975;2021-05-14;0;0;3;0;0.1;0.0
975;2021-05-15;0;0;3;0;0.1;0.0
975;2021-05-16;0;0;3;0;0.1;0.0
975;2021-05-17;0;0;3;0;0.1;0.0
975;2021-05-18;0;0;3;0;0.1;0.0
975;2021-05-19;0;0;3;0;0.1;0.0
975;2021-05-20;0;0;3;0;0.1;0.0
975;2021-05-21;0;0;3;0;0.1;0.0
975;2021-05-22;0;0;3;0;0.1;0.0
975;2021-05-23;0;0;3;0;0.1;0.0
975;2021-05-24;0;0;3;0;0.1;0.0
975;2021-05-25;0;0;3;0;0.1;0.0
975;2021-05-26;0;0;3;0;0.1;0.0
975;2021-05-27;0;0;3;0;0.1;0.0
975;2021-05-28;0;0;3;0;0.1;0.0
975;2021-05-29;0;2;3;2;0.1;0.0
975;2021-05-30;0;0;3;2;0.1;0.0
975;2021-05-31;0;0;3;2;0.1;0.0
975;2021-06-01;0;0;3;2;0.1;0.0
975;2021-06-02;0;0;3;2;0.1;0.0
975;2021-06-03;0;0;3;2;0.1;0.0
975;2021-06-04;0;0;3;2;0.1;0.0
975;2021-06-05;0;0;3;2;0.1;0.0
975;2021-06-06;0;0;3;2;0.1;0.0
975;2021-06-07;0;0;3;2;0.1;0.0
975;2021-06-08;0;0;3;2;0.1;0.0
975;2021-06-09;0;0;3;2;0.1;0.0
975;2021-06-10;0;0;3;2;0.1;0.0
975;2021-06-11;0;0;3;2;0.1;0.0
975;2021-06-12;0;0;3;2;0.1;0.0
975;2021-06-13;0;0;3;2;0.1;0.0
975;2021-06-14;0;0;3;2;0.1;0.0
975;2021-06-15;0;0;3;2;0.1;0.0
975;2021-06-16;0;0;3;2;0.1;0.0
975;2021-06-17;0;0;3;2;0.1;0.0
975;2021-06-18;0;0;3;2;0.1;0.0
975;2021-06-19;0;0;3;2;0.1;0.0
975;2021-06-20;0;0;3;2;0.1;0.0
975;2021-06-21;1;0;4;2;0.1;0.0
975;2021-06-22;0;0;4;2;0.1;0.0
975;2021-06-23;0;0;4;2;0.1;0.0
975;2021-06-24;0;0;4;2;0.1;0.0
975;2021-06-25;0;0;4;2;0.1;0.0
975;2021-06-26;0;0;4;2;0.1;0.0
975;2021-06-27;0;0;4;2;0.1;0.0
975;2021-06-28;0;0;4;2;0.1;0.0
975;2021-06-29;0;0;4;2;0.1;0.0
975;2021-06-30;0;0;4;2;0.1;0.0
975;2021-07-01;0;0;4;2;0.1;0.0
975;2021-07-02;0;0;4;2;0.1;0.0
975;2021-07-03;0;0;4;2;0.1;0.0
975;2021-07-04;0;0;4;2;0.1;0.0
975;2021-07-05;0;0;4;2;0.1;0.0
975;2021-07-06;1;0;5;2;0.1;0.0
975;2021-07-07;6;0;11;2;0.2;0.0
975;2021-07-08;0;0;11;2;0.2;0.0
975;2021-07-09;0;0;11;2;0.2;0.0
975;2021-07-10;0;0;11;2;0.2;0.0
975;2021-07-11;0;0;11;2;0.2;0.0
975;2021-07-12;0;0;11;2;0.2;0.0
975;2021-07-13;0;0;11;2;0.2;0.0
975;2021-07-14;0;0;11;2;0.2;0.0
975;2021-07-15;0;0;11;2;0.2;0.0
975;2021-07-16;0;0;11;2;0.2;0.0
975;2021-07-17;0;0;11;2;0.2;0.0
975;2021-07-18;0;0;11;2;0.2;0.0
975;2021-07-19;0;0;11;2;0.2;0.0
975;2021-07-20;0;0;11;2;0.2;0.0
975;2021-07-21;0;0;11;2;0.2;0.0
975;2021-07-22;0;0;11;2;0.2;0.0
975;2021-07-23;0;0;11;2;0.2;0.0
975;2021-07-24;0;0;11;2;0.2;0.0
975;2021-07-25;0;0;11;2;0.2;0.0
975;2021-07-26;0;0;11;2;0.2;0.0
975;2021-07-27;0;0;11;2;0.2;0.0
975;2021-07-28;0;0;11;2;0.2;0.0
975;2021-07-29;0;0;11;2;0.2;0.0
975;2021-07-30;0;0;11;2;0.2;0.0
975;2021-07-31;0;0;11;2;0.2;0.0
975;2021-08-01;0;0;11;2;0.2;0.0
975;2021-08-02;1;0;12;2;0.2;0.0
975;2021-08-03;0;0;12;2;0.2;0.0
975;2021-08-04;0;0;12;2;0.2;0.0
975;2021-08-05;0;0;12;2;0.2;0.0
976;2020-12-27;0;0;0;0;0.0;0.0
976;2020-12-28;0;0;0;0;0.0;0.0
976;2020-12-29;0;0;0;0;0.0;0.0
976;2020-12-30;0;0;0;0;0.0;0.0
976;2020-12-31;0;0;0;0;0.0;0.0
976;2021-01-01;0;0;0;0;0.0;0.0
976;2021-01-02;0;0;0;0;0.0;0.0
976;2021-01-03;0;0;0;0;0.0;0.0
976;2021-01-04;0;0;0;0;0.0;0.0
976;2021-01-05;0;0;0;0;0.0;0.0
976;2021-01-06;0;0;0;0;0.0;0.0
976;2021-01-07;0;0;0;0;0.0;0.0
976;2021-01-08;0;0;0;0;0.0;0.0
976;2021-01-09;0;0;0;0;0.0;0.0
976;2021-01-10;0;0;0;0;0.0;0.0
976;2021-01-11;9;0;9;0;0.0;0.0
976;2021-01-12;0;0;9;0;0.0;0.0
976;2021-01-13;0;0;9;0;0.0;0.0
976;2021-01-14;0;0;9;0;0.0;0.0
976;2021-01-15;1;0;10;0;0.0;0.0
976;2021-01-16;1;0;11;0;0.0;0.0
976;2021-01-17;0;0;11;0;0.0;0.0
976;2021-01-18;1;0;12;0;0.0;0.0
976;2021-01-19;0;0;12;0;0.0;0.0
976;2021-01-20;0;0;12;0;0.0;0.0
976;2021-01-21;0;0;12;0;0.0;0.0
976;2021-01-22;0;0;12;0;0.0;0.0
976;2021-01-23;1;0;13;0;0.0;0.0
976;2021-01-24;0;0;13;0;0.0;0.0
976;2021-01-25;141;2;154;2;0.1;0.0
976;2021-01-26;165;3;319;5;0.1;0.0
976;2021-01-27;251;3;570;8;0.2;0.0
976;2021-01-28;102;8;672;16;0.2;0.0
976;2021-01-29;231;2;903;18;0.3;0.0
976;2021-01-30;285;11;1188;29;0.4;0.0
976;2021-01-31;1;0;1189;29;0.4;0.0
976;2021-02-01;160;0;1349;29;0.5;0.0
976;2021-02-02;330;8;1679;37;0.6;0.0
976;2021-02-03;228;3;1907;40;0.7;0.0
976;2021-02-04;216;9;2123;49;0.8;0.0
976;2021-02-05;214;1;2337;50;0.8;0.0
976;2021-02-06;83;10;2420;60;0.9;0.0
976;2021-02-07;0;0;2420;60;0.9;0.0
976;2021-02-08;82;4;2502;64;0.9;0.0
976;2021-02-09;193;1;2695;65;1.0;0.0
976;2021-02-10;187;4;2882;69;1.0;0.0
976;2021-02-11;236;4;3118;73;1.1;0.0
976;2021-02-12;287;4;3405;77;1.2;0.0
976;2021-02-13;56;0;3461;77;1.2;0.0
976;2021-02-14;1;0;3462;77;1.2;0.0
976;2021-02-15;359;6;3821;83;1.4;0.0
976;2021-02-16;266;10;4087;93;1.5;0.0
976;2021-02-17;167;7;4254;100;1.5;0.0
976;2021-02-18;217;12;4471;112;1.6;0.0
976;2021-02-19;237;24;4708;136;1.7;0.0
976;2021-02-20;139;8;4847;144;1.7;0.1
976;2021-02-21;0;0;4847;144;1.7;0.1
976;2021-02-22;130;122;4977;266;1.8;0.1
976;2021-02-23;185;155;5162;421;1.8;0.2
976;2021-02-24;176;145;5338;566;1.9;0.2
976;2021-02-25;227;277;5565;843;2.0;0.3
976;2021-02-26;242;247;5807;1090;2.1;0.4
976;2021-02-27;0;0;5807;1090;2.1;0.4
976;2021-02-28;0;0;5807;1090;2.1;0.4
976;2021-03-01;145;259;5952;1349;2.1;0.5
976;2021-03-02;228;260;6180;1609;2.2;0.6
976;2021-03-03;202;189;6382;1798;2.3;0.6
976;2021-03-04;205;143;6587;1941;2.4;0.7
976;2021-03-05;224;113;6811;2054;2.4;0.7
976;2021-03-06;1;0;6812;2054;2.4;0.7
976;2021-03-07;0;0;6812;2054;2.4;0.7
976;2021-03-08;189;109;7001;2163;2.5;0.8
976;2021-03-09;391;161;7392;2324;2.6;0.8
976;2021-03-10;180;178;7572;2502;2.7;0.9
976;2021-03-11;167;207;7739;2709;2.8;1.0
976;2021-03-12;237;292;7976;3001;2.9;1.1
976;2021-03-13;2;0;7978;3001;2.9;1.1
976;2021-03-14;0;0;7978;3001;2.9;1.1
976;2021-03-15;157;293;8135;3294;2.9;1.2
976;2021-03-16;237;223;8372;3517;3.0;1.3
976;2021-03-17;264;143;8636;3660;3.1;1.3
976;2021-03-18;173;236;8809;3896;3.2;1.4
976;2021-03-19;172;298;8981;4194;3.2;1.5
976;2021-03-20;0;0;8981;4194;3.2;1.5
976;2021-03-21;0;0;8981;4194;3.2;1.5
976;2021-03-22;98;136;9079;4330;3.2;1.5
976;2021-03-23;136;240;9215;4570;3.3;1.6
976;2021-03-24;160;146;9375;4716;3.4;1.7
976;2021-03-25;186;206;9561;4922;3.4;1.8
976;2021-03-26;160;212;9721;5134;3.5;1.8
976;2021-03-27;18;0;9739;5134;3.5;1.8
976;2021-03-28;1;0;9740;5134;3.5;1.8
976;2021-03-29;0;2;9740;5136;3.5;1.8
976;2021-03-30;272;335;10012;5471;3.6;2.0
976;2021-03-31;224;125;10236;5596;3.7;2.0
976;2021-04-01;244;103;10480;5699;3.7;2.0
976;2021-04-02;288;263;10768;5962;3.9;2.1
976;2021-04-03;905;307;11673;6269;4.2;2.2
976;2021-04-04;1;0;11674;6269;4.2;2.2
976;2021-04-05;1;0;11675;6269;4.2;2.2
976;2021-04-06;162;278;11837;6547;4.2;2.3
976;2021-04-07;237;266;12074;6813;4.3;2.4
976;2021-04-08;285;140;12359;6953;4.4;2.5
976;2021-04-09;248;171;12607;7124;4.5;2.5
976;2021-04-10;181;114;12788;7238;4.6;2.6
976;2021-04-11;7;0;12795;7238;4.6;2.6
976;2021-04-12;0;19;12795;7257;4.6;2.6
976;2021-04-13;394;344;13189;7601;4.7;2.7
976;2021-04-14;239;205;13428;7806;4.8;2.8
976;2021-04-15;208;117;13636;7923;4.9;2.8
976;2021-04-16;214;127;13850;8050;5.0;2.9
976;2021-04-17;226;131;14076;8181;5.0;2.9
976;2021-04-18;1;0;14077;8181;5.0;2.9
976;2021-04-19;7;1;14084;8182;5.0;2.9
976;2021-04-20;369;224;14453;8406;5.2;3.0
976;2021-04-21;413;150;14866;8556;5.3;3.1
976;2021-04-22;410;151;15276;8707;5.5;3.1
976;2021-04-23;367;166;15643;8873;5.6;3.2
976;2021-04-24;413;128;16056;9001;5.7;3.2
976;2021-04-25;2;0;16058;9001;5.7;3.2
976;2021-04-26;54;8;16112;9009;5.8;3.2
976;2021-04-27;351;292;16463;9301;5.9;3.3
976;2021-04-28;355;515;16818;9816;6.0;3.5
976;2021-04-29;559;344;17377;10160;6.2;3.6
976;2021-04-30;404;238;17781;10398;6.4;3.7
976;2021-05-01;672;285;18453;10683;6.6;3.8
976;2021-05-02;0;0;18453;10683;6.6;3.8
976;2021-05-03;141;6;18594;10689;6.7;3.8
976;2021-05-04;353;426;18947;11115;6.8;4.0
976;2021-05-05;447;318;19394;11433;6.9;4.1
976;2021-05-06;320;201;19714;11634;7.1;4.2
976;2021-05-07;341;133;20055;11767;7.2;4.2
976;2021-05-08;302;139;20357;11906;7.3;4.3
976;2021-05-09;0;0;20357;11906;7.3;4.3
976;2021-05-10;9;9;20366;11915;7.3;4.3
976;2021-05-11;362;489;20728;12404;7.4;4.4
976;2021-05-12;333;310;21061;12714;7.5;4.5
976;2021-05-13;127;97;21188;12811;7.6;4.6
976;2021-05-14;0;0;21188;12811;7.6;4.6
976;2021-05-15;486;283;21674;13094;7.8;4.7
976;2021-05-16;1;0;21675;13094;7.8;4.7
976;2021-05-17;123;51;21798;13145;7.8;4.7
976;2021-05-18;516;430;22314;13575;8.0;4.9
976;2021-05-19;651;663;22965;14238;8.2;5.1
976;2021-05-20;1055;497;24020;14735;8.6;5.3
976;2021-05-21;1046;313;25066;15048;9.0;5.4
976;2021-05-22;1242;299;26308;15347;9.4;5.5
976;2021-05-23;0;0;26308;15347;9.4;5.5
976;2021-05-24;1;0;26309;15347;9.4;5.5
976;2021-05-25;889;623;27198;15970;9.7;5.7
976;2021-05-26;1036;841;28234;16811;10.1;6.0
976;2021-05-27;1324;510;29558;17321;10.6;6.2
976;2021-05-28;957;373;30515;17694;10.9;6.3
976;2021-05-29;1131;391;31646;18085;11.3;6.5
976;2021-05-30;1;1;31647;18086;11.3;6.5
976;2021-05-31;105;6;31752;18092;11.4;6.5
976;2021-06-01;1151;651;32903;18743;11.8;6.7
976;2021-06-02;1236;529;34139;19272;12.2;6.9
976;2021-06-03;807;352;34946;19624;12.5;7.0
976;2021-06-04;1001;323;35947;19947;12.9;7.1
976;2021-06-05;679;300;36626;20247;13.1;7.2
976;2021-06-06;1;0;36627;20247;13.1;7.2
976;2021-06-07;90;12;36717;20259;13.1;7.2
976;2021-06-08;956;444;37673;20703;13.5;7.4
976;2021-06-09;971;550;38644;21253;13.8;7.6
976;2021-06-10;697;230;39341;21483;14.1;7.7
976;2021-06-11;848;366;40189;21849;14.4;7.8
976;2021-06-12;583;276;40772;22125;14.6;7.9
976;2021-06-13;1;0;40773;22125;14.6;7.9
976;2021-06-14;186;112;40959;22237;14.7;8.0
976;2021-06-15;413;839;41372;23076;14.8;8.3
976;2021-06-16;890;1441;42262;24517;15.1;8.8
976;2021-06-17;775;657;43037;25174;15.4;9.0
976;2021-06-18;706;622;43743;25796;15.7;9.2
976;2021-06-19;537;643;44280;26439;15.8;9.5
976;2021-06-20;1;0;44281;26439;15.8;9.5
976;2021-06-21;127;130;44408;26569;15.9;9.5
976;2021-06-22;430;1150;44838;27719;16.0;9.9
976;2021-06-23;659;1185;45497;28904;16.3;10.3
976;2021-06-24;465;545;45962;29449;16.4;10.5
976;2021-06-25;542;477;46504;29926;16.6;10.7
976;2021-06-26;389;689;46893;30615;16.8;11.0
976;2021-06-27;0;0;46893;30615;16.8;11.0
976;2021-06-28;106;191;46999;30806;16.8;11.0
976;2021-06-29;711;974;47710;31780;17.1;11.4
976;2021-06-30;673;947;48383;32727;17.3;11.7
976;2021-07-01;576;546;48959;33273;17.5;11.9
976;2021-07-02;452;429;49411;33702;17.7;12.1
976;2021-07-03;446;420;49857;34122;17.8;12.2
976;2021-07-04;2;0;49859;34122;17.8;12.2
976;2021-07-05;117;224;49976;34346;17.9;12.3
976;2021-07-06;500;864;50476;35210;18.1;12.6
976;2021-07-07;767;1009;51243;36219;18.3;13.0
976;2021-07-08;800;634;52043;36853;18.6;13.2
976;2021-07-09;788;518;52831;37371;18.9;13.4
976;2021-07-10;439;317;53270;37688;19.1;13.5
976;2021-07-11;0;0;53270;37688;19.1;13.5
976;2021-07-12;162;172;53432;37860;19.1;13.5
976;2021-07-13;832;996;54264;38856;19.4;13.9
976;2021-07-14;0;5;54264;38861;19.4;13.9
976;2021-07-15;1203;808;55467;39669;19.8;14.2
976;2021-07-16;1285;649;56752;40318;20.3;14.4
976;2021-07-17;1030;365;57782;40683;20.7;14.6
976;2021-07-18;0;0;57782;40683;20.7;14.6
976;2021-07-19;203;133;57985;40816;20.7;14.6
976;2021-07-20;1151;867;59136;41683;21.2;14.9
976;2021-07-21;32;28;59168;41711;21.2;14.9
976;2021-07-22;1119;650;60287;42361;21.6;15.2
976;2021-07-23;1199;534;61486;42895;22.0;15.3
976;2021-07-24;847;435;62333;43330;22.3;15.5
976;2021-07-25;0;0;62333;43330;22.3;15.5
976;2021-07-26;178;36;62511;43366;22.4;15.5
976;2021-07-27;1124;820;63635;44186;22.8;15.8
976;2021-07-28;1001;633;64636;44819;23.1;16.0
976;2021-07-29;1198;554;65834;45373;23.6;16.2
976;2021-07-30;1201;403;67035;45776;24.0;16.4
976;2021-07-31;760;272;67795;46048;24.3;16.5
976;2021-08-01;0;0;67795;46048;24.3;16.5
976;2021-08-02;309;178;68104;46226;24.4;16.5
976;2021-08-03;1500;926;69604;47152;24.9;16.9
976;2021-08-04;1765;802;71369;47954;25.5;17.2
976;2021-08-05;1454;494;72823;48448;26.1;17.3
977;2020-12-27;0;0;0;0;0.0;0.0
977;2020-12-28;0;0;0;0;0.0;0.0
977;2020-12-29;0;0;0;0;0.0;0.0
977;2020-12-30;0;0;0;0;0.0;0.0
977;2020-12-31;0;0;0;0;0.0;0.0
977;2021-01-01;0;0;0;0;0.0;0.0
977;2021-01-02;0;0;0;0;0.0;0.0
977;2021-01-03;0;0;0;0;0.0;0.0
977;2021-01-04;0;0;0;0;0.0;0.0
977;2021-01-05;0;0;0;0;0.0;0.0
977;2021-01-06;0;0;0;0;0.0;0.0
977;2021-01-07;0;0;0;0;0.0;0.0
977;2021-01-08;0;0;0;0;0.0;0.0
977;2021-01-09;0;0;0;0;0.0;0.0
977;2021-01-10;0;0;0;0;0.0;0.0
977;2021-01-11;0;0;0;0;0.0;0.0
977;2021-01-12;0;0;0;0;0.0;0.0
977;2021-01-13;0;0;0;0;0.0;0.0
977;2021-01-14;0;0;0;0;0.0;0.0
977;2021-01-15;0;0;0;0;0.0;0.0
977;2021-01-16;0;0;0;0;0.0;0.0
977;2021-01-17;0;0;0;0;0.0;0.0
977;2021-01-18;1;0;1;0;0.0;0.0
977;2021-01-19;0;0;1;0;0.0;0.0
977;2021-01-20;0;0;1;0;0.0;0.0
977;2021-01-21;12;0;13;0;0.1;0.0
977;2021-01-22;12;0;25;0;0.3;0.0
977;2021-01-23;0;0;25;0;0.3;0.0
977;2021-01-24;0;0;25;0;0.3;0.0
977;2021-01-25;0;0;25;0;0.3;0.0
977;2021-01-26;0;0;25;0;0.3;0.0
977;2021-01-27;12;0;37;0;0.4;0.0
977;2021-01-28;1;0;38;0;0.4;0.0
977;2021-01-29;6;0;44;0;0.4;0.0
977;2021-01-30;0;0;44;0;0.4;0.0
977;2021-01-31;0;0;44;0;0.4;0.0
977;2021-02-01;0;0;44;0;0.4;0.0
977;2021-02-02;0;0;44;0;0.4;0.0
977;2021-02-03;11;0;55;0;0.6;0.0
977;2021-02-04;12;0;67;0;0.7;0.0
977;2021-02-05;11;0;78;0;0.8;0.0
977;2021-02-06;0;0;78;0;0.8;0.0
977;2021-02-07;0;0;78;0;0.8;0.0
977;2021-02-08;0;0;78;0;0.8;0.0
977;2021-02-09;13;0;91;0;0.9;0.0
977;2021-02-10;0;0;91;0;0.9;0.0
977;2021-02-11;17;0;108;0;1.1;0.0
977;2021-02-12;45;0;153;0;1.5;0.0
977;2021-02-13;0;0;153;0;1.5;0.0
977;2021-02-14;0;0;153;0;1.5;0.0
977;2021-02-15;0;0;153;0;1.5;0.0
977;2021-02-16;0;0;153;0;1.5;0.0
977;2021-02-17;0;0;153;0;1.5;0.0
977;2021-02-18;18;0;171;0;1.7;0.0
977;2021-02-19;35;0;206;0;2.1;0.0
977;2021-02-20;0;0;206;0;2.1;0.0
977;2021-02-21;0;0;206;0;2.1;0.0
977;2021-02-22;0;0;206;0;2.1;0.0
977;2021-02-23;0;22;206;22;2.1;0.2
977;2021-02-24;0;0;206;22;2.1;0.2
977;2021-02-25;15;10;221;32;2.2;0.3
977;2021-02-26;33;20;254;52;2.5;0.5
977;2021-02-27;0;0;254;52;2.5;0.5
977;2021-02-28;0;0;254;52;2.5;0.5
977;2021-03-01;0;0;254;52;2.5;0.5
977;2021-03-02;19;11;273;63;2.7;0.6
977;2021-03-03;0;0;273;63;2.7;0.6
977;2021-03-04;16;12;289;75;2.9;0.8
977;2021-03-05;35;19;324;94;3.3;0.9
977;2021-03-06;0;0;324;94;3.3;0.9
977;2021-03-07;0;0;324;94;3.3;0.9
977;2021-03-08;0;0;324;94;3.3;0.9
977;2021-03-09;1;0;325;94;3.3;0.9
977;2021-03-10;0;0;325;94;3.3;0.9
977;2021-03-11;20;30;345;124;3.5;1.2
977;2021-03-12;62;41;407;165;4.1;1.7
977;2021-03-13;0;0;407;165;4.1;1.7
977;2021-03-14;0;0;407;165;4.1;1.7
977;2021-03-15;0;0;407;165;4.1;1.7
977;2021-03-16;30;9;437;174;4.4;1.7
977;2021-03-17;0;0;437;174;4.4;1.7
977;2021-03-18;30;16;467;190;4.7;1.9
977;2021-03-19;55;30;522;220;5.2;2.2
977;2021-03-20;0;0;522;220;5.2;2.2
977;2021-03-21;0;0;522;220;5.2;2.2
977;2021-03-22;0;0;522;220;5.2;2.2
977;2021-03-23;0;0;522;220;5.2;2.2
977;2021-03-24;0;0;522;220;5.2;2.2
977;2021-03-25;65;17;587;237;5.9;2.4
977;2021-03-26;73;26;660;263;6.6;2.6
977;2021-03-27;0;0;660;263;6.6;2.6
977;2021-03-28;0;0;660;263;6.6;2.6
977;2021-03-29;0;0;660;263;6.6;2.6
977;2021-03-30;40;18;700;281;7.0;2.8
977;2021-03-31;26;15;726;296;7.3;3.0
977;2021-04-01;25;32;751;328;7.5;3.3
977;2021-04-02;0;0;751;328;7.5;3.3
977;2021-04-03;0;0;751;328;7.5;3.3
977;2021-04-04;0;0;751;328;7.5;3.3
977;2021-04-05;9;0;760;328;7.6;3.3
977;2021-04-06;0;0;760;328;7.6;3.3
977;2021-04-07;0;0;760;328;7.6;3.3
977;2021-04-08;57;46;817;374;8.2;3.8
977;2021-04-09;58;31;875;405;8.8;4.1
977;2021-04-10;0;0;875;405;8.8;4.1
977;2021-04-11;0;0;875;405;8.8;4.1
977;2021-04-12;0;0;875;405;8.8;4.1
977;2021-04-13;0;0;875;405;8.8;4.1
977;2021-04-14;5;6;880;411;8.8;4.1
977;2021-04-15;56;71;936;482;9.4;4.8
977;2021-04-16;90;35;1026;517;10.3;5.2
977;2021-04-17;0;1;1026;518;10.3;5.2
977;2021-04-18;0;0;1026;518;10.3;5.2
977;2021-04-19;1;0;1027;518;10.3;5.2
977;2021-04-20;335;65;1362;583;13.7;5.9
977;2021-04-21;337;30;1699;613;17.1;6.2
977;2021-04-22;284;50;1983;663;19.9;6.7
977;2021-04-23;260;42;2243;705;22.5;7.1
977;2021-04-24;231;1;2474;706;24.8;7.1
977;2021-04-25;0;0;2474;706;24.8;7.1
977;2021-04-26;283;19;2757;725;27.7;7.3
977;2021-04-27;224;68;2981;793;29.9;8.0
977;2021-04-28;192;26;3173;819;31.9;8.2
977;2021-04-29;170;23;3343;842;33.6;8.5
977;2021-04-30;172;16;3515;858;35.3;8.6
977;2021-05-01;202;12;3717;870;37.3;8.7
977;2021-05-02;0;0;3717;870;37.3;8.7
977;2021-05-03;135;9;3852;879;38.7;8.8
977;2021-05-04;161;53;4013;932;40.3;9.4
977;2021-05-05;221;30;4234;962;42.5;9.7
977;2021-05-06;175;32;4409;994;44.3;10.0
977;2021-05-07;149;31;4558;1025;45.8;10.3
977;2021-05-08;1;0;4559;1025;45.8;10.3
977;2021-05-09;0;0;4559;1025;45.8;10.3
977;2021-05-10;0;0;4559;1025;45.8;10.3
977;2021-05-11;3;41;4562;1066;45.8;10.7
977;2021-05-12;6;36;4568;1102;45.9;11.1
977;2021-05-13;0;0;4568;1102;45.9;11.1
977;2021-05-14;28;98;4596;1200;46.1;12.0
977;2021-05-15;0;0;4596;1200;46.1;12.0
977;2021-05-16;1;0;4597;1200;46.1;12.0
977;2021-05-17;1;14;4598;1214;46.2;12.2
977;2021-05-18;17;32;4615;1246;46.3;12.5
977;2021-05-19;0;1;4615;1247;46.3;12.5
977;2021-05-20;0;8;4615;1255;46.3;12.6
977;2021-05-21;12;32;4627;1287;46.5;12.9
977;2021-05-22;0;0;4627;1287;46.5;12.9
977;2021-05-23;0;0;4627;1287;46.5;12.9
977;2021-05-24;0;0;4627;1287;46.5;12.9
977;2021-05-25;50;332;4677;1619;47.0;16.3
977;2021-05-26;54;360;4731;1979;47.5;19.9
977;2021-05-27;34;317;4765;2296;47.8;23.0
977;2021-05-28;27;256;4792;2552;48.1;25.6
977;2021-05-29;35;375;4827;2927;48.5;29.4
977;2021-05-30;1;0;4828;2927;48.5;29.4
977;2021-05-31;45;216;4873;3143;48.9;31.6
977;2021-06-01;48;227;4921;3370;49.4;33.8
977;2021-06-02;69;273;4990;3643;50.1;36.6
977;2021-06-03;41;252;5031;3895;50.5;39.1
977;2021-06-04;79;269;5110;4164;51.3;41.8
977;2021-06-05;1;0;5111;4164;51.3;41.8
977;2021-06-06;0;0;5111;4164;51.3;41.8
977;2021-06-07;1;1;5112;4165;51.3;41.8
977;2021-06-08;3;2;5115;4167;51.4;41.8
977;2021-06-09;0;3;5115;4170;51.4;41.9
977;2021-06-10;8;4;5123;4174;51.4;41.9
977;2021-06-11;4;8;5127;4182;51.5;42.0
977;2021-06-12;16;59;5143;4241;51.6;42.6
977;2021-06-13;0;0;5143;4241;51.6;42.6
977;2021-06-14;0;0;5143;4241;51.6;42.6
977;2021-06-15;0;1;5143;4242;51.6;42.6
977;2021-06-16;0;0;5143;4242;51.6;42.6
977;2021-06-17;2;6;5145;4248;51.7;42.6
977;2021-06-18;0;2;5145;4250;51.7;42.7
977;2021-06-19;25;49;5170;4299;51.9;43.2
977;2021-06-20;0;0;5170;4299;51.9;43.2
977;2021-06-21;0;2;5170;4301;51.9;43.2
977;2021-06-22;8;0;5178;4301;52.0;43.2
977;2021-06-23;15;9;5193;4310;52.1;43.3
977;2021-06-24;10;5;5203;4315;52.2;43.3
977;2021-06-25;0;0;5203;4315;52.2;43.3
977;2021-06-26;25;45;5228;4360;52.5;43.8
977;2021-06-27;0;0;5228;4360;52.5;43.8
977;2021-06-28;0;0;5228;4360;52.5;43.8
977;2021-06-29;0;0;5228;4360;52.5;43.8
977;2021-06-30;0;0;5228;4360;52.5;43.8
977;2021-07-01;27;36;5255;4396;52.8;44.1
977;2021-07-02;26;31;5281;4427;53.0;44.4
977;2021-07-03;27;212;5308;4639;53.3;46.6
977;2021-07-04;0;0;5308;4639;53.3;46.6
977;2021-07-05;4;8;5312;4647;53.3;46.7
977;2021-07-06;0;0;5312;4647;53.3;46.7
977;2021-07-07;8;0;5320;4647;53.4;46.7
977;2021-07-08;33;23;5353;4670;53.7;46.9
977;2021-07-09;23;32;5376;4702;54.0;47.2
977;2021-07-10;28;40;5404;4742;54.3;47.6
977;2021-07-11;0;0;5404;4742;54.3;47.6
977;2021-07-12;0;1;5404;4743;54.3;47.6
977;2021-07-13;10;10;5414;4753;54.4;47.7
977;2021-07-14;0;0;5414;4753;54.4;47.7
977;2021-07-15;1;11;5415;4764;54.4;47.8
977;2021-07-16;44;50;5459;4814;54.8;48.3
977;2021-07-17;34;36;5493;4850;55.1;48.7
977;2021-07-18;0;0;5493;4850;55.1;48.7
977;2021-07-19;3;2;5496;4852;55.2;48.7
977;2021-07-20;3;1;5499;4853;55.2;48.7
977;2021-07-21;33;16;5532;4869;55.5;48.9
977;2021-07-22;35;33;5567;4902;55.9;49.2
977;2021-07-23;32;29;5599;4931;56.2;49.5
977;2021-07-24;43;26;5642;4957;56.6;49.8
977;2021-07-25;0;0;5642;4957;56.6;49.8
977;2021-07-26;13;9;5655;4966;56.8;49.9
977;2021-07-27;0;10;5655;4976;56.8;50.0
977;2021-07-28;31;14;5686;4990;57.1;50.1
977;2021-07-29;33;32;5719;5022;57.4;50.4
977;2021-07-30;31;29;5750;5051;57.7;50.7
977;2021-07-31;53;23;5803;5074;58.3;50.9
977;2021-08-01;0;0;5803;5074;58.3;50.9
977;2021-08-02;11;1;5814;5075;58.4;50.9
977;2021-08-03;0;0;5814;5075;58.4;50.9
977;2021-08-04;40;15;5854;5090;58.8;51.1
977;2021-08-05;28;29;5882;5119;59.1;51.4
978;2020-12-27;0;0;0;0;0.0;0.0
978;2020-12-28;0;0;0;0;0.0;0.0
978;2020-12-29;0;0;0;0;0.0;0.0
978;2020-12-30;0;0;0;0;0.0;0.0
978;2020-12-31;0;0;0;0;0.0;0.0
978;2021-01-01;0;0;0;0;0.0;0.0
978;2021-01-02;0;0;0;0;0.0;0.0
978;2021-01-03;0;0;0;0;0.0;0.0
978;2021-01-04;0;0;0;0;0.0;0.0
978;2021-01-05;0;0;0;0;0.0;0.0
978;2021-01-06;0;0;0;0;0.0;0.0
978;2021-01-07;0;0;0;0;0.0;0.0
978;2021-01-08;0;0;0;0;0.0;0.0
978;2021-01-09;0;0;0;0;0.0;0.0
978;2021-01-10;0;0;0;0;0.0;0.0
978;2021-01-11;0;0;0;0;0.0;0.0
978;2021-01-12;0;0;0;0;0.0;0.0
978;2021-01-13;10;0;10;0;0.0;0.0
978;2021-01-14;12;0;22;0;0.1;0.0
978;2021-01-15;9;0;31;0;0.1;0.0
978;2021-01-16;0;0;31;0;0.1;0.0
978;2021-01-17;0;0;31;0;0.1;0.0
978;2021-01-18;0;0;31;0;0.1;0.0
978;2021-01-19;12;0;43;0;0.1;0.0
978;2021-01-20;13;0;56;0;0.2;0.0
978;2021-01-21;6;0;62;0;0.2;0.0
978;2021-01-22;0;0;62;0;0.2;0.0
978;2021-01-23;0;0;62;0;0.2;0.0
978;2021-01-24;0;0;62;0;0.2;0.0
978;2021-01-25;0;0;62;0;0.2;0.0
978;2021-01-26;9;0;71;0;0.2;0.0
978;2021-01-27;10;0;81;0;0.2;0.0
978;2021-01-28;6;0;87;0;0.2;0.0
978;2021-01-29;0;0;87;0;0.2;0.0
978;2021-01-30;0;0;87;0;0.2;0.0
978;2021-01-31;0;0;87;0;0.2;0.0
978;2021-02-01;0;0;87;0;0.2;0.0
978;2021-02-02;38;0;125;0;0.4;0.0
978;2021-02-03;10;0;135;0;0.4;0.0
978;2021-02-04;31;0;166;0;0.5;0.0
978;2021-02-05;6;0;172;0;0.5;0.0
978;2021-02-06;0;0;172;0;0.5;0.0
978;2021-02-07;0;0;172;0;0.5;0.0
978;2021-02-08;0;0;172;0;0.5;0.0
978;2021-02-09;38;0;210;0;0.6;0.0
978;2021-02-10;27;1;237;1;0.7;0.0
978;2021-02-11;0;0;237;1;0.7;0.0
978;2021-02-12;36;0;273;1;0.8;0.0
978;2021-02-13;0;0;273;1;0.8;0.0
978;2021-02-14;0;0;273;1;0.8;0.0
978;2021-02-15;50;1;323;2;0.9;0.0
978;2021-02-16;0;0;323;2;0.9;0.0
978;2021-02-17;0;0;323;2;0.9;0.0
978;2021-02-18;28;0;351;2;1.0;0.0
978;2021-02-19;44;0;395;2;1.1;0.0
978;2021-02-20;0;0;395;2;1.1;0.0
978;2021-02-21;0;0;395;2;1.1;0.0
978;2021-02-22;45;4;440;6;1.2;0.0
978;2021-02-23;41;29;481;35;1.4;0.1
978;2021-02-24;35;1;516;36;1.5;0.1
978;2021-02-25;55;36;571;72;1.6;0.2
978;2021-02-26;39;5;610;77;1.7;0.2
978;2021-02-27;0;0;610;77;1.7;0.2
978;2021-02-28;0;0;610;77;1.7;0.2
978;2021-03-01;49;5;659;82;1.9;0.2
978;2021-03-02;7;27;666;109;1.9;0.3
978;2021-03-03;48;28;714;137;2.0;0.4
978;2021-03-04;30;26;744;163;2.1;0.5
978;2021-03-05;46;10;790;173;2.2;0.5
978;2021-03-06;0;0;790;173;2.2;0.5
978;2021-03-07;0;0;790;173;2.2;0.5
978;2021-03-08;32;7;822;180;2.3;0.5
978;2021-03-09;19;27;841;207;2.4;0.6
978;2021-03-10;33;28;874;235;2.5;0.7
978;2021-03-11;2;0;876;235;2.5;0.7
978;2021-03-12;52;21;928;256;2.6;0.7
978;2021-03-13;13;0;941;256;2.7;0.7
978;2021-03-14;0;0;941;256;2.7;0.7
978;2021-03-15;31;41;972;297;2.8;0.8
978;2021-03-16;73;6;1045;303;3.0;0.9
978;2021-03-17;67;13;1112;316;3.1;0.9
978;2021-03-18;82;39;1194;355;3.4;1.0
978;2021-03-19;32;50;1226;405;3.5;1.1
978;2021-03-20;0;0;1226;405;3.5;1.1
978;2021-03-21;0;0;1226;405;3.5;1.1
978;2021-03-22;35;45;1261;450;3.6;1.3
978;2021-03-23;30;43;1291;493;3.7;1.4
978;2021-03-24;38;42;1329;535;3.8;1.5
978;2021-03-25;94;34;1423;569;4.0;1.6
978;2021-03-26;45;33;1468;602;4.2;1.7
978;2021-03-27;94;3;1562;605;4.4;1.7
978;2021-03-28;0;0;1562;605;4.4;1.7
978;2021-03-29;69;48;1631;653;4.6;1.8
978;2021-03-30;98;24;1729;677;4.9;1.9
978;2021-03-31;90;49;1819;726;5.1;2.1
978;2021-04-01;57;48;1876;774;5.3;2.2
978;2021-04-02;0;0;1876;774;5.3;2.2
978;2021-04-03;1;0;1877;774;5.3;2.2
978;2021-04-04;0;0;1877;774;5.3;2.2
978;2021-04-05;2;0;1879;774;5.3;2.2
978;2021-04-06;49;63;1928;837;5.5;2.4
978;2021-04-07;92;33;2020;870;5.7;2.5
978;2021-04-08;120;7;2140;877;6.1;2.5
978;2021-04-09;90;39;2230;916;6.3;2.6
978;2021-04-10;169;11;2399;927;6.8;2.6
978;2021-04-11;0;0;2399;927;6.8;2.6
978;2021-04-12;41;75;2440;1002;6.9;2.8
978;2021-04-13;49;71;2489;1073;7.0;3.0
978;2021-04-14;82;45;2571;1118;7.3;3.2
978;2021-04-15;92;23;2663;1141;7.5;3.2
978;2021-04-16;77;42;2740;1183;7.8;3.3
978;2021-04-17;165;4;2905;1187;8.2;3.4
978;2021-04-18;0;0;2905;1187;8.2;3.4
978;2021-04-19;52;67;2957;1254;8.4;3.5
978;2021-04-20;83;27;3040;1281;8.6;3.6
978;2021-04-21;91;29;3131;1310;8.9;3.7
978;2021-04-22;101;20;3232;1330;9.1;3.8
978;2021-04-23;45;66;3277;1396;9.3;4.0
978;2021-04-24;99;78;3376;1474;9.6;4.2
978;2021-04-25;0;0;3376;1474;9.6;4.2
978;2021-04-26;29;91;3405;1565;9.6;4.4
978;2021-04-27;59;63;3464;1628;9.8;4.6
978;2021-04-28;90;39;3554;1667;10.1;4.7
978;2021-04-29;89;32;3643;1699;10.3;4.8
978;2021-04-30;104;14;3747;1713;10.6;4.8
978;2021-05-01;0;8;3747;1721;10.6;4.9
978;2021-05-02;0;0;3747;1721;10.6;4.9
978;2021-05-03;25;99;3772;1820;10.7;5.2
978;2021-05-04;159;102;3931;1922;11.1;5.4
978;2021-05-05;141;58;4072;1980;11.5;5.6
978;2021-05-06;200;49;4272;2029;12.1;5.7
978;2021-05-07;127;71;4399;2100;12.4;5.9
978;2021-05-08;69;122;4468;2222;12.6;6.3
978;2021-05-09;0;0;4468;2222;12.6;6.3
978;2021-05-10;124;99;4592;2321;13.0;6.6
978;2021-05-11;132;72;4724;2393;13.4;6.8
978;2021-05-12;156;78;4880;2471;13.8;7.0
978;2021-05-13;83;6;4963;2477;14.0;7.0
978;2021-05-14;130;62;5093;2539;14.4;7.2
978;2021-05-15;87;4;5180;2543;14.7;7.2
978;2021-05-16;0;0;5180;2543;14.7;7.2
978;2021-05-17;146;115;5326;2658;15.1;7.5
978;2021-05-18;151;94;5477;2752;15.5;7.8
978;2021-05-19;84;69;5561;2821;15.7;8.0
978;2021-05-20;104;26;5665;2847;16.0;8.1
978;2021-05-21;98;53;5763;2900;16.3;8.2
978;2021-05-22;100;11;5863;2911;16.6;8.2
978;2021-05-23;0;0;5863;2911;16.6;8.2
978;2021-05-24;33;7;5896;2918;16.7;8.3
978;2021-05-25;119;78;6015;2996;17.0;8.5
978;2021-05-26;109;49;6124;3045;17.3;8.6
978;2021-05-27;112;42;6236;3087;17.6;8.7
978;2021-05-28;33;1;6269;3088;17.7;8.7
978;2021-05-29;60;213;6329;3301;17.9;9.3
978;2021-05-30;0;0;6329;3301;17.9;9.3
978;2021-05-31;112;63;6441;3364;18.2;9.5
978;2021-06-01;116;62;6557;3426;18.6;9.7
978;2021-06-02;131;33;6688;3459;18.9;9.8
978;2021-06-03;102;38;6790;3497;19.2;9.9
978;2021-06-04;128;70;6918;3567;19.6;10.1
978;2021-06-05;83;21;7001;3588;19.8;10.2
978;2021-06-06;0;0;7001;3588;19.8;10.2
978;2021-06-07;96;96;7097;3684;20.1;10.4
978;2021-06-08;82;89;7179;3773;20.3;10.7
978;2021-06-09;99;73;7278;3846;20.6;10.9
978;2021-06-10;112;63;7390;3909;20.9;11.1
978;2021-06-11;117;106;7507;4015;21.2;11.4
978;2021-06-12;57;30;7564;4045;21.4;11.4
978;2021-06-13;0;0;7564;4045;21.4;11.4
978;2021-06-14;106;127;7670;4172;21.7;11.8
978;2021-06-15;88;120;7758;4292;22.0;12.1
978;2021-06-16;105;148;7863;4440;22.3;12.6
978;2021-06-17;85;72;7948;4512;22.5;12.8
978;2021-06-18;66;99;8014;4611;22.7;13.0
978;2021-06-19;64;79;8078;4690;22.9;13.3
978;2021-06-20;0;0;8078;4690;22.9;13.3
978;2021-06-21;78;152;8156;4842;23.1;13.7
978;2021-06-22;71;103;8227;4945;23.3;14.0
978;2021-06-23;68;115;8295;5060;23.5;14.3
978;2021-06-24;44;75;8339;5135;23.6;14.5
978;2021-06-25;63;100;8402;5235;23.8;14.8
978;2021-06-26;35;61;8437;5296;23.9;15.0
978;2021-06-27;0;0;8437;5296;23.9;15.0
978;2021-06-28;73;130;8510;5426;24.1;15.4
978;2021-06-29;62;105;8572;5531;24.3;15.7
978;2021-06-30;56;110;8628;5641;24.4;16.0
978;2021-07-01;42;87;8670;5728;24.5;16.2
978;2021-07-02;52;91;8722;5819;24.7;16.5
978;2021-07-03;40;90;8762;5909;24.8;16.7
978;2021-07-04;0;1;8762;5910;24.8;16.7
978;2021-07-05;67;93;8829;6003;25.0;17.0
978;2021-07-06;55;75;8884;6078;25.1;17.2
978;2021-07-07;55;123;8939;6201;25.3;17.5
978;2021-07-08;54;107;8993;6308;25.5;17.9
978;2021-07-09;46;92;9039;6400;25.6;18.1
978;2021-07-10;38;84;9077;6484;25.7;18.4
978;2021-07-11;0;4;9077;6488;25.7;18.4
978;2021-07-12;71;130;9148;6618;25.9;18.7
978;2021-07-13;146;162;9294;6780;26.3;19.2
978;2021-07-14;3;0;9297;6780;26.3;19.2
978;2021-07-15;161;194;9458;6974;26.8;19.7
978;2021-07-16;112;113;9570;7087;27.1;20.1
978;2021-07-17;51;100;9621;7187;27.2;20.3
978;2021-07-18;0;0;9621;7187;27.2;20.3
978;2021-07-19;98;134;9719;7321;27.5;20.7
978;2021-07-20;80;73;9799;7394;27.7;20.9
978;2021-07-21;61;50;9860;7444;27.9;21.1
978;2021-07-22;97;115;9957;7559;28.2;21.4
978;2021-07-23;67;100;10024;7659;28.4;21.7
978;2021-07-24;20;35;10044;7694;28.4;21.8
978;2021-07-25;0;0;10044;7694;28.4;21.8
978;2021-07-26;91;116;10135;7810;28.7;22.1
978;2021-07-27;67;145;10202;7955;28.9;22.5
978;2021-07-28;72;127;10274;8082;29.1;22.9
978;2021-07-29;80;98;10354;8180;29.3;23.2
978;2021-07-30;82;116;10436;8296;29.5;23.5
978;2021-07-31;48;66;10484;8362;29.7;23.7
978;2021-08-01;0;0;10484;8362;29.7;23.7
978;2021-08-02;65;95;10549;8457;29.9;23.9
978;2021-08-03;60;94;10609;8551;30.0;24.2
978;2021-08-04;55;55;10664;8606;30.2;24.4
978;2021-08-05;48;70;10712;8676;30.3;24.6
